year,month,day,wkday,hour,casual,registered,cnt
2010,9,15,2,14,1,0,1
2010,9,16,3,10,1,0,1
2010,9,17,4,11,0,6,6
2010,9,17,4,12,1,1,2
2010,9,17,4,17,1,0,1
2010,9,19,6,13,0,1,1
2010,9,19,6,14,1,4,5
2010,9,19,6,15,0,5,5
2010,9,20,0,11,0,4,4
2010,9,20,0,12,0,34,34
2010,9,20,0,13,0,11,11
2010,9,20,0,14,2,4,6
2010,9,20,0,15,2,11,13
2010,9,20,0,16,5,14,19
2010,9,20,0,17,2,22,24
2010,9,20,0,18,3,37,40
2010,9,20,0,19,11,23,34
2010,9,20,0,20,3,20,23
2010,9,20,0,21,4,14,18
2010,9,20,0,22,2,3,5
2010,9,20,0,23,0,7,7
2010,9,21,1,0,0,2,2
2010,9,21,1,6,1,3,4
2010,9,21,1,7,1,5,6
2010,9,21,1,8,3,22,25
2010,9,21,1,9,4,20,24
2010,9,21,1,10,3,9,12
2010,9,21,1,11,5,11,16
2010,9,21,1,12,6,16,22
2010,9,21,1,13,7,13,20
2010,9,21,1,14,7,10,17
2010,9,21,1,15,5,6,11
2010,9,21,1,16,8,7,15
2010,9,21,1,17,9,19,28
2010,9,21,1,18,19,29,48
2010,9,21,1,19,11,23,34
2010,9,21,1,20,5,12,17
2010,9,21,1,21,7,12,19
2010,9,21,1,22,7,5,12
2010,9,21,1,23,1,2,3
2010,9,22,2,0,0,1,1
2010,9,22,2,1,1,0,1
2010,9,22,2,2,1,0,1
2010,9,22,2,3,0,1,1
2010,9,22,2,4,0,2,2
2010,9,22,2,5,0,2,2
2010,9,22,2,6,0,4,4
2010,9,22,2,7,4,14,18
2010,9,22,2,8,4,24,28
2010,9,22,2,9,4,21,25
2010,9,22,2,10,6,10,16
2010,9,22,2,11,4,19,23
2010,9,22,2,12,6,21,27
2010,9,22,2,13,6,21,27
2010,9,22,2,14,12,15,27
2010,9,22,2,15,10,11,21
2010,9,22,2,16,8,14,22
2010,9,22,2,17,17,14,31
2010,9,22,2,18,7,26,33
2010,9,22,2,19,6,24,30
2010,9,22,2,20,5,15,20
2010,9,22,2,21,11,13,24
2010,9,22,2,22,1,12,13
2010,9,22,2,23,4,5,9
2010,9,23,3,0,1,3,4
2010,9,23,3,2,1,1,2
2010,9,23,3,3,0,1,1
2010,9,23,3,6,0,3,3
2010,9,23,3,7,3,8,11
2010,9,23,3,8,7,23,30
2010,9,23,3,9,5,13,18
2010,9,23,3,10,3,5,8
2010,9,23,3,11,7,13,20
2010,9,23,3,12,8,10,18
2010,9,23,3,13,5,8,13
2010,9,23,3,14,9,10,19
2010,9,23,3,15,10,8,18
2010,9,23,3,16,11,11,22
2010,9,23,3,17,6,21,27
2010,9,23,3,18,12,28,40
2010,9,23,3,19,9,29,38
2010,9,23,3,20,7,15,22
2010,9,23,3,21,3,21,24
2010,9,23,3,22,14,11,25
2010,9,23,3,23,3,14,17
2010,9,24,4,0,3,1,4
2010,9,24,4,1,0,1,1
2010,9,24,4,2,5,0,5
2010,9,24,4,7,0,7,7
2010,9,24,4,8,0,19,19
2010,9,24,4,9,1,18,19
2010,9,24,4,10,7,11,18
2010,9,24,4,11,1,13,14
2010,9,24,4,12,12,9,21
2010,9,24,4,13,11,7,18
2010,9,24,4,14,13,11,24
2010,9,24,4,15,7,12,19
2010,9,24,4,16,13,9,22
2010,9,24,4,17,13,24,37
2010,9,24,4,18,15,22,37
2010,9,24,4,19,9,18,27
2010,9,24,4,20,12,11,23
2010,9,24,4,21,12,5,17
2010,9,24,4,22,15,13,28
2010,9,24,4,23,7,3,10
2010,9,25,5,0,3,3,6
2010,9,25,5,1,0,4,4
2010,9,25,5,2,3,4,7
2010,9,25,5,3,3,1,4
2010,9,25,5,6,1,0,1
2010,9,25,5,7,4,0,4
2010,9,25,5,8,9,6,15
2010,9,25,5,9,20,11,31
2010,9,25,5,10,16,16,32
2010,9,25,5,11,22,32,54
2010,9,25,5,12,30,29,59
2010,9,25,5,13,50,21,71
2010,9,25,5,14,41,12,53
2010,9,25,5,15,16,18,34
2010,9,25,5,16,3,19,22
2010,9,25,5,17,0,14,14
2010,9,25,5,18,10,26,36
2010,9,25,5,19,12,22,34
2010,9,25,5,20,6,17,23
2010,9,25,5,21,13,15,28
2010,9,25,5,22,2,9,11
2010,9,25,5,23,3,9,12
2010,9,26,6,0,14,12,26
2010,9,26,6,1,0,5,5
2010,9,26,6,2,9,7,16
2010,9,26,6,6,1,1,2
2010,9,26,6,7,6,2,8
2010,9,26,6,8,0,2,2
2010,9,26,6,9,2,10,12
2010,9,26,6,10,5,13,18
2010,9,26,6,11,9,10,19
2010,9,26,6,12,9,30,39
2010,9,26,6,13,17,20,37
2010,9,26,6,14,32,32,64
2010,9,26,6,15,16,38,54
2010,9,26,6,16,13,25,38
2010,9,26,6,17,37,26,63
2010,9,26,6,18,20,22,42
2010,9,26,6,19,13,19,32
2010,9,26,6,20,14,21,35
2010,9,26,6,21,9,9,18
2010,9,26,6,22,4,8,12
2010,9,26,6,23,0,5,5
2010,9,27,0,0,1,3,4
2010,9,27,0,6,0,3,3
2010,9,27,0,7,1,4,5
2010,9,27,0,8,3,17,20
2010,9,27,0,9,3,9,12
2010,9,27,0,10,2,4,6
2010,9,27,0,11,2,6,8
2010,9,27,0,12,2,3,5
2010,9,27,0,13,4,8,12
2010,9,27,0,14,5,8,13
2010,9,27,0,15,4,5,9
2010,9,27,0,16,5,11,16
2010,9,27,0,17,10,32,42
2010,9,27,0,18,8,44,52
2010,9,27,0,19,4,31,35
2010,9,27,0,20,5,16,21
2010,9,27,0,21,2,14,16
2010,9,27,0,22,4,5,9
2010,9,27,0,23,0,4,4
2010,9,28,1,0,0,1,1
2010,9,28,1,1,1,0,1
2010,9,28,1,6,1,3,4
2010,9,28,1,7,2,14,16
2010,9,28,1,8,7,33,40
2010,9,28,1,9,3,15,18
2010,9,28,1,10,5,8,13
2010,9,28,1,11,1,11,12
2010,9,28,1,12,6,13,19
2010,9,28,1,13,4,19,23
2010,9,28,1,14,7,8,15
2010,9,28,1,15,11,15,26
2010,9,28,1,16,3,17,20
2010,9,28,1,17,12,35,47
2010,9,28,1,18,10,36,46
2010,9,28,1,19,4,28,32
2010,9,28,1,20,5,17,22
2010,9,28,1,21,11,26,37
2010,9,28,1,22,6,15,21
2010,9,28,1,23,3,6,9
2010,9,29,2,0,2,1,3
2010,9,29,2,1,0,1,1
2010,9,29,2,3,0,1,1
2010,9,29,2,5,0,1,1
2010,9,29,2,6,1,3,4
2010,9,29,2,7,6,26,32
2010,9,29,2,8,6,61,67
2010,9,29,2,9,3,46,49
2010,9,29,2,10,3,20,23
2010,9,29,2,11,9,20,29
2010,9,29,2,12,9,24,33
2010,9,29,2,13,4,4,8
2010,9,29,2,14,0,4,4
2010,9,29,2,15,2,2,4
2010,9,29,2,16,0,19,19
2010,9,29,2,17,3,29,32
2010,9,29,2,18,4,31,35
2010,9,29,2,19,9,31,40
2010,9,29,2,20,3,20,23
2010,9,29,2,21,5,22,27
2010,9,29,2,22,6,11,17
2010,9,29,2,23,2,1,3
2010,9,30,3,1,0,1,1
2010,9,30,3,7,0,1,1
2010,9,30,3,8,1,12,13
2010,9,30,3,9,0,10,10
2010,9,30,3,10,0,4,4
2010,9,30,3,11,2,0,2
2010,9,30,3,12,0,2,2
2010,9,30,3,13,3,7,10
2010,9,30,3,14,1,4,5
2010,9,30,3,15,5,14,19
2010,9,30,3,16,2,9,11
2010,9,30,3,17,4,40,44
2010,9,30,3,18,2,19,21
2010,9,30,3,19,2,14,16
2010,9,30,3,20,0,2,2
2010,9,30,3,21,0,1,1
2010,9,30,3,22,0,2,2
2010,9,30,3,23,0,1,1
2010,10,1,4,0,0,2,2
2010,10,1,4,1,3,2,5
2010,10,1,4,2,0,4,4
2010,10,1,4,3,0,2,2
2010,10,1,4,6,1,2,3
2010,10,1,4,7,1,18,19
2010,10,1,4,8,7,34,41
2010,10,1,4,9,3,31,34
2010,10,1,4,10,4,16,20
2010,10,1,4,11,10,21,31
2010,10,1,4,12,6,20,26
2010,10,1,4,13,11,18,29
2010,10,1,4,14,10,14,24
2010,10,1,4,15,13,16,29
2010,10,1,4,16,17,23,40
2010,10,1,4,17,12,51,63
2010,10,1,4,18,21,42,63
2010,10,1,4,19,15,45,60
2010,10,1,4,20,14,20,34
2010,10,1,4,21,4,23,27
2010,10,1,4,22,3,12,15
2010,10,1,4,23,9,9,18
2010,10,2,5,0,6,5,11
2010,10,2,5,1,0,5,5
2010,10,2,5,2,7,1,8
2010,10,2,5,3,1,1,2
2010,10,2,5,4,0,1,1
2010,10,2,5,6,1,2,3
2010,10,2,5,7,4,3,7
2010,10,2,5,8,6,17,23
2010,10,2,5,9,12,14,26
2010,10,2,5,10,22,23,45
2010,10,2,5,11,24,42,66
2010,10,2,5,12,48,46,94
2010,10,2,5,13,38,38,76
2010,10,2,5,14,37,35,72
2010,10,2,5,15,64,42,106
2010,10,2,5,16,28,37,65
2010,10,2,5,17,31,36,67
2010,10,2,5,18,23,23,46
2010,10,2,5,19,19,30,49
2010,10,2,5,20,8,14,22
2010,10,2,5,21,11,17,28
2010,10,2,5,22,5,25,30
2010,10,2,5,23,2,4,6
2010,10,3,6,0,6,14,20
2010,10,3,6,1,4,12,16
2010,10,3,6,2,5,9,14
2010,10,3,6,3,0,2,2
2010,10,3,6,4,0,1,1
2010,10,3,6,6,0,1,1
2010,10,3,6,7,0,3,3
2010,10,3,6,8,4,8,12
2010,10,3,6,9,17,15,32
2010,10,3,6,10,17,15,32
2010,10,3,6,11,22,17,39
2010,10,3,6,12,36,29,65
2010,10,3,6,13,33,30,63
2010,10,3,6,14,32,29,61
2010,10,3,6,15,17,38,55
2010,10,3,6,16,13,30,43
2010,10,3,6,17,14,21,35
2010,10,3,6,18,2,7,9
2010,10,3,6,19,1,3,4
2010,10,3,6,20,0,5,5
2010,10,3,6,21,0,1,1
2010,10,3,6,22,0,2,2
2010,10,3,6,23,0,1,1
2010,10,4,0,0,1,1,2
2010,10,4,0,2,1,0,1
2010,10,4,0,6,0,1,1
2010,10,4,0,7,1,5,6
2010,10,4,0,8,2,8,10
2010,10,4,0,9,0,10,10
2010,10,4,0,10,0,7,7
2010,10,4,0,11,1,9,10
2010,10,4,0,12,4,9,13
2010,10,4,0,13,6,15,21
2010,10,4,0,14,4,12,16
2010,10,4,0,15,6,8,14
2010,10,4,0,16,4,22,26
2010,10,4,0,17,4,50,54
2010,10,4,0,18,8,43,51
2010,10,4,0,19,9,23,32
2010,10,4,0,20,3,23,26
2010,10,4,0,21,2,16,18
2010,10,4,0,22,0,11,11
2010,10,4,0,23,2,5,7
2010,10,5,1,0,0,1,1
2010,10,5,1,1,0,3,3
2010,10,5,1,5,0,1,1
2010,10,5,1,6,1,7,8
2010,10,5,1,7,1,25,26
2010,10,5,1,8,4,47,51
2010,10,5,1,9,3,39,42
2010,10,5,1,10,7,13,20
2010,10,5,1,11,7,12,19
2010,10,5,1,12,2,20,22
2010,10,5,1,13,5,19,24
2010,10,5,1,14,4,22,26
2010,10,5,1,15,4,23,27
2010,10,5,1,16,8,27,35
2010,10,5,1,17,8,86,94
2010,10,5,1,18,10,63,73
2010,10,5,1,19,7,51,58
2010,10,5,1,20,3,43,46
2010,10,5,1,21,4,24,28
2010,10,5,1,22,4,14,18
2010,10,5,1,23,4,10,14
2010,10,6,2,0,2,5,7
2010,10,6,2,5,0,1,1
2010,10,6,2,6,2,8,10
2010,10,6,2,7,1,24,25
2010,10,6,2,8,4,57,61
2010,10,6,2,9,5,54,59
2010,10,6,2,10,4,23,27
2010,10,6,2,11,8,16,24
2010,10,6,2,12,3,38,41
2010,10,6,2,13,3,27,30
2010,10,6,2,14,5,12,17
2010,10,6,2,15,4,16,20
2010,10,6,2,16,11,34,45
2010,10,6,2,17,12,87,99
2010,10,6,2,18,17,63,80
2010,10,6,2,19,5,59,64
2010,10,6,2,20,3,34,37
2010,10,6,2,21,2,20,22
2010,10,6,2,22,2,8,10
2010,10,6,2,23,1,9,10
2010,10,7,3,0,1,9,10
2010,10,7,3,1,1,1,2
2010,10,7,3,2,0,1,1
2010,10,7,3,3,1,0,1
2010,10,7,3,5,0,1,1
2010,10,7,3,6,1,15,16
2010,10,7,3,7,4,27,31
2010,10,7,3,8,9,92,101
2010,10,7,3,9,7,47,54
2010,10,7,3,10,6,28,34
2010,10,7,3,11,8,17,25
2010,10,7,3,12,7,27,34
2010,10,7,3,13,14,37,51
2010,10,7,3,14,6,27,33
2010,10,7,3,15,9,27,36
2010,10,7,3,16,8,44,52
2010,10,7,3,17,23,71,94
2010,10,7,3,18,22,72,94
2010,10,7,3,19,7,71,78
2010,10,7,3,20,8,48,56
2010,10,7,3,21,8,34,42
2010,10,7,3,22,8,14,22
2010,10,7,3,23,5,16,21
2010,10,8,4,0,3,9,12
2010,10,8,4,1,2,9,11
2010,10,8,4,2,1,1,2
2010,10,8,4,6,0,8,8
2010,10,8,4,7,2,24,26
2010,10,8,4,8,6,82,88
2010,10,8,4,9,11,53,64
2010,10,8,4,10,8,29,37
2010,10,8,4,11,13,45,58
2010,10,8,4,12,13,43,56
2010,10,8,4,13,16,34,50
2010,10,8,4,14,8,36,44
2010,10,8,4,15,16,45,61
2010,10,8,4,16,36,42,78
2010,10,8,4,17,11,78,89
2010,10,8,4,18,10,56,66
2010,10,8,4,19,18,56,74
2010,10,8,4,20,20,20,40
2010,10,8,4,21,6,32,38
2010,10,8,4,22,14,20,34
2010,10,8,4,23,5,11,16
2010,10,9,5,0,0,9,9
2010,10,9,5,1,9,9,18
2010,10,9,5,2,7,9,16
2010,10,9,5,3,1,1,2
2010,10,9,5,4,2,3,5
2010,10,9,5,5,1,0,1
2010,10,9,5,6,1,2,3
2010,10,9,5,7,3,6,9
2010,10,9,5,8,10,21,31
2010,10,9,5,9,17,29,46
2010,10,9,5,10,28,37,65
2010,10,9,5,11,25,33,58
2010,10,9,5,12,56,42,98
2010,10,9,5,13,43,34,77
2010,10,9,5,14,49,39,88
2010,10,9,5,15,70,24,94
2010,10,9,5,16,85,48,133
2010,10,9,5,17,55,42,97
2010,10,9,5,18,40,48,88
2010,10,9,5,19,14,40,54
2010,10,9,5,20,10,29,39
2010,10,9,5,21,14,21,35
2010,10,9,5,22,22,22,44
2010,10,9,5,23,10,12,22
2010,10,10,6,0,13,9,22
2010,10,10,6,1,6,8,14
2010,10,10,6,2,11,10,21
2010,10,10,6,3,3,2,5
2010,10,10,6,4,0,1,1
2010,10,10,6,6,4,1,5
2010,10,10,6,7,4,4,8
2010,10,10,6,8,4,8,12
2010,10,10,6,9,20,23,43
2010,10,10,6,10,42,27,69
2010,10,10,6,11,40,36,76
2010,10,10,6,12,51,48,99
2010,10,10,6,13,73,36,109
2010,10,10,6,14,56,28,84
2010,10,10,6,15,54,36,90
2010,10,10,6,16,79,48,127
2010,10,10,6,17,76,27,103
2010,10,10,6,18,34,45,79
2010,10,10,6,19,14,24,38
2010,10,10,6,20,12,22,34
2010,10,10,6,21,7,19,26
2010,10,10,6,22,9,16,25
2010,10,10,6,23,10,14,24
2010,10,11,0,0,1,4,5
2010,10,11,0,1,2,11,13
2010,10,11,0,2,3,2,5
2010,10,11,0,3,1,1,2
2010,10,11,0,5,1,0,1
2010,10,11,0,6,2,2,4
2010,10,11,0,7,2,15,17
2010,10,11,0,8,13,32,45
2010,10,11,0,9,11,28,39
2010,10,11,0,10,25,30,55
2010,10,11,0,11,29,28,57
2010,10,11,0,12,49,42,91
2010,10,11,0,13,24,36,60
2010,10,11,0,14,38,39,77
2010,10,11,0,15,30,33,63
2010,10,11,0,16,26,46,72
2010,10,11,0,17,22,77,99
2010,10,11,0,18,25,70,95
2010,10,11,0,19,28,51,79
2010,10,11,0,20,9,37,46
2010,10,11,0,21,6,27,33
2010,10,11,0,22,3,17,20
2010,10,11,0,23,0,7,7
2010,10,12,1,0,2,2,4
2010,10,12,1,1,0,4,4
2010,10,12,1,3,0,1,1
2010,10,12,1,4,0,1,1
2010,10,12,1,6,0,14,14
2010,10,12,1,7,5,47,52
2010,10,12,1,8,15,94,109
2010,10,12,1,9,12,46,58
2010,10,12,1,10,15,24,39
2010,10,12,1,11,12,23,35
2010,10,12,1,12,18,35,53
2010,10,12,1,13,13,48,61
2010,10,12,1,14,15,35,50
2010,10,12,1,15,16,32,48
2010,10,12,1,16,20,56,76
2010,10,12,1,17,31,96,127
2010,10,12,1,18,21,103,124
2010,10,12,1,19,16,69,85
2010,10,12,1,20,11,38,49
2010,10,12,1,21,7,42,49
2010,10,12,1,22,7,18,25
2010,10,12,1,23,12,20,32
2010,10,13,2,0,2,4,6
2010,10,13,2,1,0,3,3
2010,10,13,2,2,0,2,2
2010,10,13,2,5,1,1,2
2010,10,13,2,6,4,15,19
2010,10,13,2,7,5,45,50
2010,10,13,2,8,14,94,108
2010,10,13,2,9,6,62,68
2010,10,13,2,10,19,38,57
2010,10,13,2,11,10,30,40
2010,10,13,2,12,26,50,76
2010,10,13,2,13,18,34,52
2010,10,13,2,14,17,23,40
2010,10,13,2,15,11,28,39
2010,10,13,2,16,13,49,62
2010,10,13,2,17,16,119,135
2010,10,13,2,18,19,103,122
2010,10,13,2,19,11,75,86
2010,10,13,2,20,14,44,58
2010,10,13,2,21,16,36,52
2010,10,13,2,22,12,35,47
2010,10,13,2,23,4,12,16
2010,10,14,3,0,3,2,5
2010,10,14,3,1,1,0,1
2010,10,14,3,2,3,1,4
2010,10,14,3,3,0,1,1
2010,10,14,3,4,0,1,1
2010,10,14,3,5,0,1,1
2010,10,14,3,6,3,14,17
2010,10,14,3,7,1,33,34
2010,10,14,3,8,2,29,31
2010,10,14,3,9,0,4,4
2010,10,14,3,10,1,8,9
2010,10,14,3,11,0,3,3
2010,10,14,3,12,1,1,2
2010,10,14,3,13,0,1,1
2010,10,14,3,14,2,8,10
2010,10,14,3,15,3,17,20
2010,10,14,3,16,5,30,35
2010,10,14,3,17,9,99,108
2010,10,14,3,18,5,91,96
2010,10,14,3,19,11,56,67
2010,10,14,3,20,5,29,34
2010,10,14,3,21,5,43,48
2010,10,14,3,22,7,23,30
2010,10,14,3,23,5,16,21
2010,10,15,4,0,7,8,15
2010,10,15,4,1,2,8,10
2010,10,15,4,2,3,2,5
2010,10,15,4,5,0,1,1
2010,10,15,4,6,3,11,14
2010,10,15,4,7,2,47,49
2010,10,15,4,8,4,84,88
2010,10,15,4,9,9,71,80
2010,10,15,4,10,12,28,40
2010,10,15,4,11,21,44,65
2010,10,15,4,12,33,41,74
2010,10,15,4,13,19,33,52
2010,10,15,4,14,38,34,72
2010,10,15,4,15,27,42,69
2010,10,15,4,16,20,43,63
2010,10,15,4,17,30,99,129
2010,10,15,4,18,16,112,128
2010,10,15,4,19,11,50,61
2010,10,15,4,20,10,36,46
2010,10,15,4,21,5,29,34
2010,10,15,4,22,3,26,29
2010,10,15,4,23,5,27,32
2010,10,16,5,0,9,20,29
2010,10,16,5,1,1,14,15
2010,10,16,5,2,0,4,4
2010,10,16,5,3,0,4,4
2010,10,16,5,4,0,1,1
2010,10,16,5,5,0,3,3
2010,10,16,5,6,0,7,7
2010,10,16,5,7,2,8,10
2010,10,16,5,8,2,26,28
2010,10,16,5,9,13,25,38
2010,10,16,5,10,25,48,73
2010,10,16,5,11,33,75,108
2010,10,16,5,12,56,50,106
2010,10,16,5,13,67,69,136
2010,10,16,5,14,77,71,148
2010,10,16,5,15,65,73,138
2010,10,16,5,16,47,68,115
2010,10,16,5,17,60,73,133
2010,10,16,5,18,40,54,94
2010,10,16,5,19,11,37,48
2010,10,16,5,20,15,28,43
2010,10,16,5,21,16,30,46
2010,10,16,5,22,12,29,41
2010,10,16,5,23,16,18,34
2010,10,17,6,0,9,11,20
2010,10,17,6,1,2,15,17
2010,10,17,6,2,5,11,16
2010,10,17,6,3,3,4,7
2010,10,17,6,4,0,3,3
2010,10,17,6,5,0,1,1
2010,10,17,6,6,2,1,3
2010,10,17,6,7,2,2,4
2010,10,17,6,8,10,20,30
2010,10,17,6,9,16,28,44
2010,10,17,6,10,21,40,61
2010,10,17,6,11,56,45,101
2010,10,17,6,12,65,43,108
2010,10,17,6,13,74,60,134
2010,10,17,6,14,65,75,140
2010,10,17,6,15,75,64,139
2010,10,17,6,16,71,65,136
2010,10,17,6,17,46,70,116
2010,10,17,6,18,42,53,95
2010,10,17,6,19,13,52,65
2010,10,17,6,20,5,25,30
2010,10,17,6,21,7,32,39
2010,10,17,6,22,8,16,24
2010,10,17,6,23,2,19,21
2010,10,18,0,0,1,5,6
2010,10,18,0,1,2,2,4
2010,10,18,0,2,3,3,6
2010,10,18,0,3,0,1,1
2010,10,18,0,5,0,3,3
2010,10,18,0,6,6,14,20
2010,10,18,0,7,4,44,48
2010,10,18,0,8,8,97,105
2010,10,18,0,9,6,70,76
2010,10,18,0,10,10,34,44
2010,10,18,0,11,13,32,45
2010,10,18,0,12,19,40,59
2010,10,18,0,13,12,41,53
2010,10,18,0,14,13,32,45
2010,10,18,0,15,17,46,63
2010,10,18,0,16,20,54,74
2010,10,18,0,17,13,108,121
2010,10,18,0,18,12,108,120
2010,10,18,0,19,16,78,94
2010,10,18,0,20,5,49,54
2010,10,18,0,21,2,37,39
2010,10,18,0,22,5,38,43
2010,10,18,0,23,7,21,28
2010,10,19,1,0,2,4,6
2010,10,19,1,1,1,1,2
2010,10,19,1,2,1,5,6
2010,10,19,1,5,0,5,5
2010,10,19,1,6,1,23,24
2010,10,19,1,7,1,60,61
2010,10,19,1,8,12,123,135
2010,10,19,1,9,12,63,75
2010,10,19,1,10,3,25,28
2010,10,19,1,11,8,17,25
2010,10,19,1,12,6,46,52
2010,10,19,1,13,20,37,57
2010,10,19,1,14,14,29,43
2010,10,19,1,15,12,35,47
2010,10,19,1,16,14,39,53
2010,10,19,1,17,28,120,148
2010,10,19,1,18,19,135,154
2010,10,19,1,19,11,75,86
2010,10,19,1,20,11,51,62
2010,10,19,1,21,10,37,47
2010,10,19,1,22,6,21,27
2010,10,19,1,23,2,14,16
2010,10,20,2,0,1,5,6
2010,10,20,2,1,0,3,3
2010,10,20,2,2,1,1,2
2010,10,20,2,4,0,1,1
2010,10,20,2,5,0,3,3
2010,10,20,2,6,1,22,23
2010,10,20,2,7,11,57,68
2010,10,20,2,8,9,125,134
2010,10,20,2,9,12,79,91
2010,10,20,2,10,8,31,39
2010,10,20,2,11,11,35,46
2010,10,20,2,12,8,39,47
2010,10,20,2,13,5,37,42
2010,10,20,2,14,1,12,13
2010,10,20,2,15,5,35,40
2010,10,20,2,16,10,50,60
2010,10,20,2,17,19,113,132
2010,10,20,2,18,22,116,138
2010,10,20,2,19,20,74,94
2010,10,20,2,20,8,49,57
2010,10,20,2,21,3,38,41
2010,10,20,2,22,7,36,43
2010,10,20,2,23,5,28,33
2010,10,21,3,0,0,12,12
2010,10,21,3,1,0,6,6
2010,10,21,3,2,0,4,4
2010,10,21,3,3,0,2,2
2010,10,21,3,5,0,4,4
2010,10,21,3,6,0,23,23
2010,10,21,3,7,5,57,62
2010,10,21,3,8,11,125,136
2010,10,21,3,9,14,82,96
2010,10,21,3,10,6,44,50
2010,10,21,3,11,9,50,59
2010,10,21,3,12,12,50,62
2010,10,21,3,13,13,40,53
2010,10,21,3,14,13,37,50
2010,10,21,3,15,15,43,58
2010,10,21,3,16,9,52,61
2010,10,21,3,17,20,124,144
2010,10,21,3,18,25,114,139
2010,10,21,3,19,14,116,130
2010,10,21,3,20,12,55,67
2010,10,21,3,21,1,42,43
2010,10,21,3,22,10,40,50
2010,10,21,3,23,5,33,38
2010,10,22,4,0,4,11,15
2010,10,22,4,1,2,11,13
2010,10,22,4,2,0,3,3
2010,10,22,4,4,1,0,1
2010,10,22,4,5,0,6,6
2010,10,22,4,6,2,11,13
2010,10,22,4,7,4,51,55
2010,10,22,4,8,11,133,144
2010,10,22,4,9,16,91,107
2010,10,22,4,10,7,29,36
2010,10,22,4,11,10,43,53
2010,10,22,4,12,14,69,83
2010,10,22,4,13,18,52,70
2010,10,22,4,14,17,54,71
2010,10,22,4,15,24,47,71
2010,10,22,4,16,14,70,84
2010,10,22,4,17,28,136,164
2010,10,22,4,18,14,119,133
2010,10,22,4,19,9,68,77
2010,10,22,4,20,5,48,53
2010,10,22,4,21,22,38,60
2010,10,22,4,22,10,40,50
2010,10,22,4,23,6,25,31
2010,10,23,5,0,5,16,21
2010,10,23,5,1,6,13,19
2010,10,23,5,2,7,19,26
2010,10,23,5,3,1,5,6
2010,10,23,5,4,1,4,5
2010,10,23,5,5,0,2,2
2010,10,23,5,6,1,7,8
2010,10,23,5,7,2,11,13
2010,10,23,5,8,7,22,29
2010,10,23,5,9,16,37,53
2010,10,23,5,10,23,47,70
2010,10,23,5,11,60,61,121
2010,10,23,5,12,57,79,136
2010,10,23,5,13,80,64,144
2010,10,23,5,14,108,83,191
2010,10,23,5,15,93,90,183
2010,10,23,5,16,108,76,184
2010,10,23,5,17,78,77,155
2010,10,23,5,18,40,74,114
2010,10,23,5,19,10,58,68
2010,10,23,5,20,10,35,45
2010,10,23,5,21,25,31,56
2010,10,23,5,22,15,25,40
2010,10,23,5,23,7,30,37
2010,10,24,6,0,21,26,47
2010,10,24,6,1,9,16,25
2010,10,24,6,2,11,13,24
2010,10,24,6,3,3,5,8
2010,10,24,6,4,0,1,1
2010,10,24,6,5,0,1,1
2010,10,24,6,6,1,2,3
2010,10,24,6,7,3,1,4
2010,10,24,6,8,10,19,29
2010,10,24,6,9,24,38,62
2010,10,24,6,10,44,43,87
2010,10,24,6,11,55,62,117
2010,10,24,6,12,63,67,130
2010,10,24,6,13,87,71,158
2010,10,24,6,14,99,66,165
2010,10,24,6,15,86,81,167
2010,10,24,6,16,55,72,127
2010,10,24,6,17,69,65,134
2010,10,24,6,18,28,61,89
2010,10,24,6,19,19,40,59
2010,10,24,6,20,8,41,49
2010,10,24,6,21,10,38,48
2010,10,24,6,22,6,17,23
2010,10,24,6,23,7,11,18
2010,10,25,0,0,7,4,11
2010,10,25,0,1,1,1,2
2010,10,25,0,2,2,3,5
2010,10,25,0,3,1,1,2
2010,10,25,0,5,0,4,4
2010,10,25,0,6,1,24,25
2010,10,25,0,7,1,53,54
2010,10,25,0,8,11,149,160
2010,10,25,0,9,11,78,89
2010,10,25,0,10,17,32,49
2010,10,25,0,11,21,27,48
2010,10,25,0,12,16,54,70
2010,10,25,0,13,12,42,54
2010,10,25,0,14,19,37,56
2010,10,25,0,15,18,33,51
2010,10,25,0,16,17,65,82
2010,10,25,0,17,21,127,148
2010,10,25,0,18,18,133,151
2010,10,25,0,19,12,93,105
2010,10,25,0,20,10,72,82
2010,10,25,0,21,4,46,50
2010,10,25,0,22,6,28,34
2010,10,25,0,23,1,19,20
2010,10,26,1,0,3,1,4
2010,10,26,1,1,2,6,8
2010,10,26,1,2,2,1,3
2010,10,26,1,5,0,7,7
2010,10,26,1,6,1,22,23
2010,10,26,1,7,6,77,83
2010,10,26,1,8,14,168,182
2010,10,26,1,9,15,88,103
2010,10,26,1,10,15,36,51
2010,10,26,1,11,18,39,57
2010,10,26,1,12,17,44,61
2010,10,26,1,13,4,50,54
2010,10,26,1,14,17,50,67
2010,10,26,1,15,20,59,79
2010,10,26,1,16,20,69,89
2010,10,26,1,17,25,143,168
2010,10,26,1,18,18,144,162
2010,10,26,1,19,19,92,111
2010,10,26,1,20,22,66,88
2010,10,26,1,21,18,66,84
2010,10,26,1,22,8,52,60
2010,10,26,1,23,3,25,28
2010,10,27,2,0,3,13,16
2010,10,27,2,1,2,2,4
2010,10,27,2,2,3,2,5
2010,10,27,2,3,1,0,1
2010,10,27,2,4,0,2,2
2010,10,27,2,6,0,4,4
2010,10,27,2,7,2,12,14
2010,10,27,2,8,6,27,33
2010,10,27,2,9,7,53,60
2010,10,27,2,10,4,41,45
2010,10,27,2,11,8,23,31
2010,10,27,2,12,6,15,21
2010,10,27,2,13,2,7,9
2010,10,27,2,14,5,26,31
2010,10,27,2,15,10,45,55
2010,10,27,2,16,4,62,66
2010,10,27,2,17,21,146,167
2010,10,27,2,18,17,153,170
2010,10,27,2,19,17,82,99
2010,10,27,2,20,8,65,73
2010,10,27,2,21,9,51,60
2010,10,27,2,22,6,45,51
2010,10,27,2,23,1,29,30
2010,10,28,3,0,4,12,16
2010,10,28,3,1,1,5,6
2010,10,28,3,2,0,2,2
2010,10,28,3,4,0,2,2
2010,10,28,3,5,0,5,5
2010,10,28,3,6,0,26,26
2010,10,28,3,7,8,71,79
2010,10,28,3,8,23,165,188
2010,10,28,3,9,11,95,106
2010,10,28,3,10,14,40,54
2010,10,28,3,11,16,47,63
2010,10,28,3,12,22,67,89
2010,10,28,3,13,19,53,72
2010,10,28,3,14,22,51,73
2010,10,28,3,15,24,39,63
2010,10,28,3,16,29,72,101
2010,10,28,3,17,52,155,207
2010,10,28,3,18,33,174,207
2010,10,28,3,19,25,90,115
2010,10,28,3,20,16,58,74
2010,10,28,3,21,21,66,87
2010,10,28,3,22,11,38,49
2010,10,28,3,23,7,23,30
2010,10,29,4,0,2,15,17
2010,10,29,4,1,6,6,12
2010,10,29,4,2,2,1,3
2010,10,29,4,3,1,2,3
2010,10,29,4,5,0,4,4
2010,10,29,4,6,2,21,23
2010,10,29,4,7,8,57,65
2010,10,29,4,8,16,149,165
2010,10,29,4,9,17,98,115
2010,10,29,4,10,24,26,50
2010,10,29,4,11,25,51,76
2010,10,29,4,12,42,57,99
2010,10,29,4,13,41,68,109
2010,10,29,4,14,32,43,75
2010,10,29,4,15,28,46,74
2010,10,29,4,16,41,83,124
2010,10,29,4,17,31,147,178
2010,10,29,4,18,36,131,167
2010,10,29,4,19,24,87,111
2010,10,29,4,20,18,65,83
2010,10,29,4,21,9,51,60
2010,10,29,4,22,4,31,35
2010,10,29,4,23,7,26,33
2010,10,30,5,0,10,27,37
2010,10,30,5,1,1,20,21
2010,10,30,5,2,7,19,26
2010,10,30,5,3,2,4,6
2010,10,30,5,4,1,2,3
2010,10,30,5,5,2,3,5
2010,10,30,5,6,2,1,3
2010,10,30,5,7,9,9,18
2010,10,30,5,8,13,36,49
2010,10,30,5,9,64,66,130
2010,10,30,5,10,89,94,183
2010,10,30,5,11,141,103,244
2010,10,30,5,12,74,56,130
2010,10,30,5,13,95,75,170
2010,10,30,5,14,134,105,239
2010,10,30,5,15,153,133,286
2010,10,30,5,16,131,111,242
2010,10,30,5,17,92,92,184
2010,10,30,5,18,40,56,96
2010,10,30,5,19,19,39,58
2010,10,30,5,20,34,35,69
2010,10,30,5,21,20,42,62
2010,10,30,5,22,15,30,45
2010,10,30,5,23,11,25,36
2010,10,31,6,0,19,14,33
2010,10,31,6,1,16,24,40
2010,10,31,6,2,21,34,55
2010,10,31,6,3,20,20,40
2010,10,31,6,4,6,5,11
2010,10,31,6,5,1,0,1
2010,10,31,6,6,3,3,6
2010,10,31,6,7,5,10,15
2010,10,31,6,8,32,24,56
2010,10,31,6,9,37,31,68
2010,10,31,6,10,72,53,125
2010,10,31,6,11,95,61,156
2010,10,31,6,12,88,88,176
2010,10,31,6,13,100,81,181
2010,10,31,6,14,105,92,197
2010,10,31,6,15,99,72,171
2010,10,31,6,16,64,85,149
2010,10,31,6,17,74,75,149
2010,10,31,6,18,41,60,101
2010,10,31,6,19,19,51,70
2010,10,31,6,20,25,31,56
2010,10,31,6,21,18,40,58
2010,10,31,6,22,17,25,42
2010,10,31,6,23,11,11,22
2010,11,1,0,0,3,8,11
2010,11,1,0,1,2,3,5
2010,11,1,0,2,4,5,9
2010,11,1,0,5,1,6,7
2010,11,1,0,6,1,29,30
2010,11,1,0,7,5,65,70
2010,11,1,0,8,12,125,137
2010,11,1,0,9,15,86,101
2010,11,1,0,10,10,30,40
2010,11,1,0,11,18,45,63
2010,11,1,0,12,22,64,86
2010,11,1,0,13,21,49,70
2010,11,1,0,14,23,48,71
2010,11,1,0,15,15,43,58
2010,11,1,0,16,20,78,98
2010,11,1,0,17,25,134,159
2010,11,1,0,18,14,140,154
2010,11,1,0,19,12,105,117
2010,11,1,0,20,0,67,67
2010,11,1,0,21,2,52,54
2010,11,1,0,22,11,32,43
2010,11,1,0,23,1,23,24
2010,11,2,1,0,2,7,9
2010,11,2,1,1,0,2,2
2010,11,2,1,3,0,1,1
2010,11,2,1,4,0,1,1
2010,11,2,1,5,2,6,8
2010,11,2,1,6,0,22,22
2010,11,2,1,7,5,65,70
2010,11,2,1,8,21,133,154
2010,11,2,1,9,10,93,103
2010,11,2,1,10,17,35,52
2010,11,2,1,11,12,48,60
2010,11,2,1,12,10,44,54
2010,11,2,1,13,13,51,64
2010,11,2,1,14,18,53,71
2010,11,2,1,15,16,59,75
2010,11,2,1,16,10,77,87
2010,11,2,1,17,16,135,151
2010,11,2,1,18,7,136,143
2010,11,2,1,19,13,99,112
2010,11,2,1,20,4,57,61
2010,11,2,1,21,3,49,52
2010,11,2,1,22,3,43,46
2010,11,2,1,23,1,23,24
2010,11,3,2,0,3,19,22
2010,11,3,2,1,2,5,7
2010,11,3,2,2,1,2,3
2010,11,3,2,4,2,2,4
2010,11,3,2,5,6,4,10
2010,11,3,2,6,2,25,27
2010,11,3,2,7,5,64,69
2010,11,3,2,8,16,129,145
2010,11,3,2,9,4,116,120
2010,11,3,2,10,4,45,49
2010,11,3,2,11,3,36,39
2010,11,3,2,12,15,50,65
2010,11,3,2,13,13,52,65
2010,11,3,2,14,12,42,54
2010,11,3,2,15,13,46,59
2010,11,3,2,16,10,81,91
2010,11,3,2,17,20,181,201
2010,11,3,2,18,19,163,182
2010,11,3,2,19,10,105,115
2010,11,3,2,20,6,70,76
2010,11,3,2,21,6,50,56
2010,11,3,2,22,6,31,37
2010,11,3,2,23,2,9,11
2010,11,4,3,0,0,8,8
2010,11,4,3,1,0,5,5
2010,11,4,3,2,1,1,2
2010,11,4,3,4,0,1,1
2010,11,4,3,5,0,1,1
2010,11,4,3,6,0,3,3
2010,11,4,3,7,3,11,14
2010,11,4,3,8,2,27,29
2010,11,4,3,9,1,16,17
2010,11,4,3,10,1,11,12
2010,11,4,3,11,0,6,6
2010,11,4,3,12,1,13,14
2010,11,4,3,13,0,12,12
2010,11,4,3,14,0,9,9
2010,11,4,3,15,0,12,12
2010,11,4,3,16,2,22,24
2010,11,4,3,17,6,79,85
2010,11,4,3,18,9,85,94
2010,11,4,3,19,7,82,89
2010,11,4,3,20,3,46,49
2010,11,4,3,21,7,49,56
2010,11,4,3,22,0,39,39
2010,11,4,3,23,2,19,21
2010,11,5,4,0,0,19,19
2010,11,5,4,1,0,4,4
2010,11,5,4,2,2,1,3
2010,11,5,4,4,0,5,5
2010,11,5,4,5,0,2,2
2010,11,5,4,6,1,15,16
2010,11,5,4,7,2,74,76
2010,11,5,4,8,10,160,170
2010,11,5,4,9,17,130,147
2010,11,5,4,10,8,56,64
2010,11,5,4,11,14,51,65
2010,11,5,4,12,21,79,100
2010,11,5,4,13,27,99,126
2010,11,5,4,14,31,81,112
2010,11,5,4,15,32,82,114
2010,11,5,4,16,30,102,132
2010,11,5,4,17,22,187,209
2010,11,5,4,18,22,131,153
2010,11,5,4,19,17,103,120
2010,11,5,4,20,14,76,90
2010,11,5,4,21,11,49,60
2010,11,5,4,22,8,45,53
2010,11,5,4,23,6,34,40
2010,11,6,5,0,4,25,29
2010,11,6,5,1,1,18,19
2010,11,6,5,2,4,8,12
2010,11,6,5,3,4,6,10
2010,11,6,5,4,0,1,1
2010,11,6,5,5,1,4,5
2010,11,6,5,6,4,0,4
2010,11,6,5,7,4,15,19
2010,11,6,5,8,2,36,38
2010,11,6,5,9,17,46,63
2010,11,6,5,10,27,58,85
2010,11,6,5,11,53,79,132
2010,11,6,5,12,73,115,188
2010,11,6,5,13,85,114,199
2010,11,6,5,14,79,92,171
2010,11,6,5,15,65,101,166
2010,11,6,5,16,58,139,197
2010,11,6,5,17,59,80,139
2010,11,6,5,18,19,88,107
2010,11,6,5,19,17,63,80
2010,11,6,5,20,11,39,50
2010,11,6,5,21,6,52,58
2010,11,6,5,22,6,26,32
2010,11,6,5,23,6,35,41
2010,11,7,6,0,6,22,28
2010,11,7,6,1,11,33,44
2010,11,7,6,2,1,10,11
2010,11,7,6,5,0,2,2
2010,11,7,6,6,0,2,2
2010,11,7,6,7,1,5,6
2010,11,7,6,8,17,20,37
2010,11,7,6,9,22,48,70
2010,11,7,6,10,31,82,113
2010,11,7,6,11,45,81,126
2010,11,7,6,12,42,105,147
2010,11,7,6,13,57,84,141
2010,11,7,6,14,46,100,146
2010,11,7,6,15,25,89,114
2010,11,7,6,16,35,81,116
2010,11,7,6,17,8,68,76
2010,11,7,6,18,13,67,80
2010,11,7,6,19,14,40,54
2010,11,7,6,20,7,40,47
2010,11,7,6,21,10,27,37
2010,11,7,6,22,3,20,23
2010,11,7,6,23,1,21,22
2010,11,8,0,0,4,7,11
2010,11,8,0,1,2,0,2
2010,11,8,0,4,1,0,1
2010,11,8,0,5,2,4,6
2010,11,8,0,6,2,25,27
2010,11,8,0,7,7,100,107
2010,11,8,0,8,12,158,170
2010,11,8,0,9,14,78,92
2010,11,8,0,10,4,38,42
2010,11,8,0,11,4,44,48
2010,11,8,0,12,18,66,84
2010,11,8,0,13,8,63,71
2010,11,8,0,14,14,57,71
2010,11,8,0,15,11,63,74
2010,11,8,0,16,14,86,100
2010,11,8,0,17,14,202,216
2010,11,8,0,18,8,164,172
2010,11,8,0,19,9,93,102
2010,11,8,0,20,6,81,87
2010,11,8,0,21,7,61,68
2010,11,8,0,22,0,48,48
2010,11,8,0,23,2,22,24
2010,11,9,1,0,4,7,11
2010,11,9,1,1,0,1,1
2010,11,9,1,2,0,2,2
2010,11,9,1,4,0,1,1
2010,11,9,1,5,0,2,2
2010,11,9,1,6,4,34,38
2010,11,9,1,7,2,105,107
2010,11,9,1,8,15,234,249
2010,11,9,1,9,10,111,121
2010,11,9,1,10,17,59,76
2010,11,9,1,11,6,44,50
2010,11,9,1,12,8,81,89
2010,11,9,1,13,19,74,93
2010,11,9,1,14,22,72,94
2010,11,9,1,15,18,67,85
2010,11,9,1,16,31,89,120
2010,11,9,1,17,26,216,242
2010,11,9,1,18,9,172,181
2010,11,9,1,19,11,147,158
2010,11,9,1,20,7,99,106
2010,11,9,1,21,2,70,72
2010,11,9,1,22,3,44,47
2010,11,9,1,23,1,18,19
2010,11,10,2,0,4,9,13
2010,11,10,2,1,0,6,6
2010,11,10,2,2,2,2,4
2010,11,10,2,4,0,3,3
2010,11,10,2,5,2,3,5
2010,11,10,2,6,1,25,26
2010,11,10,2,7,7,119,126
2010,11,10,2,8,15,228,243
2010,11,10,2,9,5,129,134
2010,11,10,2,10,15,59,74
2010,11,10,2,11,15,63,78
2010,11,10,2,12,27,89,116
2010,11,10,2,13,7,72,79
2010,11,10,2,14,10,71,81
2010,11,10,2,15,17,61,78
2010,11,10,2,16,22,104,126
2010,11,10,2,17,19,220,239
2010,11,10,2,18,12,164,176
2010,11,10,2,19,14,120,134
2010,11,10,2,20,5,124,129
2010,11,10,2,21,13,93,106
2010,11,10,2,22,11,49,60
2010,11,10,2,23,3,36,39
2010,11,11,3,0,3,15,18
2010,11,11,3,1,3,7,10
2010,11,11,3,2,0,4,4
2010,11,11,3,3,2,0,2
2010,11,11,3,4,0,1,1
2010,11,11,3,6,2,12,14
2010,11,11,3,7,2,54,56
2010,11,11,3,8,19,168,187
2010,11,11,3,9,11,117,128
2010,11,11,3,10,20,74,94
2010,11,11,3,11,39,70,109
2010,11,11,3,12,31,109,140
2010,11,11,3,13,40,108,148
2010,11,11,3,14,48,107,155
2010,11,11,3,15,42,105,147
2010,11,11,3,16,34,98,132
2010,11,11,3,17,35,172,207
2010,11,11,3,18,34,137,171
2010,11,11,3,19,22,124,146
2010,11,11,3,20,11,68,79
2010,11,11,3,21,3,45,48
2010,11,11,3,22,14,48,62
2010,11,11,3,23,3,26,29
2010,11,12,4,0,3,14,17
2010,11,12,4,1,2,7,9
2010,11,12,4,2,1,2,3
2010,11,12,4,5,0,2,2
2010,11,12,4,6,1,28,29
2010,11,12,4,7,6,75,81
2010,11,12,4,8,12,185,197
2010,11,12,4,9,16,105,121
2010,11,12,4,10,24,48,72
2010,11,12,4,11,29,52,81
2010,11,12,4,12,32,100,132
2010,11,12,4,13,29,95,124
2010,11,12,4,14,38,86,124
2010,11,12,4,15,46,85,131
2010,11,12,4,16,27,95,122
2010,11,12,4,17,29,204,233
2010,11,12,4,18,29,165,194
2010,11,12,4,19,15,110,125
2010,11,12,4,20,15,74,89
2010,11,12,4,21,14,49,63
2010,11,12,4,22,22,37,59
2010,11,12,4,23,6,45,51
2010,11,13,5,0,6,31,37
2010,11,13,5,1,8,26,34
2010,11,13,5,2,1,11,12
2010,11,13,5,3,1,7,8
2010,11,13,5,4,0,2,2
2010,11,13,5,5,0,3,3
2010,11,13,5,6,1,4,5
2010,11,13,5,7,3,20,23
2010,11,13,5,8,11,26,37
2010,11,13,5,9,20,49,69
2010,11,13,5,10,44,76,120
2010,11,13,5,11,86,122,208
2010,11,13,5,12,88,124,212
2010,11,13,5,13,113,111,224
2010,11,13,5,14,124,120,244
2010,11,13,5,15,136,114,250
2010,11,13,5,16,107,90,197
2010,11,13,5,17,46,105,151
2010,11,13,5,18,36,91,127
2010,11,13,5,19,18,71,89
2010,11,13,5,20,24,46,70
2010,11,13,5,21,22,45,67
2010,11,13,5,22,14,44,58
2010,11,13,5,23,7,46,53
2010,11,14,6,0,15,32,47
2010,11,14,6,1,12,39,51
2010,11,14,6,2,5,12,17
2010,11,14,6,3,6,14,20
2010,11,14,6,4,0,1,1
2010,11,14,6,5,0,2,2
2010,11,14,6,6,6,4,10
2010,11,14,6,7,6,15,21
2010,11,14,6,8,8,23,31
2010,11,14,6,9,39,45,84
2010,11,14,6,10,53,61,114
2010,11,14,6,11,77,72,149
2010,11,14,6,12,89,110,199
2010,11,14,6,13,103,124,227
2010,11,14,6,14,114,133,247
2010,11,14,6,15,78,104,182
2010,11,14,6,16,89,109,198
2010,11,14,6,17,48,87,135
2010,11,14,6,18,20,66,86
2010,11,14,6,19,23,50,73
2010,11,14,6,20,9,37,46
2010,11,14,6,21,4,37,41
2010,11,14,6,22,14,23,37
2010,11,14,6,23,5,16,21
2010,11,15,0,0,5,4,9
2010,11,15,0,1,0,2,2
2010,11,15,0,2,3,0,3
2010,11,15,0,3,0,1,1
2010,11,15,0,4,0,5,5
2010,11,15,0,5,0,3,3
2010,11,15,0,6,5,32,37
2010,11,15,0,7,5,97,102
2010,11,15,0,8,16,212,228
2010,11,15,0,9,12,105,117
2010,11,15,0,10,13,35,48
2010,11,15,0,11,6,43,49
2010,11,15,0,12,20,83,103
2010,11,15,0,13,13,48,61
2010,11,15,0,14,19,61,80
2010,11,15,0,15,18,66,84
2010,11,15,0,16,17,108,125
2010,11,15,0,17,20,190,210
2010,11,15,0,18,22,158,180
2010,11,15,0,19,15,122,137
2010,11,15,0,20,5,103,108
2010,11,15,0,21,2,41,43
2010,11,15,0,22,1,15,16
2010,11,15,0,23,1,5,6
2010,11,16,1,0,2,4,6
2010,11,16,1,1,0,4,4
2010,11,16,1,2,2,1,3
2010,11,16,1,3,0,1,1
2010,11,16,1,5,0,3,3
2010,11,16,1,6,0,18,18
2010,11,16,1,7,1,39,40
2010,11,16,1,8,3,69,72
2010,11,16,1,9,1,28,29
2010,11,16,1,10,0,14,14
2010,11,16,1,11,4,20,24
2010,11,16,1,12,4,16,20
2010,11,16,1,13,5,27,32
2010,11,16,1,14,3,26,29
2010,11,16,1,15,0,13,13
2010,11,16,1,16,1,20,21
2010,11,16,1,17,6,96,102
2010,11,16,1,18,5,83,88
2010,11,16,1,19,6,76,82
2010,11,16,1,20,3,53,56
2010,11,16,1,21,4,59,63
2010,11,16,1,22,4,30,34
2010,11,16,1,23,8,21,29
2010,11,17,2,0,2,10,12
2010,11,17,2,1,0,4,4
2010,11,17,2,2,0,1,1
2010,11,17,2,5,1,1,2
2010,11,17,2,6,0,39,39
2010,11,17,2,7,3,126,129
2010,11,17,2,8,17,208,225
2010,11,17,2,9,13,122,135
2010,11,17,2,10,6,55,61
2010,11,17,2,11,10,57,67
2010,11,17,2,12,15,87,102
2010,11,17,2,13,14,68,82
2010,11,17,2,14,15,56,71
2010,11,17,2,15,9,57,66
2010,11,17,2,16,7,103,110
2010,11,17,2,17,8,206,214
2010,11,17,2,18,18,182,200
2010,11,17,2,19,12,130,142
2010,11,17,2,20,4,93,97
2010,11,17,2,21,15,71,86
2010,11,17,2,22,7,47,54
2010,11,17,2,23,4,45,49
2010,11,18,3,0,2,17,19
2010,11,18,3,1,7,5,12
2010,11,18,3,2,3,4,7
2010,11,18,3,3,0,1,1
2010,11,18,3,4,0,2,2
2010,11,18,3,5,1,4,5
2010,11,18,3,6,3,28,31
2010,11,18,3,7,3,123,126
2010,11,18,3,8,14,212,226
2010,11,18,3,9,9,129,138
2010,11,18,3,10,11,55,66
2010,11,18,3,11,17,59,76
2010,11,18,3,12,23,115,138
2010,11,18,3,13,8,68,76
2010,11,18,3,14,12,54,66
2010,11,18,3,15,14,57,71
2010,11,18,3,16,8,111,119
2010,11,18,3,17,11,188,199
2010,11,18,3,18,10,156,166
2010,11,18,3,19,9,105,114
2010,11,18,3,20,8,87,95
2010,11,18,3,21,11,46,57
2010,11,18,3,22,5,36,41
2010,11,18,3,23,2,28,30
2010,11,19,4,0,3,22,25
2010,11,19,4,1,0,6,6
2010,11,19,4,2,1,10,11
2010,11,19,4,3,1,2,3
2010,11,19,4,4,0,1,1
2010,11,19,4,5,0,1,1
2010,11,19,4,6,2,29,31
2010,11,19,4,7,3,80,83
2010,11,19,4,8,12,222,234
2010,11,19,4,9,6,117,123
2010,11,19,4,10,10,55,65
2010,11,19,4,11,17,61,78
2010,11,19,4,12,23,94,117
2010,11,19,4,13,21,85,106
2010,11,19,4,14,18,66,84
2010,11,19,4,15,25,61,86
2010,11,19,4,16,35,96,131
2010,11,19,4,17,14,202,216
2010,11,19,4,18,21,157,178
2010,11,19,4,19,9,109,118
2010,11,19,4,20,5,77,82
2010,11,19,4,21,10,59,69
2010,11,19,4,22,11,64,75
2010,11,19,4,23,4,54,58
2010,11,20,5,0,7,23,30
2010,11,20,5,1,5,23,28
2010,11,20,5,2,20,17,37
2010,11,20,5,3,7,5,12
2010,11,20,5,4,3,4,7
2010,11,20,5,5,0,1,1
2010,11,20,5,6,4,1,5
2010,11,20,5,7,2,17,19
2010,11,20,5,8,17,38,55
2010,11,20,5,9,17,74,91
2010,11,20,5,10,39,85,124
2010,11,20,5,11,43,105,148
2010,11,20,5,12,76,155,231
2010,11,20,5,13,104,146,250
2010,11,20,5,14,116,149,265
2010,11,20,5,15,156,126,282
2010,11,20,5,16,92,127,219
2010,11,20,5,17,53,101,154
2010,11,20,5,18,27,86,113
2010,11,20,5,19,13,69,82
2010,11,20,5,20,5,59,64
2010,11,20,5,21,7,56,63
2010,11,20,5,22,10,41,51
2010,11,20,5,23,16,39,55
2010,11,21,6,0,10,23,33
2010,11,21,6,1,5,27,32
2010,11,21,6,2,5,21,26
2010,11,21,6,3,1,7,8
2010,11,21,6,4,0,3,3
2010,11,21,6,5,1,4,5
2010,11,21,6,6,1,2,3
2010,11,21,6,7,6,7,13
2010,11,21,6,8,2,19,21
2010,11,21,6,9,19,42,61
2010,11,21,6,10,43,59,102
2010,11,21,6,11,45,81,126
2010,11,21,6,12,79,133,212
2010,11,21,6,13,79,97,176
2010,11,21,6,14,73,112,185
2010,11,21,6,15,69,121,190
2010,11,21,6,16,31,110,141
2010,11,21,6,17,26,94,120
2010,11,21,6,18,16,77,93
2010,11,21,6,19,10,48,58
2010,11,21,6,20,11,31,42
2010,11,21,6,21,13,46,59
2010,11,21,6,22,14,28,42
2010,11,21,6,23,5,21,26
2010,11,22,0,0,5,8,13
2010,11,22,0,1,0,4,4
2010,11,22,0,2,0,4,4
2010,11,22,0,3,0,1,1
2010,11,22,0,4,0,1,1
2010,11,22,0,5,0,6,6
2010,11,22,0,6,3,38,41
2010,11,22,0,7,4,84,88
2010,11,22,0,8,10,204,214
2010,11,22,0,9,7,94,101
2010,11,22,0,10,7,56,63
2010,11,22,0,11,17,50,67
2010,11,22,0,12,18,78,96
2010,11,22,0,13,18,63,81
2010,11,22,0,14,35,65,100
2010,11,22,0,15,20,66,86
2010,11,22,0,16,21,94,115
2010,11,22,0,17,31,193,224
2010,11,22,0,18,7,173,180
2010,11,22,0,19,7,145,152
2010,11,22,0,20,16,91,107
2010,11,22,0,21,12,78,90
2010,11,22,0,22,15,44,59
2010,11,22,0,23,4,30,34
2010,11,23,1,0,9,16,25
2010,11,23,1,1,0,2,2
2010,11,23,1,2,2,1,3
2010,11,23,1,3,0,2,2
2010,11,23,1,4,0,2,2
2010,11,23,1,5,0,3,3
2010,11,23,1,6,3,34,37
2010,11,23,1,7,2,99,101
2010,11,23,1,8,10,222,232
2010,11,23,1,9,5,126,131
2010,11,23,1,10,17,57,74
2010,11,23,1,11,17,70,87
2010,11,23,1,12,24,66,90
2010,11,23,1,13,11,66,77
2010,11,23,1,14,11,65,76
2010,11,23,1,15,8,39,47
2010,11,23,1,16,8,91,99
2010,11,23,1,17,8,175,183
2010,11,23,1,18,7,173,180
2010,11,23,1,19,9,117,126
2010,11,23,1,20,0,80,80
2010,11,23,1,21,4,53,57
2010,11,23,1,22,4,46,50
2010,11,23,1,23,2,23,25
2010,11,24,2,0,10,12,22
2010,11,24,2,1,4,7,11
2010,11,24,2,2,0,4,4
2010,11,24,2,3,0,5,5
2010,11,24,2,5,0,6,6
2010,11,24,2,6,1,32,33
2010,11,24,2,7,3,74,77
2010,11,24,2,8,4,172,176
2010,11,24,2,9,6,101,107
2010,11,24,2,10,9,55,64
2010,11,24,2,11,17,62,79
2010,11,24,2,12,18,76,94
2010,11,24,2,13,17,77,94
2010,11,24,2,14,11,83,94
2010,11,24,2,15,11,143,154
2010,11,24,2,16,11,116,127
2010,11,24,2,17,10,98,108
2010,11,24,2,18,2,65,67
2010,11,24,2,19,7,55,62
2010,11,24,2,20,3,35,38
2010,11,24,2,21,8,34,42
2010,11,24,2,22,2,31,33
2010,11,24,2,23,3,13,16
2010,11,25,3,0,1,12,13
2010,11,25,3,1,4,7,11
2010,11,25,3,2,0,7,7
2010,11,25,3,3,1,1,2
2010,11,25,3,5,0,3,3
2010,11,25,3,6,1,3,4
2010,11,25,3,7,0,14,14
2010,11,25,3,8,7,16,23
2010,11,25,3,9,4,26,30
2010,11,25,3,10,12,16,28
2010,11,25,3,11,13,44,57
2010,11,25,3,12,23,40,63
2010,11,25,3,13,15,35,50
2010,11,25,3,14,28,29,57
2010,11,25,3,15,19,22,41
2010,11,25,3,16,14,18,32
2010,11,25,3,17,15,15,30
2010,11,25,3,18,1,11,12
2010,11,25,3,19,2,7,9
2010,11,25,3,20,12,13,25
2010,11,25,3,21,14,10,24
2010,11,25,3,22,7,10,17
2010,11,25,3,23,5,12,17
2010,11,26,4,0,0,10,10
2010,11,26,4,1,3,4,7
2010,11,26,4,2,0,3,3
2010,11,26,4,3,0,2,2
2010,11,26,4,4,1,3,4
2010,11,26,4,6,0,7,7
2010,11,26,4,7,2,13,15
2010,11,26,4,8,2,28,30
2010,11,26,4,9,7,31,38
2010,11,26,4,10,17,34,51
2010,11,26,4,11,6,28,34
2010,11,26,4,12,23,43,66
2010,11,26,4,13,12,47,59
2010,11,26,4,14,32,38,70
2010,11,26,4,15,22,51,73
2010,11,26,4,16,24,67,91
2010,11,26,4,17,13,39,52
2010,11,26,4,18,18,34,52
2010,11,26,4,19,4,18,22
2010,11,26,4,20,3,30,33
2010,11,26,4,21,4,27,31
2010,11,26,4,22,0,18,18
2010,11,26,4,23,4,20,24
2010,11,27,5,0,2,18,20
2010,11,27,5,1,3,12,15
2010,11,27,5,2,5,10,15
2010,11,27,5,3,1,1,2
2010,11,27,5,4,0,2,2
2010,11,27,5,5,0,1,1
2010,11,27,5,6,3,2,5
2010,11,27,5,7,4,5,9
2010,11,27,5,8,5,14,19
2010,11,27,5,9,15,32,47
2010,11,27,5,10,16,28,44
2010,11,27,5,11,36,43,79
2010,11,27,5,12,42,34,76
2010,11,27,5,13,42,45,87
2010,11,27,5,14,63,53,116
2010,11,27,5,15,50,59,109
2010,11,27,5,16,24,38,62
2010,11,27,5,17,7,49,56
2010,11,27,5,18,14,32,46
2010,11,27,5,19,10,33,43
2010,11,27,5,20,5,21,26
2010,11,27,5,21,1,23,24
2010,11,27,5,22,9,17,26
2010,11,27,5,23,5,18,23
2010,11,28,6,0,2,9,11
2010,11,28,6,1,3,10,13
2010,11,28,6,2,10,10,20
2010,11,28,6,3,0,5,5
2010,11,28,6,6,0,5,5
2010,11,28,6,7,0,9,9
2010,11,28,6,8,3,10,13
2010,11,28,6,9,11,20,31
2010,11,28,6,10,14,39,53
2010,11,28,6,11,27,36,63
2010,11,28,6,12,27,85,112
2010,11,28,6,13,20,69,89
2010,11,28,6,14,30,76,106
2010,11,28,6,15,29,74,103
2010,11,28,6,16,19,88,107
2010,11,28,6,17,6,68,74
2010,11,28,6,18,6,33,39
2010,11,28,6,19,0,29,29
2010,11,28,6,20,0,23,23
2010,11,28,6,21,2,28,30
2010,11,28,6,22,0,15,15
2010,11,28,6,23,0,8,8
2010,11,29,0,0,0,4,4
2010,11,29,0,1,0,1,1
2010,11,29,0,3,0,1,1
2010,11,29,0,5,0,3,3
2010,11,29,0,6,1,32,33
2010,11,29,0,7,1,81,82
2010,11,29,0,8,7,204,211
2010,11,29,0,9,4,87,91
2010,11,29,0,10,7,38,45
2010,11,29,0,11,5,27,32
2010,11,29,0,12,4,54,58
2010,11,29,0,13,7,59,66
2010,11,29,0,14,8,58,66
2010,11,29,0,15,4,60,64
2010,11,29,0,16,6,77,83
2010,11,29,0,17,7,184,191
2010,11,29,0,18,9,146,155
2010,11,29,0,19,5,107,112
2010,11,29,0,20,8,67,75
2010,11,29,0,21,4,71,75
2010,11,29,0,22,7,36,43
2010,11,29,0,23,2,15,17
2010,11,30,1,0,1,7,8
2010,11,30,1,1,2,4,6
2010,11,30,1,2,0,1,1
2010,11,30,1,3,0,2,2
2010,11,30,1,4,0,1,1
2010,11,30,1,5,1,4,5
2010,11,30,1,6,3,39,42
2010,11,30,1,7,3,51,54
2010,11,30,1,8,2,71,73
2010,11,30,1,9,3,79,82
2010,11,30,1,10,9,43,52
2010,11,30,1,11,3,33,36
2010,11,30,1,12,5,52,57
2010,11,30,1,13,8,57,65
2010,11,30,1,14,3,48,51
2010,11,30,1,15,7,55,62
2010,11,30,1,16,4,80,84
2010,11,30,1,17,9,169,178
2010,11,30,1,18,15,152,167
2010,11,30,1,19,5,88,93
2010,11,30,1,20,4,65,69
2010,11,30,1,21,3,43,46
2010,11,30,1,22,2,25,27
2010,11,30,1,23,2,14,16
2010,12,1,2,0,1,13,14
2010,12,1,2,1,0,3,3
2010,12,1,2,2,0,3,3
2010,12,1,2,3,1,1,2
2010,12,1,2,4,0,1,1
2010,12,1,2,5,0,1,1
2010,12,1,2,6,0,7,7
2010,12,1,2,7,0,23,23
2010,12,1,2,8,1,53,54
2010,12,1,2,9,2,40,42
2010,12,1,2,10,1,7,8
2010,12,1,2,11,2,20,22
2010,12,1,2,12,0,29,29
2010,12,1,2,13,2,40,42
2010,12,1,2,14,2,41,43
2010,12,1,2,15,1,56,57
2010,12,1,2,16,7,61,68
2010,12,1,2,17,4,124,128
2010,12,1,2,18,4,136,140
2010,12,1,2,19,3,104,107
2010,12,1,2,20,3,94,97
2010,12,1,2,21,2,42,44
2010,12,1,2,22,1,32,33
2010,12,1,2,23,3,20,23
2010,12,2,3,0,0,11,11
2010,12,2,3,1,3,5,8
2010,12,2,3,2,0,1,1
2010,12,2,3,3,0,4,4
2010,12,2,3,4,0,1,1
2010,12,2,3,5,0,5,5
2010,12,2,3,6,1,36,37
2010,12,2,3,7,1,77,78
2010,12,2,3,8,2,187,189
2010,12,2,3,9,6,146,152
2010,12,2,3,10,9,45,54
2010,12,2,3,11,4,66,70
2010,12,2,3,12,11,51,62
2010,12,2,3,13,7,41,48
2010,12,2,3,14,1,54,55
2010,12,2,3,15,4,43,47
2010,12,2,3,16,7,59,66
2010,12,2,3,17,6,144,150
2010,12,2,3,18,10,132,142
2010,12,2,3,19,5,103,108
2010,12,2,3,20,4,73,77
2010,12,2,3,21,3,51,54
2010,12,2,3,22,5,41,46
2010,12,2,3,23,0,21,21
2010,12,3,4,0,0,13,13
2010,12,3,4,1,0,5,5
2010,12,3,4,2,0,2,2
2010,12,3,4,3,0,2,2
2010,12,3,4,4,0,1,1
2010,12,3,4,5,0,2,2
2010,12,3,4,6,0,24,24
2010,12,3,4,7,0,81,81
2010,12,3,4,8,6,209,215
2010,12,3,4,9,8,121,129
2010,12,3,4,10,3,50,53
2010,12,3,4,11,9,58,67
2010,12,3,4,12,11,62,73
2010,12,3,4,13,4,77,81
2010,12,3,4,14,5,49,54
2010,12,3,4,15,10,48,58
2010,12,3,4,16,10,101,111
2010,12,3,4,17,10,146,156
2010,12,3,4,18,5,155,160
2010,12,3,4,19,6,96,102
2010,12,3,4,20,6,74,80
2010,12,3,4,21,7,52,59
2010,12,3,4,22,9,42,51
2010,12,3,4,23,4,26,30
2010,12,4,5,0,5,29,34
2010,12,4,5,1,4,15,19
2010,12,4,5,2,3,18,21
2010,12,4,5,3,3,1,4
2010,12,4,5,4,0,5,5
2010,12,4,5,5,0,3,3
2010,12,4,5,6,0,4,4
2010,12,4,5,7,0,17,17
2010,12,4,5,8,6,17,23
2010,12,4,5,9,8,36,44
2010,12,4,5,10,11,52,63
2010,12,4,5,11,14,69,83
2010,12,4,5,12,14,73,87
2010,12,4,5,13,27,106,133
2010,12,4,5,14,30,80,110
2010,12,4,5,15,34,100,134
2010,12,4,5,16,30,65,95
2010,12,4,5,17,13,58,71
2010,12,4,5,18,8,54,62
2010,12,4,5,19,17,47,64
2010,12,4,5,20,7,34,41
2010,12,4,5,21,8,39,47
2010,12,4,5,22,3,32,35
2010,12,4,5,23,2,21,23
2010,12,5,6,0,6,21,27
2010,12,5,6,1,8,29,37
2010,12,5,6,2,1,16,17
2010,12,5,6,3,1,9,10
2010,12,5,6,4,0,3,3
2010,12,5,6,5,0,1,1
2010,12,5,6,6,0,5,5
2010,12,5,6,7,3,3,6
2010,12,5,6,8,5,18,23
2010,12,5,6,9,9,33,42
2010,12,5,6,10,11,50,61
2010,12,5,6,11,22,66,88
2010,12,5,6,12,17,74,91
2010,12,5,6,13,22,79,101
2010,12,5,6,14,17,69,86
2010,12,5,6,15,11,58,69
2010,12,5,6,16,7,67,74
2010,12,5,6,17,13,64,77
2010,12,5,6,18,4,51,55
2010,12,5,6,19,3,44,47
2010,12,5,6,20,1,33,34
2010,12,5,6,21,3,22,25
2010,12,5,6,22,1,20,21
2010,12,5,6,23,1,18,19
2010,12,6,0,0,0,8,8
2010,12,6,0,1,0,4,4
2010,12,6,0,3,0,2,2
2010,12,6,0,5,0,2,2
2010,12,6,0,6,0,30,30
2010,12,6,0,7,1,68,69
2010,12,6,0,8,4,165,169
2010,12,6,0,9,2,90,92
2010,12,6,0,10,1,35,36
2010,12,6,0,11,4,43,47
2010,12,6,0,12,2,49,51
2010,12,6,0,13,2,52,54
2010,12,6,0,14,3,34,37
2010,12,6,0,15,2,40,42
2010,12,6,0,16,3,67,70
2010,12,6,0,17,6,121,127
2010,12,6,0,18,3,150,153
2010,12,6,0,19,6,78,84
2010,12,6,0,20,2,51,53
2010,12,6,0,21,3,30,33
2010,12,6,0,22,0,20,20
2010,12,6,0,23,4,7,11
2010,12,7,1,0,0,15,15
2010,12,7,1,1,2,4,6
2010,12,7,1,2,0,1,1
2010,12,7,1,3,0,1,1
2010,12,7,1,5,0,1,1
2010,12,7,1,6,1,28,29
2010,12,7,1,7,1,61,62
2010,12,7,1,8,8,153,161
2010,12,7,1,9,2,88,90
2010,12,7,1,10,0,39,39
2010,12,7,1,11,0,37,37
2010,12,7,1,12,8,43,51
2010,12,7,1,13,2,41,43
2010,12,7,1,14,1,32,33
2010,12,7,1,15,2,35,37
2010,12,7,1,16,1,56,57
2010,12,7,1,17,4,123,127
2010,12,7,1,18,6,103,109
2010,12,7,1,19,4,82,86
2010,12,7,1,20,3,40,43
2010,12,7,1,21,0,28,28
2010,12,7,1,22,0,24,24
2010,12,7,1,23,1,15,16
2010,12,8,2,0,0,10,10
2010,12,8,2,1,1,1,2
2010,12,8,2,2,0,2,2
2010,12,8,2,5,0,1,1
2010,12,8,2,6,1,19,20
2010,12,8,2,7,4,69,73
2010,12,8,2,8,5,145,150
2010,12,8,2,9,9,96,105
2010,12,8,2,10,2,34,36
2010,12,8,2,11,3,44,47
2010,12,8,2,12,2,49,51
2010,12,8,2,13,2,35,37
2010,12,8,2,14,4,38,42
2010,12,8,2,15,4,45,49
2010,12,8,2,16,4,58,62
2010,12,8,2,17,2,116,118
2010,12,8,2,18,8,107,115
2010,12,8,2,19,2,72,74
2010,12,8,2,20,2,62,64
2010,12,8,2,21,0,46,46
2010,12,8,2,22,4,29,33
2010,12,8,2,23,0,15,15
2010,12,9,3,0,1,6,7
2010,12,9,3,1,0,4,4
2010,12,9,3,2,0,1,1
2010,12,9,3,3,0,2,2
2010,12,9,3,4,0,1,1
2010,12,9,3,5,0,4,4
2010,12,9,3,6,1,24,25
2010,12,9,3,7,0,60,60
2010,12,9,3,8,4,147,151
2010,12,9,3,9,6,111,117
2010,12,9,3,10,4,37,41
2010,12,9,3,11,5,47,52
2010,12,9,3,12,4,48,52
2010,12,9,3,13,2,44,46
2010,12,9,3,14,1,55,56
2010,12,9,3,15,6,45,51
2010,12,9,3,16,6,86,92
2010,12,9,3,17,8,135,143
2010,12,9,3,18,9,117,126
2010,12,9,3,19,4,77,81
2010,12,9,3,20,4,59,63
2010,12,9,3,21,2,53,55
2010,12,9,3,22,3,36,39
2010,12,9,3,23,1,26,27
2010,12,10,4,0,2,19,21
2010,12,10,4,1,1,4,5
2010,12,10,4,2,0,2,2
2010,12,10,4,3,1,0,1
2010,12,10,4,4,1,0,1
2010,12,10,4,5,0,1,1
2010,12,10,4,6,1,15,16
2010,12,10,4,7,3,45,48
2010,12,10,4,8,5,163,168
2010,12,10,4,9,2,115,117
2010,12,10,4,10,3,41,44
2010,12,10,4,11,2,43,45
2010,12,10,4,12,2,60,62
2010,12,10,4,13,6,55,61
2010,12,10,4,14,19,53,72
2010,12,10,4,15,3,55,58
2010,12,10,4,16,1,67,68
2010,12,10,4,17,5,130,135
2010,12,10,4,18,2,111,113
2010,12,10,4,19,2,94,96
2010,12,10,4,20,1,49,50
2010,12,10,4,21,1,43,44
2010,12,10,4,22,4,46,50
2010,12,10,4,23,6,23,29
2010,12,11,5,0,0,23,23
2010,12,11,5,1,0,24,24
2010,12,11,5,2,2,12,14
2010,12,11,5,3,0,10,10
2010,12,11,5,4,0,4,4
2010,12,11,5,5,0,2,2
2010,12,11,5,6,0,7,7
2010,12,11,5,7,1,7,8
2010,12,11,5,8,1,20,21
2010,12,11,5,9,3,35,38
2010,12,11,5,10,6,50,56
2010,12,11,5,11,12,68,80
2010,12,11,5,12,14,84,98
2010,12,11,5,13,13,82,95
2010,12,11,5,14,34,84,118
2010,12,11,5,15,24,99,123
2010,12,11,5,16,20,75,95
2010,12,11,5,17,14,72,86
2010,12,11,5,18,16,62,78
2010,12,11,5,19,7,49,56
2010,12,11,5,20,10,36,46
2010,12,11,5,21,2,33,35
2010,12,11,5,22,2,14,16
2010,12,11,5,23,3,18,21
2010,12,12,6,0,1,15,16
2010,12,12,6,1,1,15,16
2010,12,12,6,2,1,6,7
2010,12,12,6,3,2,7,9
2010,12,12,6,4,0,1,1
2010,12,12,6,5,0,1,1
2010,12,12,6,6,3,7,10
2010,12,12,6,7,0,1,1
2010,12,12,6,8,3,10,13
2010,12,12,6,9,3,16,19
2010,12,12,6,10,4,35,39
2010,12,12,6,11,7,43,50
2010,12,12,6,12,6,37,43
2010,12,12,6,13,4,25,29
2010,12,12,6,14,2,9,11
2010,12,12,6,15,0,14,14
2010,12,12,6,16,0,6,6
2010,12,12,6,17,0,15,15
2010,12,12,6,18,2,25,27
2010,12,12,6,19,0,26,26
2010,12,12,6,20,4,20,24
2010,12,12,6,21,0,16,16
2010,12,12,6,22,0,23,23
2010,12,12,6,23,0,12,12
2010,12,13,0,0,0,3,3
2010,12,13,0,1,0,2,2
2010,12,13,0,2,0,1,1
2010,12,13,0,3,0,3,3
2010,12,13,0,4,0,2,2
2010,12,13,0,5,0,1,1
2010,12,13,0,6,1,14,15
2010,12,13,0,7,0,58,58
2010,12,13,0,8,7,148,155
2010,12,13,0,9,9,92,101
2010,12,13,0,10,0,38,38
2010,12,13,0,11,3,39,42
2010,12,13,0,12,6,56,62
2010,12,13,0,13,1,37,38
2010,12,13,0,14,4,47,51
2010,12,13,0,15,1,46,47
2010,12,13,0,16,3,49,52
2010,12,13,0,17,4,100,104
2010,12,13,0,18,3,101,104
2010,12,13,0,19,1,70,71
2010,12,13,0,20,2,39,41
2010,12,13,0,21,1,28,29
2010,12,13,0,22,0,23,23
2010,12,13,0,23,0,8,8
2010,12,14,1,0,0,1,1
2010,12,14,1,1,0,1,1
2010,12,14,1,2,2,0,2
2010,12,14,1,3,1,1,2
2010,12,14,1,5,0,1,1
2010,12,14,1,6,1,20,21
2010,12,14,1,7,0,57,57
2010,12,14,1,8,3,92,95
2010,12,14,1,9,3,82,85
2010,12,14,1,10,1,36,37
2010,12,14,1,11,2,25,27
2010,12,14,1,12,3,28,31
2010,12,14,1,13,1,25,26
2010,12,14,1,14,4,27,31
2010,12,14,1,15,3,32,35
2010,12,14,1,16,3,33,36
2010,12,14,1,17,2,109,111
2010,12,14,1,18,2,106,108
2010,12,14,1,19,3,47,50
2010,12,14,1,20,1,46,47
2010,12,14,1,21,1,25,26
2010,12,14,1,22,2,15,17
2010,12,14,1,23,0,12,12
2010,12,15,2,0,1,4,5
2010,12,15,2,1,0,4,4
2010,12,15,2,2,1,1,2
2010,12,15,2,5,0,3,3
2010,12,15,2,6,1,23,24
2010,12,15,2,7,2,53,55
2010,12,15,2,8,4,121,125
2010,12,15,2,9,2,87,89
2010,12,15,2,10,1,35,36
2010,12,15,2,11,2,37,39
2010,12,15,2,12,4,46,50
2010,12,15,2,13,3,32,35
2010,12,15,2,14,2,43,45
2010,12,15,2,15,3,34,37
2010,12,15,2,16,1,58,59
2010,12,15,2,17,5,117,122
2010,12,15,2,18,4,106,110
2010,12,15,2,19,1,78,79
2010,12,15,2,20,0,52,52
2010,12,15,2,21,0,33,33
2010,12,15,2,22,0,35,35
2010,12,15,2,23,6,17,23
2010,12,16,3,0,0,10,10
2010,12,16,3,1,0,2,2
2010,12,16,3,4,0,3,3
2010,12,16,3,5,0,6,6
2010,12,16,3,6,1,19,20
2010,12,16,3,7,0,66,66
2010,12,16,3,8,8,145,153
2010,12,16,3,9,0,99,99
2010,12,16,3,10,0,27,27
2010,12,16,3,11,0,20,20
2010,12,16,3,12,0,15,15
2010,12,16,3,13,0,10,10
2010,12,16,3,14,0,11,11
2010,12,16,3,15,1,13,14
2010,12,16,3,16,0,21,21
2010,12,16,3,17,1,56,57
2010,12,16,3,18,0,43,43
2010,12,16,3,19,0,39,39
2010,12,16,3,20,1,19,20
2010,12,16,3,21,0,21,21
2010,12,16,3,22,0,12,12
2010,12,16,3,23,0,9,9
2010,12,17,4,0,0,3,3
2010,12,17,4,1,1,2,3
2010,12,17,4,2,1,3,4
2010,12,17,4,6,1,10,11
2010,12,17,4,7,0,33,33
2010,12,17,4,8,5,78,83
2010,12,17,4,9,2,65,67
2010,12,17,4,10,0,34,34
2010,12,17,4,11,2,31,33
2010,12,17,4,12,2,40,42
2010,12,17,4,13,3,31,34
2010,12,17,4,14,1,36,37
2010,12,17,4,15,0,44,44
2010,12,17,4,16,5,60,65
2010,12,17,4,17,4,85,89
2010,12,17,4,18,2,92,94
2010,12,17,4,19,2,59,61
2010,12,17,4,20,0,51,51
2010,12,17,4,21,2,30,32
2010,12,17,4,22,1,24,25
2010,12,17,4,23,1,27,28
2010,12,18,5,0,0,20,20
2010,12,18,5,1,0,10,10
2010,12,18,5,2,0,12,12
2010,12,18,5,3,0,5,5
2010,12,18,5,5,0,2,2
2010,12,18,5,6,0,3,3
2010,12,18,5,7,0,10,10
2010,12,18,5,8,1,15,16
2010,12,18,5,9,0,23,23
2010,12,18,5,10,4,52,56
2010,12,18,5,11,12,50,62
2010,12,18,5,12,17,61,78
2010,12,18,5,13,11,72,83
2010,12,18,5,14,9,52,61
2010,12,18,5,15,5,66,71
2010,12,18,5,16,5,62,67
2010,12,18,5,17,7,41,48
2010,12,18,5,18,5,60,65
2010,12,18,5,19,2,30,32
2010,12,18,5,20,2,29,31
2010,12,18,5,21,3,36,39
2010,12,18,5,22,1,28,29
2010,12,18,5,23,0,23,23
2010,12,19,6,0,0,10,10
2010,12,19,6,1,4,20,24
2010,12,19,6,2,3,14,17
2010,12,19,6,3,1,6,7
2010,12,19,6,5,0,1,1
2010,12,19,6,6,0,4,4
2010,12,19,6,7,0,6,6
2010,12,19,6,8,1,11,12
2010,12,19,6,9,0,30,30
2010,12,19,6,10,2,42,44
2010,12,19,6,11,12,51,63
2010,12,19,6,12,15,84,99
2010,12,19,6,13,6,66,72
2010,12,19,6,14,17,52,69
2010,12,19,6,15,12,65,77
2010,12,19,6,16,7,58,65
2010,12,19,6,17,11,61,72
2010,12,19,6,18,7,39,46
2010,12,19,6,19,0,29,29
2010,12,19,6,20,3,19,22
2010,12,19,6,21,0,20,20
2010,12,19,6,22,0,19,19
2010,12,19,6,23,0,6,6
2010,12,20,0,0,0,3,3
2010,12,20,0,1,0,2,2
2010,12,20,0,4,0,2,2
2010,12,20,0,5,0,1,1
2010,12,20,0,6,0,23,23
2010,12,20,0,7,0,48,48
2010,12,20,0,8,1,118,119
2010,12,20,0,9,0,87,87
2010,12,20,0,10,2,26,28
2010,12,20,0,11,9,34,43
2010,12,20,0,12,4,43,47
2010,12,20,0,13,3,49,52
2010,12,20,0,14,3,46,49
2010,12,20,0,15,12,36,48
2010,12,20,0,16,6,55,61
2010,12,20,0,17,7,136,143
2010,12,20,0,18,5,103,108
2010,12,20,0,19,0,78,78
2010,12,20,0,20,0,43,43
2010,12,20,0,21,0,29,29
2010,12,20,0,22,1,18,19
2010,12,20,0,23,1,12,13
2010,12,21,1,0,0,10,10
2010,12,21,1,1,0,1,1
2010,12,21,1,2,2,4,6
2010,12,21,1,4,1,0,1
2010,12,21,1,5,0,1,1
2010,12,21,1,6,0,25,25
2010,12,21,1,7,0,42,42
2010,12,21,1,8,2,124,126
2010,12,21,1,9,4,90,94
2010,12,21,1,10,0,37,37
2010,12,21,1,11,2,41,43
2010,12,21,1,12,8,42,50
2010,12,21,1,13,5,41,46
2010,12,21,1,14,8,40,48
2010,12,21,1,15,0,40,40
2010,12,21,1,16,2,57,59
2010,12,21,1,17,5,132,137
2010,12,21,1,18,3,120,123
2010,12,21,1,19,6,58,64
2010,12,21,1,20,2,39,41
2010,12,21,1,21,0,28,28
2010,12,21,1,22,0,21,21
2010,12,21,1,23,0,18,18
2010,12,22,2,0,0,15,15
2010,12,22,2,1,1,1,2
2010,12,22,2,2,0,4,4
2010,12,22,2,5,0,1,1
2010,12,22,2,6,0,17,17
2010,12,22,2,7,0,53,53
2010,12,22,2,8,3,130,133
2010,12,22,2,9,4,93,97
2010,12,22,2,10,6,35,41
2010,12,22,2,11,11,41,52
2010,12,22,2,12,10,45,55
2010,12,22,2,13,5,50,55
2010,12,22,2,14,2,54,56
2010,12,22,2,15,9,36,45
2010,12,22,2,16,1,72,73
2010,12,22,2,17,16,116,132
2010,12,22,2,18,18,97,115
2010,12,22,2,19,3,54,57
2010,12,22,2,20,3,37,40
2010,12,22,2,21,6,28,34
2010,12,22,2,22,2,12,14
2010,12,22,2,23,0,21,21
2010,12,23,3,0,0,7,7
2010,12,23,3,1,1,8,9
2010,12,23,3,2,0,2,2
2010,12,23,3,3,0,1,1
2010,12,23,3,4,0,1,1
2010,12,23,3,5,0,1,1
2010,12,23,3,6,0,14,14
2010,12,23,3,7,1,30,31
2010,12,23,3,8,0,73,73
2010,12,23,3,9,0,61,61
2010,12,23,3,10,3,38,41
2010,12,23,3,11,0,26,26
2010,12,23,3,12,10,55,65
2010,12,23,3,13,8,47,55
2010,12,23,3,14,9,57,66
2010,12,23,3,15,8,54,62
2010,12,23,3,16,3,54,57
2010,12,23,3,17,4,53,57
2010,12,23,3,18,1,28,29
2010,12,23,3,19,6,22,28
2010,12,23,3,20,4,22,26
2010,12,23,3,21,2,16,18
2010,12,23,3,22,1,10,11
2010,12,23,3,23,0,6,6
2010,12,24,4,0,0,8,8
2010,12,24,4,1,8,2,10
2010,12,24,4,2,2,2,4
2010,12,24,4,3,0,1,1
2010,12,24,4,4,1,2,3
2010,12,24,4,5,0,2,2
2010,12,24,4,6,0,4,4
2010,12,24,4,7,2,3,5
2010,12,24,4,8,2,9,11
2010,12,24,4,9,3,18,21
2010,12,24,4,10,4,22,26
2010,12,24,4,11,5,18,23
2010,12,24,4,12,5,29,34
2010,12,24,4,13,14,25,39
2010,12,24,4,14,1,28,29
2010,12,24,4,15,8,27,35
2010,12,24,4,16,11,18,29
2010,12,24,4,17,2,17,19
2010,12,24,4,18,0,17,17
2010,12,24,4,19,2,5,7
2010,12,24,4,20,2,10,12
2010,12,24,4,21,0,7,7
2010,12,24,4,22,0,5,5
2010,12,24,4,23,0,1,1
2010,12,25,5,0,0,2,2
2010,12,25,5,1,0,2,2
2010,12,25,5,2,0,3,3
2010,12,25,5,3,0,1,1
2010,12,25,5,6,0,2,2
2010,12,25,5,7,0,1,1
2010,12,25,5,8,2,4,6
2010,12,25,5,9,3,1,4
2010,12,25,5,10,3,2,5
2010,12,25,5,11,3,6,9
2010,12,25,5,12,5,3,8
2010,12,25,5,13,13,2,15
2010,12,25,5,14,8,8,16
2010,12,25,5,15,5,11,16
2010,12,25,5,16,20,12,32
2010,12,25,5,17,14,4,18
2010,12,25,5,18,8,6,14
2010,12,25,5,19,2,0,2
2010,12,25,5,20,5,4,9
2010,12,25,5,21,8,6,14
2010,12,25,5,22,3,5,8
2010,12,25,5,23,0,4,4
2010,12,26,6,0,0,1,1
2010,12,26,6,10,2,2,4
2010,12,26,6,11,1,5,6
2010,12,26,6,12,1,9,10
2010,12,26,6,13,2,14,16
2010,12,26,6,14,1,4,5
2010,12,26,6,15,1,8,9
2010,12,26,6,16,4,9,13
2010,12,26,6,17,0,6,6
2010,12,26,6,18,2,2,4
2010,12,26,6,19,0,5,5
2010,12,26,6,20,1,3,4
2010,12,26,6,21,0,2,2
2010,12,26,6,22,0,4,4
2010,12,26,6,23,0,3,3
2010,12,27,0,0,0,1,1
2010,12,27,0,1,0,2,2
2010,12,27,0,5,0,2,2
2010,12,27,0,6,0,4,4
2010,12,27,0,7,0,7,7
2010,12,27,0,8,1,26,27
2010,12,27,0,9,1,15,16
2010,12,27,0,10,1,9,10
2010,12,27,0,11,1,9,10
2010,12,27,0,12,1,19,20
2010,12,27,0,13,6,15,21
2010,12,27,0,14,4,20,24
2010,12,27,0,15,4,10,14
2010,12,27,0,16,1,27,28
2010,12,27,0,17,4,35,39
2010,12,27,0,18,0,29,29
2010,12,27,0,19,0,15,15
2010,12,27,0,20,0,12,12
2010,12,27,0,21,0,14,14
2010,12,27,0,22,0,7,7
2010,12,27,0,23,2,4,6
2010,12,28,1,0,1,3,4
2010,12,28,1,1,1,2,3
2010,12,28,1,3,0,1,1
2010,12,28,1,5,0,2,2
2010,12,28,1,6,0,13,13
2010,12,28,1,7,0,27,27
2010,12,28,1,8,3,61,64
2010,12,28,1,9,2,44,46
2010,12,28,1,10,4,17,21
2010,12,28,1,11,1,24,25
2010,12,28,1,12,4,35,39
2010,12,28,1,13,16,46,62
2010,12,28,1,14,15,29,44
2010,12,28,1,15,4,26,30
2010,12,28,1,16,7,52,59
2010,12,28,1,17,5,90,95
2010,12,28,1,18,1,52,53
2010,12,28,1,19,3,38,41
2010,12,28,1,20,1,24,25
2010,12,28,1,21,0,22,22
2010,12,28,1,22,0,16,16
2010,12,28,1,23,1,12,13
2010,12,29,2,0,2,8,10
2010,12,29,2,1,0,7,7
2010,12,29,2,2,0,2,2
2010,12,29,2,5,0,1,1
2010,12,29,2,6,0,16,16
2010,12,29,2,7,0,28,28
2010,12,29,2,8,3,85,88
2010,12,29,2,9,5,73,78
2010,12,29,2,10,10,33,43
2010,12,29,2,11,6,36,42
2010,12,29,2,12,12,45,57
2010,12,29,2,13,7,48,55
2010,12,29,2,14,7,49,56
2010,12,29,2,15,15,30,45
2010,12,29,2,16,13,56,69
2010,12,29,2,17,10,89,99
2010,12,29,2,18,7,92,99
2010,12,29,2,19,4,45,49
2010,12,29,2,20,2,44,46
2010,12,29,2,21,7,20,27
2010,12,29,2,22,0,19,19
2010,12,29,2,23,1,9,10
2010,12,30,3,0,1,5,6
2010,12,30,3,1,0,2,2
2010,12,30,3,2,0,1,1
2010,12,30,3,3,1,0,1
2010,12,30,3,5,0,1,1
2010,12,30,3,6,0,12,12
2010,12,30,3,7,0,31,31
2010,12,30,3,8,12,88,100
2010,12,30,3,9,6,68,74
2010,12,30,3,10,12,37,49
2010,12,30,3,11,14,47,61
2010,12,30,3,12,11,58,69
2010,12,30,3,13,16,69,85
2010,12,30,3,14,16,79,95
2010,12,30,3,15,8,91,99
2010,12,30,3,16,13,98,111
2010,12,30,3,17,5,83,88
2010,12,30,3,18,8,56,64
2010,12,30,3,19,6,49,55
2010,12,30,3,20,5,28,33
2010,12,30,3,21,5,22,27
2010,12,30,3,22,8,22,30
2010,12,30,3,23,1,26,27
2010,12,31,4,0,1,11,12
2010,12,31,4,1,6,10,16
2010,12,31,4,2,2,9,11
2010,12,31,4,3,1,2,3
2010,12,31,4,4,3,2,5
2010,12,31,4,5,0,5,5
2010,12,31,4,6,0,6,6
2010,12,31,4,7,2,6,8
2010,12,31,4,8,1,15,16
2010,12,31,4,9,8,23,31
2010,12,31,4,10,14,32,46
2010,12,31,4,11,22,46,68
2010,12,31,4,12,35,50,85
2010,12,31,4,13,38,79,117
2010,12,31,4,14,36,72,108
2010,12,31,4,15,25,62,87
2010,12,31,4,16,46,58,104
2010,12,31,4,17,17,41,58
2010,12,31,4,18,7,26,33
2010,12,31,4,19,3,36,39
2010,12,31,4,20,7,26,33
2010,12,31,4,21,3,16,19
2010,12,31,4,22,4,25,29
2010,12,31,4,23,4,5,9
2011,1,1,5,0,3,13,16
2011,1,1,5,1,8,32,40
2011,1,1,5,2,5,27,32
2011,1,1,5,3,3,10,13
2011,1,1,5,4,0,1,1
2011,1,1,5,5,0,1,1
2011,1,1,5,6,2,0,2
2011,1,1,5,7,1,2,3
2011,1,1,5,8,1,7,8
2011,1,1,5,9,8,6,14
2011,1,1,5,10,12,24,36
2011,1,1,5,11,26,30,56
2011,1,1,5,12,29,55,84
2011,1,1,5,13,47,47,94
2011,1,1,5,14,34,71,105
2011,1,1,5,15,40,70,110
2011,1,1,5,16,41,52,93
2011,1,1,5,17,15,52,67
2011,1,1,5,18,9,26,35
2011,1,1,5,19,6,31,37
2011,1,1,5,20,11,25,36
2011,1,1,5,21,3,31,34
2011,1,1,5,22,11,17,28
2011,1,1,5,23,15,24,39
2011,1,2,6,0,4,13,17
2011,1,2,6,1,1,16,17
2011,1,2,6,2,1,8,9
2011,1,2,6,3,2,4,6
2011,1,2,6,4,2,1,3
2011,1,2,6,6,0,2,2
2011,1,2,6,7,0,1,1
2011,1,2,6,8,0,8,8
2011,1,2,6,9,1,19,20
2011,1,2,6,10,7,46,53
2011,1,2,6,11,16,54,70
2011,1,2,6,12,20,73,93
2011,1,2,6,13,11,64,75
2011,1,2,6,14,4,55,59
2011,1,2,6,15,19,55,74
2011,1,2,6,16,9,67,76
2011,1,2,6,17,7,58,65
2011,1,2,6,18,10,42,52
2011,1,2,6,19,1,29,30
2011,1,2,6,20,5,17,22
2011,1,2,6,21,11,20,31
2011,1,2,6,22,0,9,9
2011,1,2,6,23,0,8,8
2011,1,3,0,0,0,5,5
2011,1,3,0,1,0,2,2
2011,1,3,0,4,0,1,1
2011,1,3,0,5,0,3,3
2011,1,3,0,6,0,30,30
2011,1,3,0,7,1,63,64
2011,1,3,0,8,1,153,154
2011,1,3,0,9,7,81,88
2011,1,3,0,10,11,33,44
2011,1,3,0,11,10,41,51
2011,1,3,0,12,13,48,61
2011,1,3,0,13,8,53,61
2011,1,3,0,14,11,66,77
2011,1,3,0,15,14,58,72
2011,1,3,0,16,9,67,76
2011,1,3,0,17,11,145,156
2011,1,3,0,18,9,148,157
2011,1,3,0,19,8,101,109
2011,1,3,0,20,3,49,52
2011,1,3,0,21,3,49,52
2011,1,3,0,22,0,20,20
2011,1,3,0,23,1,11,12
2011,1,4,1,0,0,5,5
2011,1,4,1,1,0,2,2
2011,1,4,1,2,0,1,1
2011,1,4,1,4,0,2,2
2011,1,4,1,5,0,4,4
2011,1,4,1,6,0,36,36
2011,1,4,1,7,2,92,94
2011,1,4,1,8,2,177,179
2011,1,4,1,9,2,98,100
2011,1,4,1,10,5,37,42
2011,1,4,1,11,7,50,57
2011,1,4,1,12,12,66,78
2011,1,4,1,13,18,79,97
2011,1,4,1,14,9,54,63
2011,1,4,1,15,17,48,65
2011,1,4,1,16,15,68,83
2011,1,4,1,17,10,202,212
2011,1,4,1,18,3,179,182
2011,1,4,1,19,2,110,112
2011,1,4,1,20,1,52,53
2011,1,4,1,21,0,48,48
2011,1,4,1,22,1,34,35
2011,1,4,1,23,2,9,11
2011,1,5,2,0,0,6,6
2011,1,5,2,1,0,6,6
2011,1,5,2,2,0,2,2
2011,1,5,2,4,0,2,2
2011,1,5,2,5,0,3,3
2011,1,5,2,6,0,33,33
2011,1,5,2,7,1,86,87
2011,1,5,2,8,3,192,195
2011,1,5,2,9,6,109,115
2011,1,5,2,10,4,53,57
2011,1,5,2,11,12,34,46
2011,1,5,2,12,5,74,79
2011,1,5,2,13,6,65,71
2011,1,5,2,14,10,52,62
2011,1,5,2,15,7,55,62
2011,1,5,2,16,4,85,89
2011,1,5,2,17,4,186,190
2011,1,5,2,18,3,166,169
2011,1,5,2,19,5,127,132
2011,1,5,2,20,7,81,88
2011,1,5,2,21,3,40,43
2011,1,5,2,22,1,40,41
2011,1,5,2,23,1,18,19
2011,1,6,3,0,0,11,11
2011,1,6,3,1,0,4,4
2011,1,6,3,2,0,2,2
2011,1,6,3,4,0,1,1
2011,1,6,3,5,0,4,4
2011,1,6,3,6,0,36,36
2011,1,6,3,7,0,95,95
2011,1,6,3,8,3,215,218
2011,1,6,3,9,6,116,122
2011,1,6,3,10,3,42,45
2011,1,6,3,11,2,57,59
2011,1,6,3,12,6,78,84
2011,1,6,3,13,12,55,67
2011,1,6,3,14,11,59,70
2011,1,6,3,15,8,54,62
2011,1,6,3,16,12,74,86
2011,1,6,3,17,9,163,172
2011,1,6,3,18,5,158,163
2011,1,6,3,19,3,109,112
2011,1,6,3,20,3,65,68
2011,1,6,3,21,0,48,48
2011,1,6,3,22,1,50,51
2011,1,6,3,23,4,19,23
2011,1,7,4,0,4,13,17
2011,1,7,4,1,2,5,7
2011,1,7,4,2,0,1,1
2011,1,7,4,4,0,1,1
2011,1,7,4,5,0,5,5
2011,1,7,4,6,8,26,34
2011,1,7,4,7,8,75,83
2011,1,7,4,8,20,189,209
2011,1,7,4,9,9,125,134
2011,1,7,4,10,16,47,63
2011,1,7,4,11,19,48,67
2011,1,7,4,12,9,50,59
2011,1,7,4,13,9,64,73
2011,1,7,4,14,7,42,49
2011,1,7,4,15,9,63,72
2011,1,7,4,16,5,82,87
2011,1,7,4,17,9,178,187
2011,1,7,4,18,7,116,123
2011,1,7,4,19,3,91,94
2011,1,7,4,20,1,50,51
2011,1,7,4,21,0,39,39
2011,1,7,4,22,2,34,36
2011,1,7,4,23,1,14,15
2011,1,8,5,0,1,24,25
2011,1,8,5,1,1,15,16
2011,1,8,5,2,3,13,16
2011,1,8,5,3,0,7,7
2011,1,8,5,4,0,1,1
2011,1,8,5,5,0,5,5
2011,1,8,5,6,0,2,2
2011,1,8,5,7,1,8,9
2011,1,8,5,8,0,15,15
2011,1,8,5,9,0,20,20
2011,1,8,5,10,5,56,61
2011,1,8,5,11,2,60,62
2011,1,8,5,12,8,90,98
2011,1,8,5,13,7,95,102
2011,1,8,5,14,12,83,95
2011,1,8,5,15,5,69,74
2011,1,8,5,16,8,68,76
2011,1,8,5,17,5,64,69
2011,1,8,5,18,3,52,55
2011,1,8,5,19,4,26,30
2011,1,8,5,20,0,28,28
2011,1,8,5,21,2,35,37
2011,1,8,5,22,1,33,34
2011,1,8,5,23,0,22,22
2011,1,9,6,0,1,24,25
2011,1,9,6,1,0,12,12
2011,1,9,6,2,0,11,11
2011,1,9,6,3,0,4,4
2011,1,9,6,4,0,1,1
2011,1,9,6,5,0,1,1
2011,1,9,6,6,0,1,1
2011,1,9,6,7,1,5,6
2011,1,9,6,8,0,10,10
2011,1,9,6,9,0,19,19
2011,1,9,6,10,0,49,49
2011,1,9,6,11,2,46,48
2011,1,9,6,12,4,79,83
2011,1,9,6,13,6,69,75
2011,1,9,6,14,8,64,72
2011,1,9,6,15,5,77,82
2011,1,9,6,16,13,79,92
2011,1,9,6,17,3,59,62
2011,1,9,6,18,4,44,48
2011,1,9,6,19,1,40,41
2011,1,9,6,20,0,38,38
2011,1,9,6,21,1,19,20
2011,1,9,6,22,5,10,15
2011,1,9,6,23,0,6,6
2011,1,10,0,0,2,3,5
2011,1,10,0,1,1,0,1
2011,1,10,0,2,0,3,3
2011,1,10,0,3,0,1,1
2011,1,10,0,4,1,2,3
2011,1,10,0,5,0,3,3
2011,1,10,0,6,0,31,31
2011,1,10,0,7,2,74,76
2011,1,10,0,8,4,184,188
2011,1,10,0,9,2,92,94
2011,1,10,0,10,0,31,31
2011,1,10,0,11,2,28,30
2011,1,10,0,12,5,47,52
2011,1,10,0,13,4,50,54
2011,1,10,0,14,0,47,47
2011,1,10,0,15,2,43,45
2011,1,10,0,16,4,70,74
2011,1,10,0,17,4,174,178
2011,1,10,0,18,1,154,155
2011,1,10,0,19,3,92,95
2011,1,10,0,20,1,72,73
2011,1,10,0,21,1,37,38
2011,1,10,0,22,2,22,24
2011,1,10,0,23,0,18,18
2011,1,11,1,0,2,10,12
2011,1,11,1,1,0,3,3
2011,1,11,1,2,0,3,3
2011,1,11,1,5,0,6,6
2011,1,11,1,6,0,27,27
2011,1,11,1,7,2,96,98
2011,1,11,1,8,3,214,217
2011,1,11,1,9,3,127,130
2011,1,11,1,10,3,51,54
2011,1,11,1,11,4,31,35
2011,1,11,1,12,2,55,57
2011,1,11,1,13,6,46,52
2011,1,11,1,14,3,59,62
2011,1,11,1,15,2,44,46
2011,1,11,1,16,4,72,76
2011,1,11,1,17,6,130,136
2011,1,11,1,18,1,94,95
2011,1,11,1,19,0,51,51
2011,1,11,1,20,0,32,32
2011,1,11,1,21,0,20,20
2011,1,11,1,22,1,28,29
2011,1,11,1,23,1,18,19
2011,1,12,2,0,0,7,7
2011,1,12,2,1,0,6,6
2011,1,12,2,2,0,1,1
2011,1,12,2,5,0,5,5
2011,1,12,2,6,0,16,16
2011,1,12,2,7,0,54,54
2011,1,12,2,8,3,125,128
2011,1,12,2,9,3,77,80
2011,1,12,2,10,0,39,39
2011,1,12,2,11,3,32,35
2011,1,12,2,12,3,52,55
2011,1,12,2,13,0,49,49
2011,1,12,2,14,0,43,43
2011,1,12,2,15,1,48,49
2011,1,12,2,16,5,63,68
2011,1,12,2,17,0,139,139
2011,1,12,2,18,2,135,137
2011,1,12,2,19,1,81,82
2011,1,12,2,20,2,54,56
2011,1,12,2,21,0,57,57
2011,1,12,2,22,1,32,33
2011,1,12,2,23,1,19,20
2011,1,13,3,0,1,6,7
2011,1,13,3,1,0,2,2
2011,1,13,3,2,0,2,2
2011,1,13,3,3,0,2,2
2011,1,13,3,4,0,4,4
2011,1,13,3,5,0,3,3
2011,1,13,3,6,0,28,28
2011,1,13,3,7,0,72,72
2011,1,13,3,8,5,197,202
2011,1,13,3,9,2,136,138
2011,1,13,3,10,2,36,38
2011,1,13,3,11,4,33,37
2011,1,13,3,12,3,49,52
2011,1,13,3,13,2,81,83
2011,1,13,3,14,3,39,42
2011,1,13,3,15,5,55,60
2011,1,13,3,16,2,75,77
2011,1,13,3,17,3,156,159
2011,1,13,3,18,3,141,144
2011,1,13,3,19,1,98,99
2011,1,13,3,20,0,64,64
2011,1,13,3,21,0,39,39
2011,1,13,3,22,0,30,30
2011,1,13,3,23,1,14,15
2011,1,14,4,0,0,14,14
2011,1,14,4,1,0,5,5
2011,1,14,4,2,0,1,1
2011,1,14,4,3,0,1,1
2011,1,14,4,5,0,8,8
2011,1,14,4,6,0,17,17
2011,1,14,4,7,0,70,70
2011,1,14,4,8,2,155,157
2011,1,14,4,9,0,117,117
2011,1,14,4,10,4,40,44
2011,1,14,4,11,6,47,53
2011,1,14,4,12,2,58,60
2011,1,14,4,13,4,73,77
2011,1,14,4,14,5,59,64
2011,1,14,4,15,9,59,68
2011,1,14,4,16,3,87,90
2011,1,14,4,17,4,155,159
2011,1,14,4,18,5,134,139
2011,1,14,4,19,3,88,91
2011,1,14,4,20,0,68,68
2011,1,14,4,21,4,48,52
2011,1,14,4,22,2,34,36
2011,1,14,4,23,1,26,27
2011,1,15,5,0,3,25,28
2011,1,15,5,1,2,18,20
2011,1,15,5,2,0,12,12
2011,1,15,5,3,1,7,8
2011,1,15,5,4,0,5,5
2011,1,15,5,5,0,1,1
2011,1,15,5,6,1,2,3
2011,1,15,5,7,1,9,10
2011,1,15,5,8,1,22,23
2011,1,15,5,9,2,31,33
2011,1,15,5,10,2,57,59
2011,1,15,5,11,18,54,72
2011,1,15,5,12,15,74,89
2011,1,15,5,13,21,80,101
2011,1,15,5,14,26,92,118
2011,1,15,5,15,21,108,129
2011,1,15,5,16,33,95,128
2011,1,15,5,17,29,54,83
2011,1,15,5,18,15,69,84
2011,1,15,5,19,14,60,74
2011,1,15,5,20,6,35,41
2011,1,15,5,21,6,51,57
2011,1,15,5,22,0,26,26
2011,1,15,5,23,5,39,44
2011,1,16,6,0,6,33,39
2011,1,16,6,1,4,19,23
2011,1,16,6,2,3,13,16
2011,1,16,6,3,9,6,15
2011,1,16,6,4,0,1,1
2011,1,16,6,5,1,1,2
2011,1,16,6,6,0,1,1
2011,1,16,6,7,0,3,3
2011,1,16,6,8,0,18,18
2011,1,16,6,9,3,29,32
2011,1,16,6,10,8,71,79
2011,1,16,6,11,23,70,93
2011,1,16,6,12,29,75,104
2011,1,16,6,13,23,95,118
2011,1,16,6,14,22,69,91
2011,1,16,6,15,35,78,113
2011,1,16,6,16,22,77,99
2011,1,16,6,17,23,82,105
2011,1,16,6,18,11,56,67
2011,1,16,6,19,14,47,61
2011,1,16,6,20,7,50,57
2011,1,16,6,21,6,22,28
2011,1,16,6,22,2,19,21
2011,1,16,6,23,0,18,18
2011,1,17,0,0,1,16,17
2011,1,17,0,1,1,15,16
2011,1,17,0,2,0,8,8
2011,1,17,0,3,0,2,2
2011,1,17,0,4,1,2,3
2011,1,17,0,5,0,1,1
2011,1,17,0,6,0,5,5
2011,1,17,0,7,4,9,13
2011,1,17,0,8,3,30,33
2011,1,17,0,9,8,39,47
2011,1,17,0,10,7,50,57
2011,1,17,0,11,9,55,64
2011,1,17,0,12,10,70,80
2011,1,17,0,13,13,80,93
2011,1,17,0,14,12,74,86
2011,1,17,0,15,21,72,93
2011,1,17,0,16,6,76,82
2011,1,17,0,17,4,67,71
2011,1,17,0,18,7,85,92
2011,1,17,0,19,2,58,60
2011,1,17,0,20,4,29,33
2011,1,17,0,21,3,24,27
2011,1,17,0,22,0,13,13
2011,1,17,0,23,1,3,4
2011,1,18,1,12,0,3,3
2011,1,18,1,13,0,22,22
2011,1,18,1,14,2,25,27
2011,1,18,1,15,3,32,35
2011,1,18,1,16,0,61,61
2011,1,18,1,17,1,124,125
2011,1,18,1,18,1,132,133
2011,1,18,1,19,1,97,98
2011,1,18,1,20,0,82,82
2011,1,18,1,21,0,41,41
2011,1,18,1,22,0,33,33
2011,1,18,1,23,1,19,20
2011,1,19,2,0,0,3,3
2011,1,19,2,1,1,6,7
2011,1,19,2,2,0,3,3
2011,1,19,2,4,1,1,2
2011,1,19,2,5,0,7,7
2011,1,19,2,6,0,32,32
2011,1,19,2,7,1,89,90
2011,1,19,2,8,1,196,197
2011,1,19,2,9,2,107,109
2011,1,19,2,10,1,46,47
2011,1,19,2,11,5,47,52
2011,1,19,2,12,5,65,70
2011,1,19,2,13,11,67,78
2011,1,19,2,14,7,68,75
2011,1,19,2,15,4,78,82
2011,1,19,2,16,10,93,103
2011,1,19,2,17,7,190,197
2011,1,19,2,18,5,156,161
2011,1,19,2,19,4,108,112
2011,1,19,2,20,2,74,76
2011,1,19,2,21,4,55,59
2011,1,19,2,22,6,53,59
2011,1,19,2,23,1,27,28
2011,1,20,3,0,5,8,13
2011,1,20,3,1,2,3,5
2011,1,20,3,2,0,2,2
2011,1,20,3,3,0,1,1
2011,1,20,3,4,0,1,1
2011,1,20,3,5,0,6,6
2011,1,20,3,6,0,35,35
2011,1,20,3,7,1,100,101
2011,1,20,3,8,2,247,249
2011,1,20,3,9,3,140,143
2011,1,20,3,10,1,56,57
2011,1,20,3,11,5,63,68
2011,1,20,3,12,7,77,84
2011,1,20,3,13,12,77,89
2011,1,20,3,14,6,75,81
2011,1,20,3,15,8,62,70
2011,1,20,3,16,7,83,90
2011,1,20,3,17,8,207,215
2011,1,20,3,18,1,184,185
2011,1,20,3,19,5,146,151
2011,1,20,3,20,2,124,126
2011,1,20,3,21,3,53,56
2011,1,20,3,22,0,56,56
2011,1,20,3,23,3,28,31
2011,1,21,4,0,1,20,21
2011,1,21,4,1,0,6,6
2011,1,21,4,2,0,2,2
2011,1,21,4,3,0,1,1
2011,1,21,4,4,0,1,1
2011,1,21,4,5,1,4,5
2011,1,21,4,6,0,27,27
2011,1,21,4,7,2,66,68
2011,1,21,4,8,7,208,215
2011,1,21,4,9,7,159,166
2011,1,21,4,10,6,56,62
2011,1,21,4,11,6,53,59
2011,1,21,4,12,10,66,76
2011,1,21,4,13,8,65,73
2011,1,21,4,14,5,56,61
2011,1,21,4,15,4,61,65
2011,1,21,4,16,0,97,97
2011,1,21,4,17,10,151,161
2011,1,21,4,18,1,119,120
2011,1,21,4,19,3,93,96
2011,1,21,4,20,1,52,53
2011,1,21,4,21,0,41,41
2011,1,21,4,22,1,33,34
2011,1,21,4,23,0,27,27
2011,1,22,5,0,0,13,13
2011,1,22,5,1,3,9,12
2011,1,22,5,2,0,11,11
2011,1,22,5,3,1,6,7
2011,1,22,5,4,0,3,3
2011,1,22,5,6,0,2,2
2011,1,22,5,7,0,8,8
2011,1,22,5,8,1,26,27
2011,1,22,5,9,3,37,40
2011,1,22,5,10,3,50,53
2011,1,22,5,11,4,59,63
2011,1,22,5,12,10,60,70
2011,1,22,5,13,12,72,84
2011,1,22,5,14,11,64,75
2011,1,22,5,15,10,93,103
2011,1,22,5,16,11,72,83
2011,1,22,5,17,8,59,67
2011,1,22,5,18,0,54,54
2011,1,22,5,19,6,53,59
2011,1,22,5,20,1,44,45
2011,1,22,5,21,0,39,39
2011,1,22,5,22,7,23,30
2011,1,22,5,23,2,31,33
2011,1,23,6,0,2,20,22
2011,1,23,6,1,1,12,13
2011,1,23,6,2,3,15,18
2011,1,23,6,3,1,4,5
2011,1,23,6,5,0,3,3
2011,1,23,6,6,0,1,1
2011,1,23,6,7,1,1,2
2011,1,23,6,8,2,17,19
2011,1,23,6,9,3,25,28
2011,1,23,6,10,7,51,58
2011,1,23,6,11,22,77,99
2011,1,23,6,12,24,92,116
2011,1,23,6,13,12,75,87
2011,1,23,6,14,17,93,110
2011,1,23,6,15,13,64,77
2011,1,23,6,16,9,56,65
2011,1,23,6,17,5,50,55
2011,1,23,6,18,5,44,49
2011,1,23,6,19,5,45,50
2011,1,23,6,20,4,31,35
2011,1,23,6,21,5,20,25
2011,1,23,6,22,5,23,28
2011,1,23,6,23,4,17,21
2011,1,24,0,0,0,7,7
2011,1,24,0,1,0,1,1
2011,1,24,0,3,0,1,1
2011,1,24,0,4,0,1,1
2011,1,24,0,5,0,5,5
2011,1,24,0,6,0,15,15
2011,1,24,0,7,5,78,83
2011,1,24,0,8,6,171,177
2011,1,24,0,9,4,98,102
2011,1,24,0,10,6,34,40
2011,1,24,0,11,3,43,46
2011,1,24,0,12,11,52,63
2011,1,24,0,13,6,54,60
2011,1,24,0,14,2,43,45
2011,1,24,0,15,7,50,57
2011,1,24,0,16,4,66,70
2011,1,24,0,17,6,178,184
2011,1,24,0,18,8,145,153
2011,1,24,0,19,5,101,106
2011,1,24,0,20,1,79,80
2011,1,24,0,21,6,53,59
2011,1,24,0,22,3,32,35
2011,1,24,0,23,3,21,24
2011,1,25,1,0,3,6,9
2011,1,25,1,1,0,5,5
2011,1,25,1,2,0,2,2
2011,1,25,1,4,0,1,1
2011,1,25,1,5,0,9,9
2011,1,25,1,6,1,35,36
2011,1,25,1,7,5,103,108
2011,1,25,1,8,5,231,236
2011,1,25,1,9,10,134,144
2011,1,25,1,10,6,49,55
2011,1,25,1,11,6,55,61
2011,1,25,1,12,21,85,106
2011,1,25,1,13,21,72,93
2011,1,25,1,14,11,57,68
2011,1,25,1,15,21,63,84
2011,1,25,1,16,14,102,116
2011,1,25,1,17,14,208,222
2011,1,25,1,18,7,218,225
2011,1,25,1,19,13,133,146
2011,1,25,1,20,16,102,118
2011,1,25,1,21,5,40,45
2011,1,25,1,22,4,49,53
2011,1,25,1,23,3,37,40
2011,1,26,2,0,3,14,17
2011,1,26,2,1,0,5,5
2011,1,26,2,2,3,7,10
2011,1,26,2,5,0,1,1
2011,1,26,2,6,0,8,8
2011,1,26,2,7,1,29,30
2011,1,26,2,8,3,69,72
2011,1,26,2,9,3,55,58
2011,1,26,2,10,2,26,28
2011,1,26,2,11,6,35,41
2011,1,26,2,12,7,39,46
2011,1,26,2,13,4,43,47
2011,1,26,2,14,0,36,36
2011,1,26,2,15,1,41,42
2011,1,26,2,16,1,35,36
2011,1,26,2,17,0,26,26
2011,1,27,3,16,1,23,24
2011,1,27,3,17,2,82,84
2011,1,27,3,18,3,101,104
2011,1,27,3,19,3,76,79
2011,1,27,3,20,4,54,58
2011,1,27,3,21,2,36,38
2011,1,27,3,22,0,27,27
2011,1,27,3,23,0,16,16
2011,1,28,4,0,0,9,9
2011,1,28,4,1,1,2,3
2011,1,28,4,2,0,2,2
2011,1,28,4,3,1,0,1
2011,1,28,4,5,0,4,4
2011,1,28,4,6,0,16,16
2011,1,28,4,7,2,58,60
2011,1,28,4,8,2,155,157
2011,1,28,4,9,6,95,101
2011,1,28,4,10,0,49,49
2011,1,28,4,11,0,30,30
2011,1,28,4,12,1,27,28
2011,1,28,4,13,0,31,31
2011,1,28,4,14,2,36,38
2011,1,28,4,15,1,40,41
2011,1,28,4,16,10,69,79
2011,1,28,4,17,2,147,149
2011,1,28,4,18,2,107,109
2011,1,28,4,19,5,84,89
2011,1,28,4,20,1,61,62
2011,1,28,4,21,1,57,58
2011,1,28,4,22,0,26,26
2011,1,28,4,23,1,22,23
2011,1,29,5,0,2,26,28
2011,1,29,5,1,0,20,20
2011,1,29,5,2,0,15,15
2011,1,29,5,3,3,5,8
2011,1,29,5,4,1,2,3
2011,1,29,5,6,0,2,2
2011,1,29,5,7,1,4,5
2011,1,29,5,8,3,31,34
2011,1,29,5,9,0,34,34
2011,1,29,5,10,4,51,55
2011,1,29,5,11,4,59,63
2011,1,29,5,12,12,66,78
2011,1,29,5,13,9,56,65
2011,1,29,5,14,10,89,99
2011,1,29,5,15,22,98,120
2011,1,29,5,16,19,88,107
2011,1,29,5,17,9,82,91
2011,1,29,5,18,9,59,68
2011,1,29,5,19,6,52,58
2011,1,29,5,20,1,42,43
2011,1,29,5,21,1,35,36
2011,1,29,5,22,4,28,32
2011,1,29,5,23,3,30,33
2011,1,30,6,0,0,33,33
2011,1,30,6,1,7,22,29
2011,1,30,6,2,1,10,11
2011,1,30,6,3,1,7,8
2011,1,30,6,4,0,1,1
2011,1,30,6,5,0,3,3
2011,1,30,6,7,0,3,3
2011,1,30,6,8,1,11,12
2011,1,30,6,9,4,34,38
2011,1,30,6,10,7,57,64
2011,1,30,6,11,9,50,59
2011,1,30,6,12,10,86,96
2011,1,30,6,13,13,71,84
2011,1,30,6,14,18,104,122
2011,1,30,6,15,14,95,109
2011,1,30,6,16,19,103,122
2011,1,30,6,17,6,70,76
2011,1,30,6,18,8,57,65
2011,1,30,6,19,9,46,55
2011,1,30,6,20,3,30,33
2011,1,30,6,21,3,25,28
2011,1,30,6,22,2,19,21
2011,1,30,6,23,5,16,21
2011,1,31,0,0,1,6,7
2011,1,31,0,1,2,5,7
2011,1,31,0,2,0,1,1
2011,1,31,0,3,0,2,2
2011,1,31,0,4,0,2,2
2011,1,31,0,5,0,8,8
2011,1,31,0,6,0,37,37
2011,1,31,0,7,1,71,72
2011,1,31,0,8,3,182,185
2011,1,31,0,9,0,112,112
2011,1,31,0,10,1,68,69
2011,1,31,0,11,2,46,48
2011,1,31,0,12,6,62,68
2011,1,31,0,13,2,52,54
2011,1,31,0,14,1,85,86
2011,1,31,0,15,3,41,44
2011,1,31,0,16,3,83,86
2011,1,31,0,17,6,155,161
2011,1,31,0,18,3,153,156
2011,1,31,0,19,3,108,111
2011,1,31,0,20,0,78,78
2011,1,31,0,21,3,53,56
2011,1,31,0,22,0,34,34
2011,1,31,0,23,2,15,17
2011,2,1,1,0,2,6,8
2011,2,1,1,1,0,3,3
2011,2,1,1,2,0,2,2
2011,2,1,1,3,0,2,2
2011,2,1,1,5,0,3,3
2011,2,1,1,6,0,22,22
2011,2,1,1,7,0,52,52
2011,2,1,1,8,3,132,135
2011,2,1,1,9,2,114,116
2011,2,1,1,10,0,47,47
2011,2,1,1,11,2,49,51
2011,2,1,1,12,2,53,55
2011,2,1,1,13,3,49,52
2011,2,1,1,14,5,49,54
2011,2,1,1,15,7,45,52
2011,2,1,1,16,3,61,64
2011,2,1,1,17,4,172,176
2011,2,1,1,18,3,165,168
2011,2,1,1,19,3,105,108
2011,2,1,1,20,5,69,74
2011,2,1,1,21,0,64,64
2011,2,1,1,22,2,34,36
2011,2,1,1,23,1,15,16
2011,2,2,2,0,0,2,2
2011,2,2,2,1,0,3,3
2011,2,2,2,2,4,0,4
2011,2,2,2,3,0,1,1
2011,2,2,2,4,0,1,1
2011,2,2,2,5,0,3,3
2011,2,2,2,6,1,17,18
2011,2,2,2,7,1,48,49
2011,2,2,2,8,1,154,155
2011,2,2,2,9,4,119,123
2011,2,2,2,10,2,59,61
2011,2,2,2,11,5,47,52
2011,2,2,2,12,3,60,63
2011,2,2,2,13,1,74,75
2011,2,2,2,14,2,61,63
2011,2,2,2,15,10,66,76
2011,2,2,2,16,8,95,103
2011,2,2,2,17,7,183,190
2011,2,2,2,18,7,174,181
2011,2,2,2,19,3,88,91
2011,2,2,2,20,4,71,75
2011,2,2,2,21,1,62,63
2011,2,2,2,22,5,35,40
2011,2,2,2,23,3,29,32
2011,2,3,3,0,1,11,12
2011,2,3,3,1,0,5,5
2011,2,3,3,2,0,2,2
2011,2,3,3,3,0,1,1
2011,2,3,3,5,0,2,2
2011,2,3,3,6,0,39,39
2011,2,3,3,7,1,85,86
2011,2,3,3,8,4,184,188
2011,2,3,3,9,6,127,133
2011,2,3,3,10,2,50,52
2011,2,3,3,11,9,55,64
2011,2,3,3,12,2,65,67
2011,2,3,3,13,4,47,51
2011,2,3,3,14,4,43,47
2011,2,3,3,15,4,56,60
2011,2,3,3,16,5,73,78
2011,2,3,3,17,5,170,175
2011,2,3,3,18,2,144,146
2011,2,3,3,19,4,91,95
2011,2,3,3,20,1,108,109
2011,2,3,3,21,1,53,54
2011,2,3,3,22,2,39,41
2011,2,3,3,23,4,34,38
2011,2,4,4,0,3,10,13
2011,2,4,4,1,0,7,7
2011,2,4,4,2,0,1,1
2011,2,4,4,3,0,1,1
2011,2,4,4,5,0,7,7
2011,2,4,4,6,2,26,28
2011,2,4,4,7,0,86,86
2011,2,4,4,8,3,216,219
2011,2,4,4,9,3,124,127
2011,2,4,4,10,5,46,51
2011,2,4,4,11,3,61,64
2011,2,4,4,12,8,78,86
2011,2,4,4,13,9,73,82
2011,2,4,4,14,15,76,91
2011,2,4,4,15,9,81,90
2011,2,4,4,16,8,91,99
2011,2,4,4,17,10,195,205
2011,2,4,4,18,3,152,155
2011,2,4,4,19,1,101,102
2011,2,4,4,20,2,69,71
2011,2,4,4,21,2,41,43
2011,2,4,4,22,1,45,46
2011,2,4,4,23,1,30,31
2011,2,5,5,0,3,36,39
2011,2,5,5,1,1,17,18
2011,2,5,5,2,5,12,17
2011,2,5,5,3,1,10,11
2011,2,5,5,4,0,8,8
2011,2,5,5,5,0,9,9
2011,2,5,5,6,0,4,4
2011,2,5,5,7,0,4,4
2011,2,5,5,8,0,10,10
2011,2,5,5,9,3,17,20
2011,2,5,5,10,3,31,34
2011,2,5,5,11,1,46,47
2011,2,5,5,12,10,42,52
2011,2,5,5,13,10,62,72
2011,2,5,5,14,5,50,55
2011,2,5,5,15,11,49,60
2011,2,5,5,16,8,63,71
2011,2,5,5,17,14,64,78
2011,2,5,5,18,2,81,83
2011,2,5,5,19,6,78,84
2011,2,5,5,20,5,64,69
2011,2,5,5,21,3,53,56
2011,2,5,5,22,2,43,45
2011,2,5,5,23,7,52,59
2011,2,6,6,0,2,37,39
2011,2,6,6,1,4,40,44
2011,2,6,6,2,0,20,20
2011,2,6,6,3,3,10,13
2011,2,6,6,4,0,2,2
2011,2,6,6,5,0,1,1
2011,2,6,6,6,0,1,1
2011,2,6,6,7,0,8,8
2011,2,6,6,8,2,21,23
2011,2,6,6,9,7,38,45
2011,2,6,6,10,15,74,89
2011,2,6,6,11,28,89,117
2011,2,6,6,12,48,125,173
2011,2,6,6,13,47,135,182
2011,2,6,6,14,47,113,160
2011,2,6,6,15,52,129,181
2011,2,6,6,16,42,115,157
2011,2,6,6,17,24,97,121
2011,2,6,6,18,13,65,78
2011,2,6,6,19,1,20,21
2011,2,6,6,20,5,21,26
2011,2,6,6,21,5,22,27
2011,2,6,6,22,5,57,62
2011,2,6,6,23,4,26,30
2011,2,7,0,0,1,14,15
2011,2,7,0,1,1,4,5
2011,2,7,0,2,0,3,3
2011,2,7,0,3,0,1,1
2011,2,7,0,4,1,1,2
2011,2,7,0,5,1,9,10
2011,2,7,0,6,1,29,30
2011,2,7,0,7,6,89,95
2011,2,7,0,8,7,221,228
2011,2,7,0,9,3,115,118
2011,2,7,0,10,6,49,55
2011,2,7,0,11,11,36,47
2011,2,7,0,12,7,59,66
2011,2,7,0,13,10,54,64
2011,2,7,0,14,8,52,60
2011,2,7,0,15,4,45,49
2011,2,7,0,16,16,98,114
2011,2,7,0,17,9,206,215
2011,2,7,0,18,5,170,175
2011,2,7,0,19,5,121,126
2011,2,7,0,20,6,82,88
2011,2,7,0,21,3,75,78
2011,2,7,0,22,3,34,37
2011,2,7,0,23,6,19,25
2011,2,8,1,0,4,6,10
2011,2,8,1,1,0,4,4
2011,2,8,1,2,1,1,2
2011,2,8,1,3,0,1,1
2011,2,8,1,4,0,3,3
2011,2,8,1,5,0,2,2
2011,2,8,1,6,0,39,39
2011,2,8,1,7,3,96,99
2011,2,8,1,8,7,235,242
2011,2,8,1,9,7,127,134
2011,2,8,1,10,4,44,48
2011,2,8,1,11,1,49,50
2011,2,8,1,12,2,63,65
2011,2,8,1,13,2,48,50
2011,2,8,1,14,3,61,64
2011,2,8,1,15,6,44,50
2011,2,8,1,16,4,79,83
2011,2,8,1,17,4,172,176
2011,2,8,1,18,1,150,151
2011,2,8,1,19,1,99,100
2011,2,8,1,20,3,53,56
2011,2,8,1,21,8,46,54
2011,2,8,1,22,0,29,29
2011,2,8,1,23,3,9,12
2011,2,9,2,0,0,17,17
2011,2,9,2,1,0,7,7
2011,2,9,2,2,1,2,3
2011,2,9,2,3,0,2,2
2011,2,9,2,5,0,7,7
2011,2,9,2,6,0,43,43
2011,2,9,2,7,4,94,98
2011,2,9,2,8,1,195,196
2011,2,9,2,9,3,118,121
2011,2,9,2,10,8,51,59
2011,2,9,2,11,1,40,41
2011,2,9,2,12,4,57,61
2011,2,9,2,13,2,67,69
2011,2,9,2,14,2,56,58
2011,2,9,2,15,3,60,63
2011,2,9,2,16,7,71,78
2011,2,9,2,17,9,157,166
2011,2,9,2,18,2,168,170
2011,2,9,2,19,1,87,88
2011,2,9,2,20,0,84,84
2011,2,9,2,21,0,83,83
2011,2,9,2,22,4,42,46
2011,2,9,2,23,0,37,37
2011,2,10,3,0,0,16,16
2011,2,10,3,1,0,7,7
2011,2,10,3,2,0,3,3
2011,2,10,3,4,0,1,1
2011,2,10,3,5,0,6,6
2011,2,10,3,6,0,26,26
2011,2,10,3,7,0,98,98
2011,2,10,3,8,4,172,176
2011,2,10,3,9,1,120,121
2011,2,10,3,10,1,34,35
2011,2,10,3,11,1,44,45
2011,2,10,3,12,4,65,69
2011,2,10,3,13,3,59,62
2011,2,10,3,14,6,42,48
2011,2,10,3,15,0,50,50
2011,2,10,3,16,4,76,80
2011,2,10,3,17,6,159,165
2011,2,10,3,18,3,157,160
2011,2,10,3,19,2,110,112
2011,2,10,3,20,4,93,97
2011,2,10,3,21,2,70,72
2011,2,10,3,22,4,47,51
2011,2,10,3,23,1,33,34
2011,2,11,4,0,2,12,14
2011,2,11,4,1,1,6,7
2011,2,11,4,2,0,3,3
2011,2,11,4,5,0,4,4
2011,2,11,4,6,1,23,24
2011,2,11,4,7,1,73,74
2011,2,11,4,8,4,210,214
2011,2,11,4,9,8,132,140
2011,2,11,4,10,5,37,42
2011,2,11,4,11,12,52,64
2011,2,11,4,12,7,62,69
2011,2,11,4,13,21,89,110
2011,2,11,4,14,17,67,84
2011,2,11,4,15,12,62,74
2011,2,11,4,16,14,111,125
2011,2,11,4,17,18,193,211
2011,2,11,4,18,9,165,174
2011,2,11,4,19,6,94,100
2011,2,11,4,20,2,61,63
2011,2,11,4,21,1,46,47
2011,2,11,4,22,2,41,43
2011,2,11,4,23,5,48,53
2011,2,12,5,0,3,27,30
2011,2,12,5,1,2,22,24
2011,2,12,5,2,2,13,15
2011,2,12,5,3,3,7,10
2011,2,12,5,4,0,4,4
2011,2,12,5,5,0,1,1
2011,2,12,5,6,1,1,2
2011,2,12,5,7,2,9,11
2011,2,12,5,8,2,28,30
2011,2,12,5,9,5,38,43
2011,2,12,5,10,13,71,84
2011,2,12,5,11,30,84,114
2011,2,12,5,12,27,93,120
2011,2,12,5,13,32,102,134
2011,2,12,5,14,30,90,120
2011,2,12,5,15,47,127,174
2011,2,12,5,16,42,103,145
2011,2,12,5,17,24,113,137
2011,2,12,5,18,4,60,64
2011,2,12,5,19,2,39,41
2011,2,12,5,20,1,39,40
2011,2,12,5,21,9,42,51
2011,2,12,5,22,6,39,45
2011,2,12,5,23,1,31,32
2011,2,13,6,0,5,34,39
2011,2,13,6,1,1,23,24
2011,2,13,6,2,1,19,20
2011,2,13,6,3,4,8,12
2011,2,13,6,4,0,2,2
2011,2,13,6,6,2,3,5
2011,2,13,6,7,0,3,3
2011,2,13,6,8,1,11,12
2011,2,13,6,9,12,35,47
2011,2,13,6,10,19,86,105
2011,2,13,6,11,26,86,112
2011,2,13,6,12,58,94,152
2011,2,13,6,13,62,92,154
2011,2,13,6,14,51,110,161
2011,2,13,6,15,40,122,162
2011,2,13,6,16,28,106,134
2011,2,13,6,17,30,95,125
2011,2,13,6,18,17,78,95
2011,2,13,6,19,11,50,61
2011,2,13,6,20,15,32,47
2011,2,13,6,21,6,45,51
2011,2,13,6,22,5,31,36
2011,2,13,6,23,3,27,30
2011,2,14,0,0,3,8,11
2011,2,14,0,1,1,6,7
2011,2,14,0,2,0,2,2
2011,2,14,0,3,1,1,2
2011,2,14,0,4,0,2,2
2011,2,14,0,5,0,3,3
2011,2,14,0,6,1,25,26
2011,2,14,0,7,2,96,98
2011,2,14,0,8,7,247,254
2011,2,14,0,9,8,121,129
2011,2,14,0,10,9,46,55
2011,2,14,0,11,10,43,53
2011,2,14,0,12,27,97,124
2011,2,14,0,13,27,92,119
2011,2,14,0,14,14,75,89
2011,2,14,0,15,19,71,90
2011,2,14,0,16,16,102,118
2011,2,14,0,17,25,218,243
2011,2,14,0,18,11,194,205
2011,2,14,0,19,12,86,98
2011,2,14,0,20,5,65,70
2011,2,14,0,21,8,35,43
2011,2,14,0,22,1,44,45
2011,2,14,0,23,1,19,20
2011,2,15,1,0,7,12,19
2011,2,15,1,1,0,5,5
2011,2,15,1,2,1,2,3
2011,2,15,1,4,0,1,1
2011,2,15,1,5,0,4,4
2011,2,15,1,6,0,30,30
2011,2,15,1,7,2,102,104
2011,2,15,1,8,10,211,221
2011,2,15,1,9,2,108,110
2011,2,15,1,10,5,47,52
2011,2,15,1,11,11,46,57
2011,2,15,1,12,6,65,71
2011,2,15,1,13,14,68,82
2011,2,15,1,14,10,69,79
2011,2,15,1,15,11,74,85
2011,2,15,1,16,21,77,98
2011,2,15,1,17,14,190,204
2011,2,15,1,18,14,198,212
2011,2,15,1,19,3,141,144
2011,2,15,1,20,3,97,100
2011,2,15,1,21,5,61,66
2011,2,15,1,22,0,41,41
2011,2,15,1,23,0,20,20
2011,2,16,2,0,0,15,15
2011,2,16,2,1,0,9,9
2011,2,16,2,3,0,1,1
2011,2,16,2,4,0,1,1
2011,2,16,2,5,0,5,5
2011,2,16,2,6,1,31,32
2011,2,16,2,7,5,103,108
2011,2,16,2,8,6,222,228
2011,2,16,2,9,2,121,123
2011,2,16,2,10,14,55,69
2011,2,16,2,11,7,59,66
2011,2,16,2,12,14,72,86
2011,2,16,2,13,13,79,92
2011,2,16,2,14,17,65,82
2011,2,16,2,15,35,82,117
2011,2,16,2,16,26,95,121
2011,2,16,2,17,11,244,255
2011,2,16,2,18,20,202,222
2011,2,16,2,19,18,143,161
2011,2,16,2,20,10,108,118
2011,2,16,2,21,5,86,91
2011,2,16,2,22,12,61,73
2011,2,16,2,23,2,31,33
2011,2,17,3,0,1,16,17
2011,2,17,3,1,0,6,6
2011,2,17,3,2,2,4,6
2011,2,17,3,3,3,1,4
2011,2,17,3,4,3,1,4
2011,2,17,3,5,1,11,12
2011,2,17,3,6,3,44,47
2011,2,17,3,7,7,119,126
2011,2,17,3,8,18,264,282
2011,2,17,3,9,16,163,179
2011,2,17,3,10,18,70,88
2011,2,17,3,11,19,71,90
2011,2,17,3,12,15,86,101
2011,2,17,3,13,15,107,122
2011,2,17,3,14,26,55,81
2011,2,17,3,15,14,91,105
2011,2,17,3,16,29,117,146
2011,2,17,3,17,18,256,274
2011,2,17,3,18,11,211,222
2011,2,17,3,19,14,161,175
2011,2,17,3,20,8,131,139
2011,2,17,3,21,5,118,123
2011,2,17,3,22,8,68,76
2011,2,17,3,23,4,40,44
2011,2,18,4,0,12,20,32
2011,2,18,4,1,1,7,8
2011,2,18,4,2,2,5,7
2011,2,18,4,3,2,6,8
2011,2,18,4,4,0,1,1
2011,2,18,4,5,1,6,7
2011,2,18,4,6,2,48,50
2011,2,18,4,7,8,108,116
2011,2,18,4,8,25,243,268
2011,2,18,4,9,15,154,169
2011,2,18,4,10,17,78,95
2011,2,18,4,11,31,82,113
2011,2,18,4,12,59,126,185
2011,2,18,4,13,45,130,175
2011,2,18,4,14,73,118,191
2011,2,18,4,15,55,117,172
2011,2,18,4,16,68,164,232
2011,2,18,4,17,52,275,327
2011,2,18,4,18,29,195,224
2011,2,18,4,19,16,146,162
2011,2,18,4,20,19,105,124
2011,2,18,4,21,11,61,72
2011,2,18,4,22,19,88,107
2011,2,18,4,23,16,61,77
2011,2,19,5,0,6,23,29
2011,2,19,5,1,10,21,31
2011,2,19,5,2,3,14,17
2011,2,19,5,3,0,7,7
2011,2,19,5,4,0,3,3
2011,2,19,5,5,0,3,3
2011,2,19,5,6,3,3,6
2011,2,19,5,7,6,16,22
2011,2,19,5,8,9,36,45
2011,2,19,5,9,18,37,55
2011,2,19,5,10,34,72,106
2011,2,19,5,11,47,76,123
2011,2,19,5,12,38,80,118
2011,2,19,5,13,52,103,155
2011,2,19,5,14,102,94,196
2011,2,19,5,15,84,87,171
2011,2,19,5,16,39,81,120
2011,2,19,5,17,36,91,127
2011,2,19,5,18,21,67,88
2011,2,19,5,19,5,54,59
2011,2,19,5,20,9,38,47
2011,2,19,5,21,4,29,33
2011,2,19,5,22,2,42,44
2011,2,19,5,23,4,25,29
2011,2,20,6,0,3,14,17
2011,2,20,6,1,5,11,16
2011,2,20,6,2,0,17,17
2011,2,20,6,3,9,9,18
2011,2,20,6,4,0,1,1
2011,2,20,6,6,1,1,2
2011,2,20,6,7,0,2,2
2011,2,20,6,8,2,22,24
2011,2,20,6,9,7,48,55
2011,2,20,6,10,34,70,104
2011,2,20,6,11,72,89,161
2011,2,20,6,12,62,120,182
2011,2,20,6,13,76,122,198
2011,2,20,6,14,108,104,212
2011,2,20,6,15,66,102,168
2011,2,20,6,16,59,88,147
2011,2,20,6,17,60,86,146
2011,2,20,6,18,30,71,101
2011,2,20,6,19,3,39,42
2011,2,20,6,20,12,30,42
2011,2,20,6,21,17,39,56
2011,2,20,6,22,4,43,47
2011,2,20,6,23,9,45,54
2011,2,21,0,0,7,30,37
2011,2,21,0,1,2,11,13
2011,2,21,0,2,1,3,4
2011,2,21,0,3,2,3,5
2011,2,21,0,4,1,0,1
2011,2,21,0,5,1,2,3
2011,2,21,0,6,2,6,8
2011,2,21,0,7,3,16,19
2011,2,21,0,8,7,56,63
2011,2,21,0,9,11,46,57
2011,2,21,0,10,29,52,81
2011,2,21,0,11,20,70,90
2011,2,21,0,12,26,67,93
2011,2,21,0,13,28,75,103
2011,2,21,0,14,15,100,115
2011,2,21,0,15,11,76,87
2011,2,21,0,16,8,48,56
2011,2,21,0,17,18,62,80
2011,2,21,0,18,2,64,66
2011,2,21,0,19,0,49,49
2011,2,21,0,20,0,28,28
2011,2,21,0,21,1,33,34
2011,2,21,0,22,0,11,11
2011,2,21,0,23,0,2,2
2011,2,22,1,6,0,7,7
2011,2,22,1,7,0,38,38
2011,2,22,1,8,7,104,111
2011,2,22,1,9,5,101,106
2011,2,22,1,10,0,44,44
2011,2,22,1,11,7,43,50
2011,2,22,1,12,7,47,54
2011,2,22,1,13,3,52,55
2011,2,22,1,14,9,49,58
2011,2,22,1,15,1,66,67
2011,2,22,1,16,7,79,86
2011,2,22,1,17,8,188,196
2011,2,22,1,18,6,161,167
2011,2,22,1,19,4,113,117
2011,2,22,1,20,3,102,105
2011,2,22,1,21,2,80,82
2011,2,22,1,22,1,76,77
2011,2,22,1,23,3,18,21
2011,2,23,2,0,0,6,6
2011,2,23,2,1,0,4,4
2011,2,23,2,2,0,1,1
2011,2,23,2,3,0,2,2
2011,2,23,2,5,0,8,8
2011,2,23,2,6,0,36,36
2011,2,23,2,7,2,92,94
2011,2,23,2,8,8,223,231
2011,2,23,2,9,9,129,138
2011,2,23,2,10,4,47,51
2011,2,23,2,11,16,53,69
2011,2,23,2,12,11,56,67
2011,2,23,2,13,9,78,87
2011,2,23,2,14,17,61,78
2011,2,23,2,15,18,54,72
2011,2,23,2,16,15,79,94
2011,2,23,2,17,15,207,222
2011,2,23,2,18,3,206,209
2011,2,23,2,19,6,135,141
2011,2,23,2,20,2,105,107
2011,2,23,2,21,2,89,91
2011,2,23,2,22,1,60,61
2011,2,23,2,23,1,38,39
2011,2,24,3,0,0,11,11
2011,2,24,3,1,0,7,7
2011,2,24,3,2,0,4,4
2011,2,24,3,3,0,2,2
2011,2,24,3,5,1,3,4
2011,2,24,3,6,0,58,58
2011,2,24,3,7,0,104,104
2011,2,24,3,8,8,240,248
2011,2,24,3,9,4,133,137
2011,2,24,3,10,8,49,57
2011,2,24,3,11,8,71,79
2011,2,24,3,12,10,85,95
2011,2,24,3,13,16,72,88
2011,2,24,3,14,2,67,69
2011,2,24,3,15,5,58,63
2011,2,24,3,16,4,67,71
2011,2,24,3,17,9,168,177
2011,2,24,3,18,5,132,137
2011,2,24,3,19,3,110,113
2011,2,24,3,20,2,87,89
2011,2,24,3,21,7,76,83
2011,2,24,3,22,5,50,55
2011,2,24,3,23,3,47,50
2011,2,25,4,0,1,8,9
2011,2,25,4,1,1,9,10
2011,2,25,4,2,0,3,3
2011,2,25,4,3,1,1,2
2011,2,25,4,5,1,5,6
2011,2,25,4,6,0,11,11
2011,2,25,4,7,1,34,35
2011,2,25,4,8,3,67,70
2011,2,25,4,9,3,111,114
2011,2,25,4,10,7,42,49
2011,2,25,4,11,9,49,58
2011,2,25,4,12,20,94,114
2011,2,25,4,13,6,77,83
2011,2,25,4,14,14,71,85
2011,2,25,4,15,5,49,54
2011,2,25,4,16,11,91,102
2011,2,25,4,17,8,181,189
2011,2,25,4,18,7,150,157
2011,2,25,4,19,4,85,89
2011,2,25,4,20,2,60,62
2011,2,25,4,21,7,56,63
2011,2,25,4,22,7,43,50
2011,2,25,4,23,2,37,39
2011,2,26,5,0,3,25,28
2011,2,26,5,1,2,25,27
2011,2,26,5,2,3,9,12
2011,2,26,5,3,1,7,8
2011,2,26,5,4,1,1,2
2011,2,26,5,5,1,9,10
2011,2,26,5,6,1,6,7
2011,2,26,5,7,1,21,22
2011,2,26,5,8,2,55,57
2011,2,26,5,9,9,65,74
2011,2,26,5,10,14,71,85
2011,2,26,5,11,26,100,126
2011,2,26,5,12,45,115,160
2011,2,26,5,13,38,136,174
2011,2,26,5,14,57,154,211
2011,2,26,5,15,40,125,165
2011,2,26,5,16,41,129,170
2011,2,26,5,17,53,130,183
2011,2,26,5,18,26,111,137
2011,2,26,5,19,30,64,94
2011,2,26,5,20,8,60,68
2011,2,26,5,21,9,59,68
2011,2,26,5,22,8,38,46
2011,2,26,5,23,5,29,34
2011,2,27,6,0,8,26,34
2011,2,27,6,1,7,30,37
2011,2,27,6,2,2,20,22
2011,2,27,6,3,3,8,11
2011,2,27,6,4,0,2,2
2011,2,27,6,6,2,1,3
2011,2,27,6,7,6,8,14
2011,2,27,6,8,9,26,35
2011,2,27,6,9,17,42,59
2011,2,27,6,10,24,79,103
2011,2,27,6,11,33,92,125
2011,2,27,6,12,61,132,193
2011,2,27,6,13,90,169,259
2011,2,27,6,14,105,177,282
2011,2,27,6,15,98,163,261
2011,2,27,6,16,98,170,268
2011,2,27,6,17,66,121,187
2011,2,27,6,18,24,103,127
2011,2,27,6,19,16,85,101
2011,2,27,6,20,9,72,81
2011,2,27,6,21,8,61,69
2011,2,27,6,22,2,67,69
2011,2,27,6,23,6,53,59
2011,2,28,0,0,5,25,30
2011,2,28,0,1,1,7,8
2011,2,28,0,3,0,1,1
2011,2,28,0,5,1,4,5
2011,2,28,0,6,1,27,28
2011,2,28,0,7,2,90,92
2011,2,28,0,8,13,239,252
2011,2,28,0,9,15,126,141
2011,2,28,0,10,13,78,91
2011,2,28,0,11,13,74,87
2011,2,28,0,12,0,36,36
2011,2,28,0,13,1,31,32
2011,2,28,0,14,1,24,25
2011,2,28,0,15,0,35,35
2011,2,28,0,16,2,39,41
2011,2,28,0,17,2,77,79
2011,2,28,0,18,4,127,131
2011,2,28,0,19,1,78,79
2011,2,28,0,20,0,45,45
2011,2,28,0,21,2,78,80
2011,2,28,0,22,4,72,76
2011,2,28,0,23,0,45,45
2011,3,1,1,0,0,7,7
2011,3,1,1,1,0,3,3
2011,3,1,1,2,0,4,4
2011,3,1,1,3,0,2,2
2011,3,1,1,4,0,1,1
2011,3,1,1,5,1,1,2
2011,3,1,1,6,0,46,46
2011,3,1,1,7,2,104,106
2011,3,1,1,8,10,202,212
2011,3,1,1,9,8,115,123
2011,3,1,1,10,13,54,67
2011,3,1,1,11,8,47,55
2011,3,1,1,12,6,80,86
2011,3,1,1,13,13,65,78
2011,3,1,1,14,18,61,79
2011,3,1,1,15,7,57,64
2011,3,1,1,16,10,92,102
2011,3,1,1,17,12,229,241
2011,3,1,1,18,10,214,224
2011,3,1,1,19,4,115,119
2011,3,1,1,20,2,86,88
2011,3,1,1,21,8,55,63
2011,3,1,1,22,3,43,46
2011,3,1,1,23,2,23,25
2011,3,2,2,0,3,5,8
2011,3,2,2,1,0,4,4
2011,3,2,2,2,0,2,2
2011,3,2,2,3,3,1,4
2011,3,2,2,4,1,0,1
2011,3,2,2,5,0,5,5
2011,3,2,2,6,1,39,40
2011,3,2,2,7,2,107,109
2011,3,2,2,8,13,241,254
2011,3,2,2,9,7,141,148
2011,3,2,2,10,11,65,76
2011,3,2,2,11,8,65,73
2011,3,2,2,12,20,62,82
2011,3,2,2,13,35,90,125
2011,3,2,2,14,21,75,96
2011,3,2,2,15,19,91,110
2011,3,2,2,16,27,110,137
2011,3,2,2,17,30,238,268
2011,3,2,2,18,8,193,201
2011,3,2,2,19,6,144,150
2011,3,2,2,20,9,85,94
2011,3,2,2,21,3,68,71
2011,3,2,2,22,4,44,48
2011,3,2,2,23,0,21,21
2011,3,3,3,0,3,10,13
2011,3,3,3,1,0,1,1
2011,3,3,3,2,1,2,3
2011,3,3,3,3,0,1,1
2011,3,3,3,4,0,1,1
2011,3,3,3,5,1,7,8
2011,3,3,3,6,1,34,35
2011,3,3,3,7,1,107,108
2011,3,3,3,8,4,213,217
2011,3,3,3,9,10,135,145
2011,3,3,3,10,7,48,55
2011,3,3,3,11,10,40,50
2011,3,3,3,12,7,65,72
2011,3,3,3,13,13,67,80
2011,3,3,3,14,18,60,78
2011,3,3,3,15,6,62,68
2011,3,3,3,16,6,65,71
2011,3,3,3,17,17,185,202
2011,3,3,3,18,6,161,167
2011,3,3,3,19,5,101,106
2011,3,3,3,20,1,69,70
2011,3,3,3,21,3,48,51
2011,3,3,3,22,3,50,53
2011,3,3,3,23,0,22,22
2011,3,4,4,0,0,12,12
2011,3,4,4,1,0,4,4
2011,3,4,4,2,0,2,2
2011,3,4,4,3,0,1,1
2011,3,4,4,4,1,0,1
2011,3,4,4,5,0,7,7
2011,3,4,4,6,1,28,29
2011,3,4,4,7,0,80,80
2011,3,4,4,8,6,221,227
2011,3,4,4,9,12,137,149
2011,3,4,4,10,10,55,65
2011,3,4,4,11,16,73,89
2011,3,4,4,12,10,87,97
2011,3,4,4,13,13,74,87
2011,3,4,4,14,30,65,95
2011,3,4,4,15,31,75,106
2011,3,4,4,16,17,101,118
2011,3,4,4,17,22,206,228
2011,3,4,4,18,15,170,185
2011,3,4,4,19,5,102,107
2011,3,4,4,20,9,78,87
2011,3,4,4,21,6,64,70
2011,3,4,4,22,4,40,44
2011,3,4,4,23,6,40,46
2011,3,5,5,0,4,15,19
2011,3,5,5,1,5,20,25
2011,3,5,5,2,5,15,20
2011,3,5,5,3,0,2,2
2011,3,5,5,4,0,1,1
2011,3,5,5,5,0,3,3
2011,3,5,5,6,1,3,4
2011,3,5,5,7,5,10,15
2011,3,5,5,8,11,34,45
2011,3,5,5,9,15,48,63
2011,3,5,5,10,34,69,103
2011,3,5,5,11,43,116,159
2011,3,5,5,12,46,121,167
2011,3,5,5,13,60,129,189
2011,3,5,5,14,80,118,198
2011,3,5,5,15,83,121,204
2011,3,5,5,16,74,130,204
2011,3,5,5,17,60,103,163
2011,3,5,5,18,37,114,151
2011,3,5,5,19,27,62,89
2011,3,5,5,20,12,58,70
2011,3,5,5,21,12,60,72
2011,3,5,5,22,16,47,63
2011,3,5,5,23,10,34,44
2011,3,6,6,0,11,41,52
2011,3,6,6,1,12,27,39
2011,3,6,6,2,5,27,32
2011,3,6,6,3,2,9,11
2011,3,6,6,4,0,3,3
2011,3,6,6,6,1,1,2
2011,3,6,6,7,0,5,5
2011,3,6,6,8,1,8,9
2011,3,6,6,9,4,18,22
2011,3,6,6,10,4,27,31
2011,3,6,6,11,18,44,62
2011,3,6,6,12,10,69,79
2011,3,6,6,13,22,83,105
2011,3,6,6,14,12,27,39
2011,3,6,6,15,3,4,7
2011,3,6,6,16,3,8,11
2011,3,6,6,17,2,23,25
2011,3,6,6,18,0,23,23
2011,3,6,6,19,0,11,11
2011,3,6,6,20,3,7,10
2011,3,6,6,21,1,6,7
2011,3,6,6,22,0,10,10
2011,3,6,6,23,0,9,9
2011,3,7,0,0,0,4,4
2011,3,7,0,1,0,2,2
2011,3,7,0,3,0,1,1
2011,3,7,0,4,1,0,1
2011,3,7,0,5,0,1,1
2011,3,7,0,6,3,31,34
2011,3,7,0,7,3,87,90
2011,3,7,0,8,11,199,210
2011,3,7,0,9,5,129,134
2011,3,7,0,10,15,43,58
2011,3,7,0,11,19,41,60
2011,3,7,0,12,28,68,96
2011,3,7,0,13,15,54,69
2011,3,7,0,14,21,56,77
2011,3,7,0,15,32,64,96
2011,3,7,0,16,26,96,122
2011,3,7,0,17,27,206,233
2011,3,7,0,18,19,214,233
2011,3,7,0,19,11,134,145
2011,3,7,0,20,5,86,91
2011,3,7,0,21,1,52,53
2011,3,7,0,22,1,34,35
2011,3,7,0,23,0,22,22
2011,3,8,1,0,1,9,10
2011,3,8,1,1,0,3,3
2011,3,8,1,2,1,0,1
2011,3,8,1,3,5,2,7
2011,3,8,1,4,0,2,2
2011,3,8,1,5,2,8,10
2011,3,8,1,6,3,42,45
2011,3,8,1,7,9,116,125
2011,3,8,1,8,10,246,256
2011,3,8,1,9,11,140,151
2011,3,8,1,10,25,46,71
2011,3,8,1,11,26,52,78
2011,3,8,1,12,28,70,98
2011,3,8,1,13,25,72,97
2011,3,8,1,14,16,55,71
2011,3,8,1,15,35,76,111
2011,3,8,1,16,26,82,108
2011,3,8,1,17,39,209,248
2011,3,8,1,18,21,213,234
2011,3,8,1,19,9,141,150
2011,3,8,1,20,2,74,76
2011,3,8,1,21,7,68,75
2011,3,8,1,22,11,44,55
2011,3,8,1,23,3,38,41
2011,3,9,2,0,0,9,9
2011,3,9,2,1,0,4,4
2011,3,9,2,2,1,1,2
2011,3,9,2,3,1,2,3
2011,3,9,2,4,0,2,2
2011,3,9,2,5,1,7,8
2011,3,9,2,6,5,44,49
2011,3,9,2,7,18,120,138
2011,3,9,2,8,11,234,245
2011,3,9,2,9,5,135,140
2011,3,9,2,10,8,49,57
2011,3,9,2,11,15,44,59
2011,3,9,2,12,14,84,98
2011,3,9,2,13,17,82,99
2011,3,9,2,14,10,61,71
2011,3,9,2,15,15,64,79
2011,3,9,2,16,10,101,111
2011,3,9,2,17,18,176,194
2011,3,9,2,18,12,175,187
2011,3,9,2,19,11,123,134
2011,3,9,2,20,4,87,91
2011,3,9,2,21,10,52,62
2011,3,9,2,22,4,17,21
2011,3,9,2,23,1,17,18
2011,3,10,3,0,3,0,3
2011,3,10,3,1,0,2,2
2011,3,10,3,2,0,1,1
2011,3,10,3,5,1,2,3
2011,3,10,3,6,0,12,12
2011,3,10,3,7,1,35,36
2011,3,10,3,8,1,41,42
2011,3,10,3,9,1,23,24
2011,3,10,3,10,0,17,17
2011,3,10,3,11,6,5,11
2011,3,10,3,12,4,30,34
2011,3,10,3,13,1,11,12
2011,3,10,3,14,0,12,12
2011,3,10,3,15,3,11,14
2011,3,10,3,16,1,20,21
2011,3,10,3,17,2,109,111
2011,3,10,3,18,2,80,82
2011,3,10,3,19,5,51,56
2011,3,10,3,20,9,29,38
2011,3,10,3,21,1,27,28
2011,3,10,3,22,4,30,34
2011,3,10,3,23,1,26,27
2011,3,11,4,0,0,6,6
2011,3,11,4,1,0,8,8
2011,3,11,4,2,2,3,5
2011,3,11,4,3,0,2,2
2011,3,11,4,5,1,6,7
2011,3,11,4,6,1,31,32
2011,3,11,4,7,10,103,113
2011,3,11,4,8,14,242,256
2011,3,11,4,9,13,143,156
2011,3,11,4,10,18,60,78
2011,3,11,4,11,14,66,80
2011,3,11,4,12,15,96,111
2011,3,11,4,13,15,92,107
2011,3,11,4,14,25,64,89
2011,3,11,4,15,21,64,85
2011,3,11,4,16,18,94,112
2011,3,11,4,17,23,200,223
2011,3,11,4,18,19,134,153
2011,3,11,4,19,7,111,118
2011,3,11,4,20,6,70,76
2011,3,11,4,21,10,43,53
2011,3,11,4,22,11,53,64
2011,3,11,4,23,3,34,37
2011,3,12,5,0,4,30,34
2011,3,12,5,1,3,15,18
2011,3,12,5,2,0,14,14
2011,3,12,5,3,1,6,7
2011,3,12,5,4,0,1,1
2011,3,12,5,5,0,2,2
2011,3,12,5,6,2,2,4
2011,3,12,5,7,4,19,23
2011,3,12,5,8,9,44,53
2011,3,12,5,9,25,76,101
2011,3,12,5,10,21,78,99
2011,3,12,5,11,36,83,119
2011,3,12,5,12,51,107,158
2011,3,12,5,13,62,95,157
2011,3,12,5,14,70,96,166
2011,3,12,5,15,81,101,182
2011,3,12,5,16,100,144,244
2011,3,12,5,17,99,114,213
2011,3,12,5,18,54,91,145
2011,3,12,5,19,26,86,112
2011,3,12,5,20,22,64,86
2011,3,12,5,21,36,46,82
2011,3,12,5,22,7,56,63
2011,3,12,5,23,11,38,49
2011,3,13,6,0,3,35,38
2011,3,13,6,1,10,23,33
2011,3,13,6,3,6,17,23
2011,3,13,6,4,4,9,13
2011,3,13,6,5,0,3,3
2011,3,13,6,6,0,2,2
2011,3,13,6,7,2,8,10
2011,3,13,6,8,11,23,34
2011,3,13,6,9,8,36,44
2011,3,13,6,10,36,86,122
2011,3,13,6,11,88,93,181
2011,3,13,6,12,74,120,194
2011,3,13,6,13,97,124,221
2011,3,13,6,14,144,106,250
2011,3,13,6,15,148,155,303
2011,3,13,6,16,122,132,254
2011,3,13,6,17,98,143,241
2011,3,13,6,18,55,92,147
2011,3,13,6,19,28,73,101
2011,3,13,6,20,23,53,76
2011,3,13,6,21,9,49,58
2011,3,13,6,22,8,29,37
2011,3,13,6,23,5,23,28
2011,3,14,0,0,4,7,11
2011,3,14,0,1,0,1,1
2011,3,14,0,2,0,1,1
2011,3,14,0,3,0,3,3
2011,3,14,0,5,0,8,8
2011,3,14,0,6,1,27,28
2011,3,14,0,7,4,84,88
2011,3,14,0,8,24,216,240
2011,3,14,0,9,13,127,140
2011,3,14,0,10,27,56,83
2011,3,14,0,11,26,44,70
2011,3,14,0,12,40,54,94
2011,3,14,0,13,24,51,75
2011,3,14,0,14,27,52,79
2011,3,14,0,15,24,77,101
2011,3,14,0,16,27,80,107
2011,3,14,0,17,42,229,271
2011,3,14,0,18,25,210,235
2011,3,14,0,19,17,133,150
2011,3,14,0,20,23,106,129
2011,3,14,0,21,5,58,63
2011,3,14,0,22,4,43,47
2011,3,14,0,23,2,17,19
2011,3,15,1,0,7,7,14
2011,3,15,1,1,4,6,10
2011,3,15,1,2,1,2,3
2011,3,15,1,4,1,1,2
2011,3,15,1,5,0,11,11
2011,3,15,1,6,3,32,35
2011,3,15,1,7,10,109,119
2011,3,15,1,8,23,255,278
2011,3,15,1,9,10,147,157
2011,3,15,1,10,22,56,78
2011,3,15,1,11,27,51,78
2011,3,15,1,12,32,69,101
2011,3,15,1,13,23,72,95
2011,3,15,1,14,14,74,88
2011,3,15,1,15,24,64,88
2011,3,15,1,16,21,93,114
2011,3,15,1,17,22,195,217
2011,3,15,1,18,18,207,225
2011,3,15,1,19,14,137,151
2011,3,15,1,20,9,79,88
2011,3,15,1,21,2,53,55
2011,3,15,1,22,1,20,21
2011,3,15,1,23,1,17,18
2011,3,16,2,0,0,8,8
2011,3,16,2,1,1,2,3
2011,3,16,2,3,1,2,3
2011,3,16,2,4,0,1,1
2011,3,16,2,5,0,3,3
2011,3,16,2,6,1,30,31
2011,3,16,2,7,10,100,110
2011,3,16,2,8,26,225,251
2011,3,16,2,9,10,144,154
2011,3,16,2,10,19,47,66
2011,3,16,2,11,13,62,75
2011,3,16,2,12,23,65,88
2011,3,16,2,13,18,81,99
2011,3,16,2,14,33,67,100
2011,3,16,2,15,22,79,101
2011,3,16,2,16,30,121,151
2011,3,16,2,17,37,216,253
2011,3,16,2,18,26,211,237
2011,3,16,2,19,18,150,168
2011,3,16,2,20,10,111,121
2011,3,16,2,21,3,75,78
2011,3,16,2,22,11,48,59
2011,3,16,2,23,9,18,27
2011,3,17,3,0,4,19,23
2011,3,17,3,1,1,11,12
2011,3,17,3,2,3,5,8
2011,3,17,3,3,1,1,2
2011,3,17,3,4,0,3,3
2011,3,17,3,5,0,13,13
2011,3,17,3,6,4,47,51
2011,3,17,3,7,12,128,140
2011,3,17,3,8,17,281,298
2011,3,17,3,9,23,161,184
2011,3,17,3,10,9,69,78
2011,3,17,3,11,20,66,86
2011,3,17,3,12,24,81,105
2011,3,17,3,13,26,84,110
2011,3,17,3,14,32,87,119
2011,3,17,3,15,30,95,125
2011,3,17,3,16,34,108,142
2011,3,17,3,17,48,265,313
2011,3,17,3,18,49,259,308
2011,3,17,3,19,18,188,206
2011,3,17,3,20,25,111,136
2011,3,17,3,21,19,118,137
2011,3,17,3,22,17,70,87
2011,3,17,3,23,7,43,50
2011,3,18,4,0,5,24,29
2011,3,18,4,1,4,12,16
2011,3,18,4,2,5,9,14
2011,3,18,4,3,1,4,5
2011,3,18,4,5,2,8,10
2011,3,18,4,6,1,34,35
2011,3,18,4,7,11,111,122
2011,3,18,4,8,24,254,278
2011,3,18,4,9,18,191,209
2011,3,18,4,10,43,73,116
2011,3,18,4,11,55,104,159
2011,3,18,4,12,72,123,195
2011,3,18,4,13,57,118,175
2011,3,18,4,14,71,101,172
2011,3,18,4,15,61,111,172
2011,3,18,4,16,67,137,204
2011,3,18,4,17,95,235,330
2011,3,18,4,18,84,247,331
2011,3,18,4,19,58,132,190
2011,3,18,4,20,46,102,148
2011,3,18,4,21,22,91,113
2011,3,18,4,22,55,63,118
2011,3,18,4,23,26,60,86
2011,3,19,5,0,26,50,76
2011,3,19,5,1,16,35,51
2011,3,19,5,2,5,20,25
2011,3,19,5,3,1,7,8
2011,3,19,5,4,1,2,3
2011,3,19,5,5,0,2,2
2011,3,19,5,6,0,10,10
2011,3,19,5,7,4,9,13
2011,3,19,5,8,11,37,48
2011,3,19,5,9,35,40,75
2011,3,19,5,10,55,84,139
2011,3,19,5,11,90,106,196
2011,3,19,5,12,126,141,267
2011,3,19,5,13,174,127,301
2011,3,19,5,14,168,144,312
2011,3,19,5,15,170,142,312
2011,3,19,5,16,175,129,304
2011,3,19,5,17,138,140,278
2011,3,19,5,18,91,125,216
2011,3,19,5,19,38,116,154
2011,3,19,5,20,39,68,107
2011,3,19,5,21,20,73,93
2011,3,19,5,22,27,45,72
2011,3,19,5,23,13,37,50
2011,3,20,6,0,7,33,40
2011,3,20,6,1,2,22,24
2011,3,20,6,2,6,24,30
2011,3,20,6,3,1,11,12
2011,3,20,6,4,2,1,3
2011,3,20,6,5,3,6,9
2011,3,20,6,6,1,3,4
2011,3,20,6,7,5,9,14
2011,3,20,6,8,7,30,37
2011,3,20,6,9,35,43,78
2011,3,20,6,10,55,81,136
2011,3,20,6,11,92,111,203
2011,3,20,6,12,120,108,228
2011,3,20,6,13,88,115,203
2011,3,20,6,14,145,134,279
2011,3,20,6,15,172,136,308
2011,3,20,6,16,92,132,224
2011,3,20,6,17,83,140,223
2011,3,20,6,18,58,98,156
2011,3,20,6,19,21,58,79
2011,3,20,6,20,21,46,67
2011,3,20,6,21,10,39,49
2011,3,20,6,22,8,30,38
2011,3,20,6,23,13,11,24
2011,3,21,0,0,2,11,13
2011,3,21,0,1,1,6,7
2011,3,21,0,2,1,5,6
2011,3,21,0,3,0,1,1
2011,3,21,0,5,1,1,2
2011,3,21,0,6,2,30,32
2011,3,21,0,7,3,15,18
2011,3,21,0,8,3,92,95
2011,3,21,0,9,12,115,127
2011,3,21,0,10,17,44,61
2011,3,21,0,11,32,47,79
2011,3,21,0,12,25,56,81
2011,3,21,0,13,35,77,112
2011,3,21,0,14,36,65,101
2011,3,21,0,15,41,66,107
2011,3,21,0,16,29,112,141
2011,3,21,0,17,41,231,272
2011,3,21,0,18,44,232,276
2011,3,21,0,19,22,199,221
2011,3,21,0,20,16,106,122
2011,3,21,0,21,12,79,91
2011,3,21,0,22,18,60,78
2011,3,21,0,23,8,22,30
2011,3,22,1,0,4,7,11
2011,3,22,1,1,6,13,19
2011,3,22,1,2,0,1,1
2011,3,22,1,3,3,2,5
2011,3,22,1,4,0,1,1
2011,3,22,1,5,1,11,12
2011,3,22,1,6,2,58,60
2011,3,22,1,7,4,131,135
2011,3,22,1,8,24,310,334
2011,3,22,1,9,19,159,178
2011,3,22,1,10,29,95,124
2011,3,22,1,11,22,63,85
2011,3,22,1,12,35,86,121
2011,3,22,1,13,21,85,106
2011,3,22,1,14,30,71,101
2011,3,22,1,15,55,79,134
2011,3,22,1,16,40,125,165
2011,3,22,1,17,42,265,307
2011,3,22,1,18,41,270,311
2011,3,22,1,19,22,140,162
2011,3,22,1,20,19,115,134
2011,3,22,1,21,24,63,87
2011,3,22,1,22,13,57,70
2011,3,22,1,23,4,28,32
2011,3,23,2,0,3,8,11
2011,3,23,2,1,0,7,7
2011,3,23,2,2,1,1,2
2011,3,23,2,3,0,3,3
2011,3,23,2,5,0,10,10
2011,3,23,2,6,1,43,44
2011,3,23,2,7,7,110,117
2011,3,23,2,8,14,245,259
2011,3,23,2,9,8,174,182
2011,3,23,2,10,15,60,75
2011,3,23,2,11,18,53,71
2011,3,23,2,12,14,73,87
2011,3,23,2,13,14,94,108
2011,3,23,2,14,13,71,84
2011,3,23,2,15,11,74,85
2011,3,23,2,16,13,123,136
2011,3,23,2,17,28,245,273
2011,3,23,2,18,20,218,238
2011,3,23,2,19,12,147,159
2011,3,23,2,20,3,72,75
2011,3,23,2,21,0,22,22
2011,3,23,2,22,6,38,44
2011,3,23,2,23,2,23,25
2011,3,24,3,0,0,11,11
2011,3,24,3,1,0,3,3
2011,3,24,3,2,0,6,6
2011,3,24,3,3,1,0,1
2011,3,24,3,4,0,1,1
2011,3,24,3,5,1,8,9
2011,3,24,3,6,0,41,41
2011,3,24,3,7,2,105,107
2011,3,24,3,8,4,120,124
2011,3,24,3,9,3,93,96
2011,3,24,3,10,10,55,65
2011,3,24,3,11,10,61,71
2011,3,24,3,12,12,82,94
2011,3,24,3,13,11,90,101
2011,3,24,3,14,17,66,83
2011,3,24,3,15,13,77,90
2011,3,24,3,16,6,77,83
2011,3,24,3,17,12,221,233
2011,3,24,3,18,17,196,213
2011,3,24,3,19,16,122,138
2011,3,24,3,20,8,108,116
2011,3,24,3,21,11,67,78
2011,3,24,3,22,3,59,62
2011,3,24,3,23,9,24,33
2011,3,25,4,0,1,17,18
2011,3,25,4,1,0,5,5
2011,3,25,4,2,0,5,5
2011,3,25,4,3,0,2,2
2011,3,25,4,4,3,2,5
2011,3,25,4,5,0,9,9
2011,3,25,4,6,0,32,32
2011,3,25,4,7,4,99,103
2011,3,25,4,8,9,223,232
2011,3,25,4,9,16,150,166
2011,3,25,4,10,15,53,68
2011,3,25,4,11,17,58,75
2011,3,25,4,12,37,108,145
2011,3,25,4,13,34,104,138
2011,3,25,4,14,30,102,132
2011,3,25,4,15,43,79,122
2011,3,25,4,16,23,127,150
2011,3,25,4,17,23,202,225
2011,3,25,4,18,8,189,197
2011,3,25,4,19,9,125,134
2011,3,25,4,20,6,74,80
2011,3,25,4,21,11,64,75
2011,3,25,4,22,3,39,42
2011,3,25,4,23,8,31,39
2011,3,26,5,0,3,25,28
2011,3,26,5,1,3,24,27
2011,3,26,5,2,4,21,25
2011,3,26,5,3,2,7,9
2011,3,26,5,4,2,4,6
2011,3,26,5,5,0,8,8
2011,3,26,5,6,2,8,10
2011,3,26,5,7,18,23,41
2011,3,26,5,8,24,42,66
2011,3,26,5,9,32,68,100
2011,3,26,5,10,32,93,125
2011,3,26,5,11,75,93,168
2011,3,26,5,12,98,129,227
2011,3,26,5,13,94,145,239
2011,3,26,5,14,93,123,216
2011,3,26,5,15,110,109,219
2011,3,26,5,16,118,130,248
2011,3,26,5,17,102,101,203
2011,3,26,5,18,64,89,153
2011,3,26,5,19,45,93,138
2011,3,26,5,20,18,66,84
2011,3,26,5,21,15,36,51
2011,3,26,5,22,17,46,63
2011,3,26,5,23,10,31,41
2011,3,27,6,0,5,26,31
2011,3,27,6,1,3,17,20
2011,3,27,6,2,6,15,21
2011,3,27,6,3,0,14,14
2011,3,27,6,4,1,5,6
2011,3,27,6,6,0,2,2
2011,3,27,6,7,0,7,7
2011,3,27,6,8,6,8,14
2011,3,27,6,9,17,37,54
2011,3,27,6,10,27,59,86
2011,3,27,6,11,23,84,107
2011,3,27,6,12,43,120,163
2011,3,27,6,13,47,100,147
2011,3,27,6,14,61,103,164
2011,3,27,6,15,61,111,172
2011,3,27,6,16,45,98,143
2011,3,27,6,17,50,109,159
2011,3,27,6,18,32,105,137
2011,3,27,6,19,23,80,103
2011,3,27,6,20,7,50,57
2011,3,27,6,21,7,29,36
2011,3,27,6,22,5,25,30
2011,3,27,6,23,3,16,19
2011,3,28,0,0,1,11,12
2011,3,28,0,1,2,4,6
2011,3,28,0,2,0,5,5
2011,3,28,0,3,0,2,2
2011,3,28,0,5,0,8,8
2011,3,28,0,6,0,40,40
2011,3,28,0,7,6,102,108
2011,3,28,0,8,15,238,253
2011,3,28,0,9,12,109,121
2011,3,28,0,10,22,46,68
2011,3,28,0,11,18,38,56
2011,3,28,0,12,8,71,79
2011,3,28,0,13,14,69,83
2011,3,28,0,14,15,64,79
2011,3,28,0,15,19,53,72
2011,3,28,0,16,15,117,132
2011,3,28,0,17,25,227,252
2011,3,28,0,18,21,220,241
2011,3,28,0,19,17,155,172
2011,3,28,0,20,5,106,111
2011,3,28,0,21,6,55,61
2011,3,28,0,22,0,40,40
2011,3,28,0,23,1,18,19
2011,3,29,1,0,1,15,16
2011,3,29,1,1,0,4,4
2011,3,29,1,2,0,3,3
2011,3,29,1,3,2,1,3
2011,3,29,1,4,1,1,2
2011,3,29,1,5,0,8,8
2011,3,29,1,6,4,46,50
2011,3,29,1,7,5,127,132
2011,3,29,1,8,19,267,286
2011,3,29,1,9,16,156,172
2011,3,29,1,10,13,45,58
2011,3,29,1,11,18,63,81
2011,3,29,1,12,29,76,105
2011,3,29,1,13,24,80,104
2011,3,29,1,14,20,66,86
2011,3,29,1,15,22,65,87
2011,3,29,1,16,12,124,136
2011,3,29,1,17,34,265,299
2011,3,29,1,18,42,252,294
2011,3,29,1,19,20,169,189
2011,3,29,1,20,13,119,132
2011,3,29,1,21,8,75,83
2011,3,29,1,22,6,49,55
2011,3,29,1,23,8,27,35
2011,3,30,2,0,3,8,11
2011,3,30,2,1,1,8,9
2011,3,30,2,2,0,4,4
2011,3,30,2,3,0,4,4
2011,3,30,2,4,1,0,1
2011,3,30,2,5,0,7,7
2011,3,30,2,6,4,43,47
2011,3,30,2,7,8,127,135
2011,3,30,2,8,16,243,259
2011,3,30,2,9,7,147,154
2011,3,30,2,10,13,51,64
2011,3,30,2,11,26,64,90
2011,3,30,2,12,15,65,80
2011,3,30,2,13,14,84,98
2011,3,30,2,14,16,63,79
2011,3,30,2,15,14,56,70
2011,3,30,2,16,0,36,36
2011,3,30,2,17,11,105,116
2011,3,30,2,18,6,79,85
2011,3,30,2,19,5,67,72
2011,3,30,2,20,4,40,44
2011,3,30,2,21,0,27,27
2011,3,30,2,22,3,21,24
2011,3,30,2,23,1,11,12
2011,3,31,3,0,0,3,3
2011,3,31,3,1,1,4,5
2011,3,31,3,2,0,5,5
2011,3,31,3,3,0,1,1
2011,3,31,3,4,0,2,2
2011,3,31,3,5,0,8,8
2011,3,31,3,6,2,34,36
2011,3,31,3,7,5,87,92
2011,3,31,3,8,7,179,186
2011,3,31,3,9,6,126,132
2011,3,31,3,10,15,54,69
2011,3,31,3,11,6,51,57
2011,3,31,3,12,17,72,89
2011,3,31,3,13,13,54,67
2011,3,31,3,14,27,49,76
2011,3,31,3,15,4,61,65
2011,3,31,3,16,13,72,85
2011,3,31,3,17,15,153,168
2011,3,31,3,18,12,164,176
2011,3,31,3,19,12,118,130
2011,3,31,3,20,6,79,85
2011,3,31,3,21,7,52,59
2011,3,31,3,22,7,44,51
2011,3,31,3,23,4,23,27
2011,4,1,4,0,0,6,6
2011,4,1,4,1,0,4,4
2011,4,1,4,2,0,7,7
2011,4,1,4,3,0,4,4
2011,4,1,4,4,0,3,3
2011,4,1,4,5,1,11,12
2011,4,1,4,6,2,26,28
2011,4,1,4,7,4,90,94
2011,4,1,4,8,8,197,205
2011,4,1,4,9,11,162,173
2011,4,1,4,10,12,63,75
2011,4,1,4,11,17,71,88
2011,4,1,4,12,15,78,93
2011,4,1,4,13,18,91,109
2011,4,1,4,14,26,60,86
2011,4,1,4,15,30,80,110
2011,4,1,4,16,42,125,167
2011,4,1,4,17,36,244,280
2011,4,1,4,18,36,205,241
2011,4,1,4,19,16,119,135
2011,4,1,4,20,2,75,77
2011,4,1,4,21,9,83,92
2011,4,1,4,22,10,64,74
2011,4,1,4,23,12,41,53
2011,4,2,5,0,3,29,32
2011,4,2,5,1,4,28,32
2011,4,2,5,2,1,20,21
2011,4,2,5,3,1,8,9
2011,4,2,5,4,0,5,5
2011,4,2,5,5,1,4,5
2011,4,2,5,6,5,7,12
2011,4,2,5,7,2,16,18
2011,4,2,5,8,10,45,55
2011,4,2,5,9,22,65,87
2011,4,2,5,10,41,113,154
2011,4,2,5,11,72,126,198
2011,4,2,5,12,84,100,184
2011,4,2,5,13,56,81,137
2011,4,2,5,14,97,93,190
2011,4,2,5,15,72,64,136
2011,4,2,5,16,111,85,196
2011,4,2,5,17,89,95,184
2011,4,2,5,18,69,110,179
2011,4,2,5,19,71,77,148
2011,4,2,5,20,29,56,85
2011,4,2,5,21,24,53,77
2011,4,2,5,22,14,41,55
2011,4,2,5,23,20,33,53
2011,4,3,6,0,8,31,39
2011,4,3,6,1,8,26,34
2011,4,3,6,2,5,19,24
2011,4,3,6,3,3,8,11
2011,4,3,6,4,3,0,3
2011,4,3,6,5,1,4,5
2011,4,3,6,6,10,23,33
2011,4,3,6,7,13,20,33
2011,4,3,6,8,18,44,62
2011,4,3,6,9,68,74,142
2011,4,3,6,10,111,104,215
2011,4,3,6,11,139,104,243
2011,4,3,6,12,166,147,313
2011,4,3,6,13,219,148,367
2011,4,3,6,14,240,109,349
2011,4,3,6,15,174,118,292
2011,4,3,6,16,147,155,302
2011,4,3,6,17,148,126,274
2011,4,3,6,18,71,101,172
2011,4,3,6,19,51,93,144
2011,4,3,6,20,24,55,79
2011,4,3,6,21,8,37,45
2011,4,3,6,22,7,29,36
2011,4,3,6,23,9,22,31
2011,4,4,0,0,1,5,6
2011,4,4,0,1,7,4,11
2011,4,4,0,2,1,1,2
2011,4,4,0,3,1,0,1
2011,4,4,0,4,1,1,2
2011,4,4,0,5,0,7,7
2011,4,4,0,6,3,43,46
2011,4,4,0,7,7,148,155
2011,4,4,0,8,31,306,337
2011,4,4,0,9,24,134,158
2011,4,4,0,10,35,55,90
2011,4,4,0,11,58,65,123
2011,4,4,0,12,59,97,156
2011,4,4,0,13,47,92,139
2011,4,4,0,14,47,76,123
2011,4,4,0,15,47,96,143
2011,4,4,0,16,59,130,189
2011,4,4,0,17,83,283,366
2011,4,4,0,18,78,307,385
2011,4,4,0,19,51,227,278
2011,4,4,0,20,40,133,173
2011,4,4,0,21,19,76,95
2011,4,4,0,22,17,58,75
2011,4,4,0,23,18,30,48
2011,4,5,1,0,10,12,22
2011,4,5,1,1,10,5,15
2011,4,5,1,2,0,5,5
2011,4,5,1,3,1,3,4
2011,4,5,1,4,0,2,2
2011,4,5,1,5,0,5,5
2011,4,5,1,6,2,36,38
2011,4,5,1,7,10,123,133
2011,4,5,1,8,9,147,156
2011,4,5,1,9,2,44,46
2011,4,5,1,10,3,25,28
2011,4,5,1,11,1,18,19
2011,4,5,1,12,6,32,38
2011,4,5,1,13,5,51,56
2011,4,5,1,14,9,66,75
2011,4,5,1,15,6,61,67
2011,4,5,1,16,17,113,130
2011,4,5,1,17,27,244,271
2011,4,5,1,18,19,247,266
2011,4,5,1,19,12,146,158
2011,4,5,1,20,4,87,91
2011,4,5,1,21,8,81,89
2011,4,5,1,22,3,43,46
2011,4,5,1,23,3,23,26
2011,4,6,2,0,0,15,15
2011,4,6,2,1,0,2,2
2011,4,6,2,2,0,5,5
2011,4,6,2,3,0,4,4
2011,4,6,2,4,0,1,1
2011,4,6,2,5,1,12,13
2011,4,6,2,6,4,52,56
2011,4,6,2,7,3,128,131
2011,4,6,2,8,17,305,322
2011,4,6,2,9,8,157,165
2011,4,6,2,10,21,48,69
2011,4,6,2,11,23,70,93
2011,4,6,2,12,22,112,134
2011,4,6,2,13,29,83,112
2011,4,6,2,14,35,80,115
2011,4,6,2,15,34,81,115
2011,4,6,2,16,27,142,169
2011,4,6,2,17,53,302,355
2011,4,6,2,18,43,281,324
2011,4,6,2,19,36,195,231
2011,4,6,2,20,15,125,140
2011,4,6,2,21,18,84,102
2011,4,6,2,22,13,71,84
2011,4,6,2,23,11,29,40
2011,4,7,3,0,5,15,20
2011,4,7,3,1,2,11,13
2011,4,7,3,2,0,7,7
2011,4,7,3,3,0,3,3
2011,4,7,3,4,0,1,1
2011,4,7,3,5,0,6,6
2011,4,7,3,6,5,59,64
2011,4,7,3,7,8,150,158
2011,4,7,3,8,23,288,311
2011,4,7,3,9,15,155,170
2011,4,7,3,10,29,66,95
2011,4,7,3,11,36,86,122
2011,4,7,3,12,39,114,153
2011,4,7,3,13,36,99,135
2011,4,7,3,14,46,111,157
2011,4,7,3,15,27,133,160
2011,4,7,3,16,52,161,213
2011,4,7,3,17,63,280,343
2011,4,7,3,18,68,264,332
2011,4,7,3,19,34,191,225
2011,4,7,3,20,37,165,202
2011,4,7,3,21,19,89,108
2011,4,7,3,22,18,63,81
2011,4,7,3,23,9,45,54
2011,4,8,4,0,4,21,25
2011,4,8,4,1,3,6,9
2011,4,8,4,2,3,10,13
2011,4,8,4,3,0,1,1
2011,4,8,4,4,0,1,1
2011,4,8,4,5,1,8,9
2011,4,8,4,6,2,33,35
2011,4,8,4,7,4,109,113
2011,4,8,4,8,13,207,220
2011,4,8,4,9,17,166,183
2011,4,8,4,10,10,63,73
2011,4,8,4,11,19,79,98
2011,4,8,4,12,29,51,80
2011,4,8,4,13,7,35,42
2011,4,8,4,14,2,13,15
2011,4,8,4,15,1,24,25
2011,4,8,4,16,2,58,60
2011,4,8,4,17,10,137,147
2011,4,8,4,18,8,54,62
2011,4,8,4,19,1,52,53
2011,4,8,4,20,12,51,63
2011,4,8,4,21,11,43,54
2011,4,8,4,22,9,42,51
2011,4,8,4,23,4,31,35
2011,4,9,5,0,5,26,31
2011,4,9,5,1,3,17,20
2011,4,9,5,2,2,15,17
2011,4,9,5,3,3,11,14
2011,4,9,5,4,0,3,3
2011,4,9,5,5,0,5,5
2011,4,9,5,6,0,13,13
2011,4,9,5,7,8,13,21
2011,4,9,5,8,7,47,54
2011,4,9,5,9,27,70,97
2011,4,9,5,10,43,90,133
2011,4,9,5,11,51,91,142
2011,4,9,5,12,79,123,202
2011,4,9,5,13,114,108,222
2011,4,9,5,14,94,118,212
2011,4,9,5,15,85,116,201
2011,4,9,5,16,73,118,191
2011,4,9,5,17,128,129,257
2011,4,9,5,18,48,129,177
2011,4,9,5,19,47,83,130
2011,4,9,5,20,19,74,93
2011,4,9,5,21,10,65,75
2011,4,9,5,22,21,66,87
2011,4,9,5,23,12,45,57
2011,4,10,6,0,5,48,53
2011,4,10,6,1,6,31,37
2011,4,10,6,2,12,24,36
2011,4,10,6,3,5,11,16
2011,4,10,6,4,3,2,5
2011,4,10,6,5,0,4,4
2011,4,10,6,6,0,4,4
2011,4,10,6,7,3,7,10
2011,4,10,6,8,17,38,55
2011,4,10,6,9,31,50,81
2011,4,10,6,10,69,81,150
2011,4,10,6,11,93,108,201
2011,4,10,6,12,94,136,230
2011,4,10,6,13,121,140,261
2011,4,10,6,14,148,133,281
2011,4,10,6,15,156,141,297
2011,4,10,6,16,135,153,288
2011,4,10,6,17,84,152,236
2011,4,10,6,18,103,137,240
2011,4,10,6,19,47,84,131
2011,4,10,6,20,21,71,92
2011,4,10,6,21,18,77,95
2011,4,10,6,22,12,45,57
2011,4,10,6,23,5,27,32
2011,4,11,0,0,7,16,23
2011,4,11,0,1,1,3,4
2011,4,11,0,2,7,2,9
2011,4,11,0,4,0,1,1
2011,4,11,0,5,1,12,13
2011,4,11,0,6,2,59,61
2011,4,11,0,7,12,163,175
2011,4,11,0,8,28,284,312
2011,4,11,0,9,33,131,164
2011,4,11,0,10,41,55,96
2011,4,11,0,11,45,59,104
2011,4,11,0,12,37,97,134
2011,4,11,0,13,62,77,139
2011,4,11,0,14,60,85,145
2011,4,11,0,15,55,85,140
2011,4,11,0,16,73,162,235
2011,4,11,0,17,100,352,452
2011,4,11,0,18,93,290,383
2011,4,11,0,19,73,211,284
2011,4,11,0,20,44,120,164
2011,4,11,0,21,39,119,158
2011,4,11,0,22,25,66,91
2011,4,11,0,23,16,38,54
2011,4,12,1,0,11,13,24
2011,4,12,1,1,6,7,13
2011,4,12,1,2,7,7,14
2011,4,12,1,3,0,1,1
2011,4,12,1,4,4,2,6
2011,4,12,1,5,1,15,16
2011,4,12,1,6,3,54,57
2011,4,12,1,7,12,176,188
2011,4,12,1,8,15,209,224
2011,4,12,1,9,4,49,53
2011,4,12,1,10,6,33,39
2011,4,12,1,11,11,38,49
2011,4,12,1,12,9,83,92
2011,4,12,1,13,22,83,105
2011,4,12,1,14,16,27,43
2011,4,12,1,15,24,54,78
2011,4,12,1,16,19,80,99
2011,4,12,1,17,29,262,291
2011,4,12,1,18,21,203,224
2011,4,12,1,19,3,126,129
2011,4,12,1,20,9,94,103
2011,4,12,1,21,10,74,84
2011,4,12,1,22,7,47,54
2011,4,12,1,23,8,31,39
2011,4,13,2,0,3,12,15
2011,4,13,2,1,0,1,1
2011,4,13,2,2,0,2,2
2011,4,13,2,3,0,2,2
2011,4,13,2,4,1,2,3
2011,4,13,2,5,1,4,5
2011,4,13,2,6,1,33,34
2011,4,13,2,7,3,67,70
2011,4,13,2,8,6,157,163
2011,4,13,2,9,2,61,63
2011,4,13,2,10,4,42,46
2011,4,13,2,11,4,57,61
2011,4,13,2,12,12,83,95
2011,4,13,2,13,6,55,61
2011,4,13,2,14,24,81,105
2011,4,13,2,15,12,69,81
2011,4,13,2,16,23,118,141
2011,4,13,2,17,25,284,309
2011,4,13,2,18,28,292,320
2011,4,13,2,19,14,160,174
2011,4,13,2,20,7,118,125
2011,4,13,2,21,17,98,115
2011,4,13,2,22,10,88,98
2011,4,13,2,23,5,56,61
2011,4,14,3,0,3,18,21
2011,4,14,3,1,1,9,10
2011,4,14,3,2,0,3,3
2011,4,14,3,3,0,2,2
2011,4,14,3,4,1,8,9
2011,4,14,3,5,2,12,14
2011,4,14,3,6,4,66,70
2011,4,14,3,7,11,180,191
2011,4,14,3,8,21,312,333
2011,4,14,3,9,18,150,168
2011,4,14,3,10,21,68,89
2011,4,14,3,11,28,87,115
2011,4,14,3,12,35,109,144
2011,4,14,3,13,38,121,159
2011,4,14,3,14,36,101,137
2011,4,14,3,15,57,84,141
2011,4,14,3,16,49,153,202
2011,4,14,3,17,50,336,386
2011,4,14,3,18,47,290,337
2011,4,14,3,19,37,222,259
2011,4,14,3,20,22,145,167
2011,4,14,3,21,18,125,143
2011,4,14,3,22,22,82,104
2011,4,14,3,23,7,40,47
2011,4,15,4,0,6,21,27
2011,4,15,4,1,6,9,15
2011,4,15,4,2,8,10,18
2011,4,15,4,3,0,3,3
2011,4,15,4,4,0,3,3
2011,4,15,4,5,2,11,13
2011,4,15,4,6,5,42,47
2011,4,15,4,7,10,136,146
2011,4,15,4,8,21,279,300
2011,4,15,4,9,16,162,178
2011,4,15,4,10,31,90,121
2011,4,15,4,11,41,95,136
2011,4,15,4,12,45,154,199
2011,4,15,4,13,47,132,179
2011,4,15,4,14,57,106,163
2011,4,15,4,15,50,112,162
2011,4,15,4,16,70,173,243
2011,4,15,4,17,64,267,331
2011,4,15,4,18,47,214,261
2011,4,15,4,19,41,166,207
2011,4,15,4,20,26,91,117
2011,4,15,4,21,25,77,102
2011,4,15,4,22,16,64,80
2011,4,15,4,23,8,56,64
2011,4,16,5,0,7,36,43
2011,4,16,5,1,5,28,33
2011,4,16,5,2,5,19,24
2011,4,16,5,3,5,9,14
2011,4,16,5,4,1,4,5
2011,4,16,5,5,1,3,4
2011,4,16,5,6,1,9,10
2011,4,16,5,7,3,18,21
2011,4,16,5,8,7,38,45
2011,4,16,5,9,2,27,29
2011,4,16,5,10,1,21,22
2011,4,16,5,11,4,27,31
2011,4,16,5,12,6,26,32
2011,4,16,5,13,9,49,58
2011,4,16,5,14,14,49,63
2011,4,16,5,15,16,62,78
2011,4,16,5,16,6,27,33
2011,4,16,5,17,1,14,15
2011,4,16,5,18,6,32,38
2011,4,16,5,19,9,62,71
2011,4,16,5,20,4,49,53
2011,4,16,5,21,1,13,14
2011,4,16,5,22,2,22,24
2011,4,16,5,23,5,30,35
2011,4,17,6,0,4,29,33
2011,4,17,6,1,6,25,31
2011,4,17,6,2,4,25,29
2011,4,17,6,3,12,13,25
2011,4,17,6,4,2,5,7
2011,4,17,6,5,2,1,3
2011,4,17,6,6,3,5,8
2011,4,17,6,7,2,14,16
2011,4,17,6,8,7,36,43
2011,4,17,6,9,31,71,102
2011,4,17,6,10,91,120,211
2011,4,17,6,11,118,185,303
2011,4,17,6,12,167,187,354
2011,4,17,6,13,180,162,342
2011,4,17,6,14,170,191,361
2011,4,17,6,15,178,209,387
2011,4,17,6,16,161,182,343
2011,4,17,6,17,143,163,306
2011,4,17,6,18,102,175,277
2011,4,17,6,19,75,135,210
2011,4,17,6,20,44,97,141
2011,4,17,6,21,13,70,83
2011,4,17,6,22,21,49,70
2011,4,17,6,23,19,37,56
2011,4,18,0,0,15,24,39
2011,4,18,0,1,11,8,19
2011,4,18,0,2,14,2,16
2011,4,18,0,3,6,1,7
2011,4,18,0,4,2,4,6
2011,4,18,0,5,0,16,16
2011,4,18,0,6,3,51,54
2011,4,18,0,7,12,155,167
2011,4,18,0,8,20,275,295
2011,4,18,0,9,37,130,167
2011,4,18,0,10,41,68,109
2011,4,18,0,11,36,87,123
2011,4,18,0,12,60,123,183
2011,4,18,0,13,41,128,169
2011,4,18,0,14,49,95,144
2011,4,18,0,15,64,112,176
2011,4,18,0,16,40,165,205
2011,4,18,0,17,66,361,427
2011,4,18,0,18,41,321,362
2011,4,18,0,19,41,243,284
2011,4,18,0,20,29,135,164
2011,4,18,0,21,20,130,150
2011,4,18,0,22,9,81,90
2011,4,18,0,23,11,35,46
2011,4,19,1,0,2,23,25
2011,4,19,1,1,5,2,7
2011,4,19,1,2,8,5,13
2011,4,19,1,3,0,3,3
2011,4,19,1,4,1,4,5
2011,4,19,1,5,1,17,18
2011,4,19,1,6,2,63,65
2011,4,19,1,7,22,165,187
2011,4,19,1,8,20,328,348
2011,4,19,1,9,23,136,159
2011,4,19,1,10,15,60,75
2011,4,19,1,11,19,52,71
2011,4,19,1,12,19,82,101
2011,4,19,1,13,26,103,129
2011,4,19,1,14,19,87,106
2011,4,19,1,15,44,83,127
2011,4,19,1,16,30,162,192
2011,4,19,1,17,39,372,411
2011,4,19,1,18,44,377,421
2011,4,19,1,19,28,248,276
2011,4,19,1,20,20,148,168
2011,4,19,1,21,8,113,121
2011,4,19,1,22,3,109,112
2011,4,19,1,23,11,41,52
2011,4,20,2,0,4,28,32
2011,4,20,2,1,2,5,7
2011,4,20,2,2,0,2,2
2011,4,20,2,3,0,2,2
2011,4,20,2,4,5,4,9
2011,4,20,2,5,1,14,15
2011,4,20,2,6,2,62,64
2011,4,20,2,7,26,209,235
2011,4,20,2,8,22,373,395
2011,4,20,2,9,27,168,195
2011,4,20,2,10,45,86,131
2011,4,20,2,11,31,87,118
2011,4,20,2,12,28,117,145
2011,4,20,2,13,42,134,176
2011,4,20,2,14,33,115,148
2011,4,20,2,15,32,112,144
2011,4,20,2,16,54,201,255
2011,4,20,2,17,33,398,431
2011,4,20,2,18,56,384,440
2011,4,20,2,19,74,309,383
2011,4,20,2,20,31,194,225
2011,4,20,2,21,38,133,171
2011,4,20,2,22,12,105,117
2011,4,20,2,23,14,79,93
2011,4,21,3,0,11,33,44
2011,4,21,3,1,6,20,26
2011,4,21,3,2,3,10,13
2011,4,21,3,3,4,3,7
2011,4,21,3,4,2,4,6
2011,4,21,3,5,0,14,14
2011,4,21,3,6,2,73,75
2011,4,21,3,7,15,182,197
2011,4,21,3,8,19,344,363
2011,4,21,3,9,18,176,194
2011,4,21,3,10,25,73,98
2011,4,21,3,11,34,99,133
2011,4,21,3,12,49,150,199
2011,4,21,3,13,55,122,177
2011,4,21,3,14,68,160,228
2011,4,21,3,15,69,166,235
2011,4,21,3,16,66,228,294
2011,4,21,3,17,78,400,478
2011,4,21,3,18,71,380,451
2011,4,21,3,19,52,272,324
2011,4,21,3,20,28,176,204
2011,4,21,3,21,25,158,183
2011,4,21,3,22,31,106,137
2011,4,21,3,23,13,86,99
2011,4,22,4,0,3,30,33
2011,4,22,4,1,2,22,24
2011,4,22,4,2,2,7,9
2011,4,22,4,3,0,2,2
2011,4,22,4,4,1,2,3
2011,4,22,4,5,0,16,16
2011,4,22,4,6,2,47,49
2011,4,22,4,7,5,174,179
2011,4,22,4,8,15,328,343
2011,4,22,4,9,17,176,193
2011,4,22,4,10,32,104,136
2011,4,22,4,11,23,83,106
2011,4,22,4,12,19,61,80
2011,4,22,4,13,3,37,40
2011,4,22,4,14,3,33,36
2011,4,22,4,15,13,62,75
2011,4,22,4,16,4,58,62
2011,4,22,4,17,6,63,69
2011,4,22,4,18,4,47,51
2011,4,22,4,19,7,48,55
2011,4,22,4,20,8,38,46
2011,4,22,4,21,5,23,28
2011,4,22,4,22,3,21,24
2011,4,22,4,23,0,17,17
2011,4,23,5,0,0,18,18
2011,4,23,5,1,5,11,16
2011,4,23,5,2,3,14,17
2011,4,23,5,3,0,4,4
2011,4,23,5,4,2,3,5
2011,4,23,5,5,1,6,7
2011,4,23,5,6,0,11,11
2011,4,23,5,7,2,17,19
2011,4,23,5,8,15,32,47
2011,4,23,5,9,13,55,68
2011,4,23,5,10,36,93,129
2011,4,23,5,11,68,164,232
2011,4,23,5,12,94,197,291
2011,4,23,5,13,126,186,312
2011,4,23,5,14,182,209,391
2011,4,23,5,15,171,226,397
2011,4,23,5,16,180,246,426
2011,4,23,5,17,168,215,383
2011,4,23,5,18,148,227,375
2011,4,23,5,19,84,199,283
2011,4,23,5,20,45,138,183
2011,4,23,5,21,32,103,135
2011,4,23,5,22,55,114,169
2011,4,23,5,23,31,86,117
2011,4,24,6,0,30,66,96
2011,4,24,6,1,14,40,54
2011,4,24,6,2,27,45,72
2011,4,24,6,3,4,20,24
2011,4,24,6,4,0,5,5
2011,4,24,6,5,5,7,12
2011,4,24,6,6,10,3,13
2011,4,24,6,7,16,11,27
2011,4,24,6,8,38,42,80
2011,4,24,6,9,73,104,177
2011,4,24,6,10,117,171,288
2011,4,24,6,11,124,193,317
2011,4,24,6,12,168,220,388
2011,4,24,6,13,205,236,441
2011,4,24,6,14,196,223,419
2011,4,24,6,15,167,201,368
2011,4,24,6,16,162,197,359
2011,4,24,6,17,142,189,331
2011,4,24,6,18,96,174,270
2011,4,24,6,19,62,132,194
2011,4,24,6,20,34,71,105
2011,4,24,6,21,8,53,61
2011,4,24,6,22,5,40,45
2011,4,24,6,23,5,37,42
2011,4,25,0,0,2,10,12
2011,4,25,0,1,2,8,10
2011,4,25,0,2,1,9,10
2011,4,25,0,3,2,8,10
2011,4,25,0,4,1,4,5
2011,4,25,0,5,2,14,16
2011,4,25,0,6,7,59,66
2011,4,25,0,7,13,183,196
2011,4,25,0,8,27,324,351
2011,4,25,0,9,27,146,173
2011,4,25,0,10,61,64,125
2011,4,25,0,11,53,93,146
2011,4,25,0,12,48,139,187
2011,4,25,0,13,57,146,203
2011,4,25,0,14,47,99,146
2011,4,25,0,15,50,125,175
2011,4,25,0,16,41,198,239
2011,4,25,0,17,80,440,520
2011,4,25,0,18,74,425,499
2011,4,25,0,19,62,318,380
2011,4,25,0,20,42,194,236
2011,4,25,0,21,41,148,189
2011,4,25,0,22,23,83,106
2011,4,25,0,23,9,53,62
2011,4,26,1,0,10,17,27
2011,4,26,1,1,16,5,21
2011,4,26,1,2,17,9,26
2011,4,26,1,3,17,4,21
2011,4,26,1,4,2,4,6
2011,4,26,1,5,0,16,16
2011,4,26,1,6,0,80,80
2011,4,26,1,7,15,250,265
2011,4,26,1,8,32,412,444
2011,4,26,1,9,35,162,197
2011,4,26,1,10,22,98,120
2011,4,26,1,11,40,129,169
2011,4,26,1,12,40,146,186
2011,4,26,1,13,37,139,176
2011,4,26,1,14,40,114,154
2011,4,26,1,15,34,119,153
2011,4,26,1,16,40,250,290
2011,4,26,1,17,66,455,521
2011,4,26,1,18,65,461,526
2011,4,26,1,19,42,285,327
2011,4,26,1,20,34,198,232
2011,4,26,1,21,33,162,195
2011,4,26,1,22,32,116,148
2011,4,26,1,23,7,71,78
2011,4,27,2,0,3,24,27
2011,4,27,2,1,2,15,17
2011,4,27,2,2,0,5,5
2011,4,27,2,3,3,4,7
2011,4,27,2,4,0,6,6
2011,4,27,2,5,1,16,17
2011,4,27,2,6,5,79,84
2011,4,27,2,7,17,226,243
2011,4,27,2,8,31,412,443
2011,4,27,2,9,20,159,179
2011,4,27,2,10,26,66,92
2011,4,27,2,11,53,103,156
2011,4,27,2,12,38,134,172
2011,4,27,2,13,31,118,149
2011,4,27,2,14,29,118,147
2011,4,27,2,15,18,120,138
2011,4,27,2,16,29,188,217
2011,4,27,2,17,62,458,520
2011,4,27,2,18,46,366,412
2011,4,27,2,19,40,219,259
2011,4,27,2,20,30,188,218
2011,4,27,2,21,19,126,145
2011,4,27,2,22,18,111,129
2011,4,27,2,23,25,52,77
2011,4,28,3,0,13,41,54
2011,4,28,3,1,8,12,20
2011,4,28,3,2,14,7,21
2011,4,28,3,3,2,1,3
2011,4,28,3,4,4,5,9
2011,4,28,3,5,0,13,13
2011,4,28,3,6,7,79,86
2011,4,28,3,7,14,199,213
2011,4,28,3,8,31,364,395
2011,4,28,3,9,18,164,182
2011,4,28,3,10,8,45,53
2011,4,28,3,11,10,74,84
2011,4,28,3,12,23,84,107
2011,4,28,3,13,18,102,120
2011,4,28,3,14,21,121,142
2011,4,28,3,15,46,116,162
2011,4,28,3,16,42,228,270
2011,4,28,3,17,49,406,455
2011,4,28,3,18,44,484,528
2011,4,28,3,19,57,345,402
2011,4,28,3,20,49,220,269
2011,4,28,3,21,27,166,193
2011,4,28,3,22,34,119,153
2011,4,28,3,23,29,81,110
2011,4,29,4,0,11,37,48
2011,4,29,4,1,10,21,31
2011,4,29,4,2,2,8,10
2011,4,29,4,3,1,4,5
2011,4,29,4,4,0,6,6
2011,4,29,4,5,0,25,25
2011,4,29,4,6,4,66,70
2011,4,29,4,7,18,222,240
2011,4,29,4,8,35,384,419
2011,4,29,4,9,45,185,230
2011,4,29,4,10,57,99,156
2011,4,29,4,11,49,108,157
2011,4,29,4,12,63,160,223
2011,4,29,4,13,74,234,308
2011,4,29,4,14,58,190,248
2011,4,29,4,15,77,175,252
2011,4,29,4,16,59,240,299
2011,4,29,4,17,75,433,508
2011,4,29,4,18,55,383,438
2011,4,29,4,19,40,229,269
2011,4,29,4,20,34,160,194
2011,4,29,4,21,50,145,195
2011,4,29,4,22,36,110,146
2011,4,29,4,23,25,88,113
2011,4,30,5,0,33,73,106
2011,4,30,5,1,15,59,74
2011,4,30,5,2,12,53,65
2011,4,30,5,3,4,13,17
2011,4,30,5,4,2,5,7
2011,4,30,5,5,3,4,7
2011,4,30,5,6,10,11,21
2011,4,30,5,7,21,27,48
2011,4,30,5,8,21,70,91
2011,4,30,5,9,35,121,156
2011,4,30,5,10,94,185,279
2011,4,30,5,11,120,201,321
2011,4,30,5,12,178,238,416
2011,4,30,5,13,185,270,455
2011,4,30,5,14,184,268,452
2011,4,30,5,15,217,282,499
2011,4,30,5,16,191,273,464
2011,4,30,5,17,162,245,407
2011,4,30,5,18,134,237,371
2011,4,30,5,19,150,237,387
2011,4,30,5,20,65,159,224
2011,4,30,5,21,58,119,177
2011,4,30,5,22,37,106,143
2011,4,30,5,23,34,91,125
2011,5,1,6,0,19,77,96
2011,5,1,6,1,9,50,59
2011,5,1,6,2,7,43,50
2011,5,1,6,3,8,15,23
2011,5,1,6,4,6,11,17
2011,5,1,6,5,0,10,10
2011,5,1,6,6,4,9,13
2011,5,1,6,7,7,26,33
2011,5,1,6,8,16,43,59
2011,5,1,6,9,45,96,141
2011,5,1,6,10,109,155,264
2011,5,1,6,11,109,141,250
2011,5,1,6,12,109,172,281
2011,5,1,6,13,123,209,332
2011,5,1,6,14,85,153,238
2011,5,1,6,15,113,153,266
2011,5,1,6,16,75,139,214
2011,5,1,6,17,59,136,195
2011,5,1,6,18,33,125,158
2011,5,1,6,19,47,130,177
2011,5,1,6,20,35,86,121
2011,5,1,6,21,23,82,105
2011,5,1,6,22,32,68,100
2011,5,1,6,23,64,82,146
2011,5,2,0,0,68,109,177
2011,5,2,0,1,41,73,114
2011,5,2,0,2,16,19,35
2011,5,2,0,3,9,7,16
2011,5,2,0,4,9,8,17
2011,5,2,0,5,4,16,20
2011,5,2,0,6,3,59,62
2011,5,2,0,7,15,190,205
2011,5,2,0,8,21,348,369
2011,5,2,0,9,41,131,172
2011,5,2,0,10,31,77,108
2011,5,2,0,11,34,95,129
2011,5,2,0,12,40,146,186
2011,5,2,0,13,51,119,170
2011,5,2,0,14,48,133,181
2011,5,2,0,15,45,109,154
2011,5,2,0,16,49,220,269
2011,5,2,0,17,65,472,537
2011,5,2,0,18,68,450,518
2011,5,2,0,19,46,263,309
2011,5,2,0,20,44,173,217
2011,5,2,0,21,54,178,232
2011,5,2,0,22,28,96,124
2011,5,2,0,23,16,48,64
2011,5,3,1,0,0,16,16
2011,5,3,1,1,0,14,14
2011,5,3,1,2,0,5,5
2011,5,3,1,3,0,2,2
2011,5,3,1,4,3,1,4
2011,5,3,1,5,0,14,14
2011,5,3,1,6,7,102,109
2011,5,3,1,7,17,247,264
2011,5,3,1,8,24,431,455
2011,5,3,1,9,29,156,185
2011,5,3,1,10,36,91,127
2011,5,3,1,11,20,118,138
2011,5,3,1,12,48,168,216
2011,5,3,1,13,50,144,194
2011,5,3,1,14,36,121,157
2011,5,3,1,15,37,117,154
2011,5,3,1,16,46,225,271
2011,5,3,1,17,53,463,516
2011,5,3,1,18,59,484,543
2011,5,3,1,19,42,323,365
2011,5,3,1,20,28,261,289
2011,5,3,1,21,42,182,224
2011,5,3,1,22,14,99,113
2011,5,3,1,23,12,50,62
2011,5,4,2,0,5,22,27
2011,5,4,2,1,1,6,7
2011,5,4,2,2,0,4,4
2011,5,4,2,3,0,1,1
2011,5,4,2,4,1,2,3
2011,5,4,2,5,1,8,9
2011,5,4,2,6,0,21,21
2011,5,4,2,7,5,45,50
2011,5,4,2,8,5,71,76
2011,5,4,2,9,5,34,39
2011,5,4,2,10,5,26,31
2011,5,4,2,11,3,69,72
2011,5,4,2,12,19,105,124
2011,5,4,2,13,15,128,143
2011,5,4,2,14,13,94,107
2011,5,4,2,15,22,106,128
2011,5,4,2,16,22,173,195
2011,5,4,2,17,21,388,409
2011,5,4,2,18,29,366,395
2011,5,4,2,19,30,266,296
2011,5,4,2,20,17,174,191
2011,5,4,2,21,17,133,150
2011,5,4,2,22,9,80,89
2011,5,4,2,23,8,49,57
2011,5,5,3,0,4,23,27
2011,5,5,3,1,4,6,10
2011,5,5,3,2,1,4,5
2011,5,5,3,3,0,4,4
2011,5,5,3,4,4,3,7
2011,5,5,3,5,1,29,30
2011,5,5,3,6,3,86,89
2011,5,5,3,7,16,255,271
2011,5,5,3,8,25,412,437
2011,5,5,3,9,19,164,183
2011,5,5,3,10,30,97,127
2011,5,5,3,11,43,104,147
2011,5,5,3,12,27,168,195
2011,5,5,3,13,50,141,191
2011,5,5,3,14,19,134,153
2011,5,5,3,15,27,120,147
2011,5,5,3,16,36,233,269
2011,5,5,3,17,66,466,532
2011,5,5,3,18,64,455,519
2011,5,5,3,19,56,305,361
2011,5,5,3,20,33,225,258
2011,5,5,3,21,39,141,180
2011,5,5,3,22,30,135,165
2011,5,5,3,23,16,99,115
2011,5,6,4,0,13,43,56
2011,5,6,4,1,8,24,32
2011,5,6,4,2,1,15,16
2011,5,6,4,3,3,6,9
2011,5,6,4,4,0,1,1
2011,5,6,4,5,0,16,16
2011,5,6,4,6,8,74,82
2011,5,6,4,7,20,200,220
2011,5,6,4,8,34,411,445
2011,5,6,4,9,27,160,187
2011,5,6,4,10,30,96,126
2011,5,6,4,11,42,122,164
2011,5,6,4,12,48,198,246
2011,5,6,4,13,71,182,253
2011,5,6,4,14,86,127,213
2011,5,6,4,15,89,171,260
2011,5,6,4,16,82,262,344
2011,5,6,4,17,82,470,552
2011,5,6,4,18,85,385,470
2011,5,6,4,19,39,251,290
2011,5,6,4,20,29,161,190
2011,5,6,4,21,22,130,152
2011,5,6,4,22,46,105,151
2011,5,6,4,23,27,92,119
2011,5,7,5,0,10,76,86
2011,5,7,5,1,8,50,58
2011,5,7,5,2,5,47,52
2011,5,7,5,3,9,9,18
2011,5,7,5,4,1,4,5
2011,5,7,5,5,4,3,7
2011,5,7,5,6,1,12,13
2011,5,7,5,7,8,32,40
2011,5,7,5,8,19,96,115
2011,5,7,5,9,54,163,217
2011,5,7,5,10,90,208,298
2011,5,7,5,11,132,215,347
2011,5,7,5,12,129,244,373
2011,5,7,5,13,196,240,436
2011,5,7,5,14,143,234,377
2011,5,7,5,15,148,230,378
2011,5,7,5,16,119,223,342
2011,5,7,5,17,138,215,353
2011,5,7,5,18,114,175,289
2011,5,7,5,19,88,178,266
2011,5,7,5,20,82,137,219
2011,5,7,5,21,58,124,182
2011,5,7,5,22,26,94,120
2011,5,7,5,23,30,89,119
2011,5,8,6,0,22,78,100
2011,5,8,6,1,8,56,64
2011,5,8,6,2,17,42,59
2011,5,8,6,3,10,21,31
2011,5,8,6,4,2,8,10
2011,5,8,6,5,0,5,5
2011,5,8,6,6,2,4,6
2011,5,8,6,7,8,15,23
2011,5,8,6,8,28,58,86
2011,5,8,6,9,48,112,160
2011,5,8,6,10,91,153,244
2011,5,8,6,11,142,198,340
2011,5,8,6,12,139,243,382
2011,5,8,6,13,166,224,390
2011,5,8,6,14,126,240,366
2011,5,8,6,15,128,230,358
2011,5,8,6,16,122,263,385
2011,5,8,6,17,106,245,351
2011,5,8,6,18,63,205,268
2011,5,8,6,19,61,178,239
2011,5,8,6,20,42,132,174
2011,5,8,6,21,32,94,126
2011,5,8,6,22,29,86,115
2011,5,8,6,23,9,41,50
2011,5,9,0,0,31,22,53
2011,5,9,0,1,25,8,33
2011,5,9,0,2,6,2,8
2011,5,9,0,3,0,7,7
2011,5,9,0,4,0,4,4
2011,5,9,0,5,0,22,22
2011,5,9,0,6,2,87,89
2011,5,9,0,7,14,221,235
2011,5,9,0,8,22,348,370
2011,5,9,0,9,36,142,178
2011,5,9,0,10,24,95,119
2011,5,9,0,11,26,99,125
2011,5,9,0,12,35,160,195
2011,5,9,0,13,36,138,174
2011,5,9,0,14,44,118,162
2011,5,9,0,15,51,140,191
2011,5,9,0,16,49,249,298
2011,5,9,0,17,59,539,598
2011,5,9,0,18,66,457,523
2011,5,9,0,19,45,338,383
2011,5,9,0,20,25,214,239
2011,5,9,0,21,28,126,154
2011,5,9,0,22,21,93,114
2011,5,9,0,23,16,45,61
2011,5,10,1,0,6,12,18
2011,5,10,1,1,3,12,15
2011,5,10,1,2,1,4,5
2011,5,10,1,3,1,3,4
2011,5,10,1,4,0,2,2
2011,5,10,1,5,1,28,29
2011,5,10,1,6,9,103,112
2011,5,10,1,7,13,298,311
2011,5,10,1,8,27,397,424
2011,5,10,1,9,27,173,200
2011,5,10,1,10,27,100,127
2011,5,10,1,11,17,106,123
2011,5,10,1,12,47,169,216
2011,5,10,1,13,50,150,200
2011,5,10,1,14,42,134,176
2011,5,10,1,15,28,151,179
2011,5,10,1,16,56,271,327
2011,5,10,1,17,79,532,611
2011,5,10,1,18,70,478,548
2011,5,10,1,19,69,363,432
2011,5,10,1,20,50,240,290
2011,5,10,1,21,30,173,203
2011,5,10,1,22,29,120,149
2011,5,10,1,23,9,72,81
2011,5,11,2,0,8,30,38
2011,5,11,2,1,4,16,20
2011,5,11,2,2,6,4,10
2011,5,11,2,3,0,3,3
2011,5,11,2,4,0,2,2
2011,5,11,2,5,0,20,20
2011,5,11,2,6,6,93,99
2011,5,11,2,7,25,291,316
2011,5,11,2,8,21,421,442
2011,5,11,2,9,21,181,202
2011,5,11,2,10,30,123,153
2011,5,11,2,11,18,123,141
2011,5,11,2,12,41,185,226
2011,5,11,2,13,36,157,193
2011,5,11,2,14,36,140,176
2011,5,11,2,15,48,131,179
2011,5,11,2,16,49,240,289
2011,5,11,2,17,17,242,259
2011,5,11,2,18,40,234,274
2011,5,11,2,19,60,340,400
2011,5,11,2,20,28,245,273
2011,5,11,2,21,32,200,232
2011,5,11,2,22,11,133,144
2011,5,11,2,23,12,69,81
2011,5,12,3,0,5,39,44
2011,5,12,3,1,1,16,17
2011,5,12,3,2,1,14,15
2011,5,12,3,3,0,5,5
2011,5,12,3,4,1,5,6
2011,5,12,3,5,2,27,29
2011,5,12,3,6,9,102,111
2011,5,12,3,7,14,281,295
2011,5,12,3,8,26,393,419
2011,5,12,3,9,21,190,211
2011,5,12,3,10,28,119,147
2011,5,12,3,11,43,136,179
2011,5,12,3,12,43,164,207
2011,5,12,3,13,48,170,218
2011,5,12,3,14,43,147,190
2011,5,12,3,15,54,163,217
2011,5,12,3,16,50,237,287
2011,5,12,3,17,54,540,594
2011,5,12,3,18,64,463,527
2011,5,12,3,19,59,304,363
2011,5,12,3,20,56,220,276
2011,5,12,3,21,31,192,223
2011,5,12,3,22,25,147,172
2011,5,12,3,23,16,87,103
2011,5,13,4,0,6,46,52
2011,5,13,4,1,5,15,20
2011,5,13,4,2,3,8,11
2011,5,13,4,3,2,2,4
2011,5,13,4,4,2,3,5
2011,5,13,4,5,1,24,25
2011,5,13,4,6,6,76,82
2011,5,13,4,7,16,141,157
2011,5,13,4,8,26,360,386
2011,5,13,4,9,18,213,231
2011,5,13,4,10,31,99,130
2011,5,13,4,11,56,89,145
2011,5,13,4,12,53,170,223
2011,5,13,4,13,69,157,226
2011,5,13,4,14,70,120,190
2011,5,13,4,15,56,142,198
2011,5,13,4,16,44,256,300
2011,5,13,4,17,62,427,489
2011,5,13,4,18,38,358,396
2011,5,13,4,19,25,244,269
2011,5,13,4,20,22,130,152
2011,5,13,4,21,24,130,154
2011,5,13,4,22,25,107,132
2011,5,13,4,23,31,88,119
2011,5,14,5,0,24,78,102
2011,5,14,5,1,18,64,82
2011,5,14,5,2,15,37,52
2011,5,14,5,3,5,30,35
2011,5,14,5,4,1,4,5
2011,5,14,5,5,7,7,14
2011,5,14,5,6,2,9,11
2011,5,14,5,7,4,28,32
2011,5,14,5,8,16,72,88
2011,5,14,5,9,14,85,99
2011,5,14,5,10,34,133,167
2011,5,14,5,11,72,207,279
2011,5,14,5,12,75,204,279
2011,5,14,5,13,67,180,247
2011,5,14,5,14,57,159,216
2011,5,14,5,15,73,221,294
2011,5,14,5,16,107,188,295
2011,5,14,5,17,78,194,272
2011,5,14,5,18,87,215,302
2011,5,14,5,19,69,178,247
2011,5,14,5,20,42,115,157
2011,5,14,5,21,15,44,59
2011,5,14,5,22,7,17,24
2011,5,14,5,23,11,33,44
2011,5,15,6,0,5,34,39
2011,5,15,6,1,4,43,47
2011,5,15,6,2,13,37,50
2011,5,15,6,3,11,21,32
2011,5,15,6,4,5,8,13
2011,5,15,6,5,3,11,14
2011,5,15,6,6,3,14,17
2011,5,15,6,7,4,38,42
2011,5,15,6,8,24,46,70
2011,5,15,6,9,36,98,134
2011,5,15,6,10,73,153,226
2011,5,15,6,11,120,202,322
2011,5,15,6,12,120,247,367
2011,5,15,6,13,195,261,456
2011,5,15,6,14,183,254,437
2011,5,15,6,15,206,253,459
2011,5,15,6,16,158,282,440
2011,5,15,6,17,137,255,392
2011,5,15,6,18,60,177,237
2011,5,15,6,19,78,153,231
2011,5,15,6,20,53,138,191
2011,5,15,6,21,44,106,150
2011,5,15,6,22,29,88,117
2011,5,15,6,23,18,51,69
2011,5,16,0,0,17,21,38
2011,5,16,0,1,6,8,14
2011,5,16,0,2,4,9,13
2011,5,16,0,3,1,3,4
2011,5,16,0,4,1,5,6
2011,5,16,0,5,1,20,21
2011,5,16,0,6,11,93,104
2011,5,16,0,7,27,243,270
2011,5,16,0,8,28,365,393
2011,5,16,0,9,38,156,194
2011,5,16,0,10,37,74,111
2011,5,16,0,11,56,129,185
2011,5,16,0,12,72,137,209
2011,5,16,0,13,61,153,214
2011,5,16,0,14,76,117,193
2011,5,16,0,15,55,110,165
2011,5,16,0,16,45,180,225
2011,5,16,0,17,47,227,274
2011,5,16,0,18,55,396,451
2011,5,16,0,19,36,271,307
2011,5,16,0,20,31,167,198
2011,5,16,0,21,28,149,177
2011,5,16,0,22,22,105,127
2011,5,16,0,23,18,39,57
2011,5,17,1,0,13,18,31
2011,5,17,1,1,7,6,13
2011,5,17,1,2,4,4,8
2011,5,17,1,3,1,3,4
2011,5,17,1,4,2,2,4
2011,5,17,1,5,0,22,22
2011,5,17,1,6,0,49,49
2011,5,17,1,7,13,136,149
2011,5,17,1,8,22,324,346
2011,5,17,1,9,17,188,205
2011,5,17,1,10,31,72,103
2011,5,17,1,11,26,104,130
2011,5,17,1,12,38,114,152
2011,5,17,1,13,31,141,172
2011,5,17,1,14,61,123,184
2011,5,17,1,15,79,131,210
2011,5,17,1,16,73,217,290
2011,5,17,1,17,83,520,603
2011,5,17,1,18,54,426,480
2011,5,17,1,19,51,298,349
2011,5,17,1,20,30,252,282
2011,5,17,1,21,23,150,173
2011,5,17,1,22,12,86,98
2011,5,17,1,23,7,49,56
2011,5,18,2,0,8,15,23
2011,5,18,2,1,3,9,12
2011,5,18,2,2,1,5,6
2011,5,18,2,3,6,3,9
2011,5,18,2,4,1,2,3
2011,5,18,2,5,0,9,9
2011,5,18,2,6,2,99,101
2011,5,18,2,7,14,259,273
2011,5,18,2,8,25,426,451
2011,5,18,2,9,26,175,201
2011,5,18,2,10,33,72,105
2011,5,18,2,11,6,17,23
2011,5,18,2,12,12,42,54
2011,5,18,2,13,30,91,121
2011,5,18,2,14,44,94,138
2011,5,18,2,15,34,132,166
2011,5,18,2,16,53,239,292
2011,5,18,2,17,77,487,564
2011,5,18,2,18,58,430,488
2011,5,18,2,19,43,287,330
2011,5,18,2,20,24,189,213
2011,5,18,2,21,11,74,85
2011,5,18,2,22,14,103,117
2011,5,18,2,23,10,49,59
2011,5,19,3,0,6,23,29
2011,5,19,3,1,2,4,6
2011,5,19,3,2,3,12,15
2011,5,19,3,3,1,3,4
2011,5,19,3,4,2,3,5
2011,5,19,3,5,2,23,25
2011,5,19,3,6,17,86,103
2011,5,19,3,7,18,239,257
2011,5,19,3,8,34,451,485
2011,5,19,3,9,40,173,213
2011,5,19,3,10,35,93,128
2011,5,19,3,11,53,110,163
2011,5,19,3,12,38,130,168
2011,5,19,3,13,44,138,182
2011,5,19,3,14,43,136,179
2011,5,19,3,15,63,125,188
2011,5,19,3,16,55,247,302
2011,5,19,3,17,60,487,547
2011,5,19,3,18,59,453,512
2011,5,19,3,19,65,345,410
2011,5,19,3,20,46,235,281
2011,5,19,3,21,29,179,208
2011,5,19,3,22,11,68,79
2011,5,19,3,23,9,63,72
2011,5,20,4,0,15,33,48
2011,5,20,4,1,8,17,25
2011,5,20,4,2,4,4,8
2011,5,20,4,3,1,4,5
2011,5,20,4,4,1,4,5
2011,5,20,4,5,0,28,28
2011,5,20,4,6,15,102,117
2011,5,20,4,7,30,287,317
2011,5,20,4,8,41,474,515
2011,5,20,4,9,35,199,234
2011,5,20,4,10,44,104,148
2011,5,20,4,11,62,133,195
2011,5,20,4,12,69,185,254
2011,5,20,4,13,60,171,231
2011,5,20,4,14,66,131,197
2011,5,20,4,15,74,168,242
2011,5,20,4,16,61,269,330
2011,5,20,4,17,71,481,552
2011,5,20,4,18,79,393,472
2011,5,20,4,19,49,253,302
2011,5,20,4,20,40,179,219
2011,5,20,4,21,40,155,195
2011,5,20,4,22,28,124,152
2011,5,20,4,23,15,100,115
2011,5,21,5,0,20,78,98
2011,5,21,5,1,8,64,72
2011,5,21,5,2,5,35,40
2011,5,21,5,3,7,12,19
2011,5,21,5,4,1,6,7
2011,5,21,5,5,1,4,5
2011,5,21,5,6,6,22,28
2011,5,21,5,7,10,33,43
2011,5,21,5,8,29,97,126
2011,5,21,5,9,60,165,225
2011,5,21,5,10,122,201,323
2011,5,21,5,11,173,244,417
2011,5,21,5,12,222,271,493
2011,5,21,5,13,191,271,462
2011,5,21,5,14,187,268,455
2011,5,21,5,15,232,274,506
2011,5,21,5,16,204,267,471
2011,5,21,5,17,191,253,444
2011,5,21,5,18,191,253,444
2011,5,21,5,19,117,184,301
2011,5,21,5,20,84,164,248
2011,5,21,5,21,77,150,227
2011,5,21,5,22,78,126,204
2011,5,21,5,23,42,103,145
2011,5,22,6,0,31,100,131
2011,5,22,6,1,17,81,98
2011,5,22,6,2,18,50,68
2011,5,22,6,3,10,23,33
2011,5,22,6,4,3,9,12
2011,5,22,6,5,1,5,6
2011,5,22,6,6,5,13,18
2011,5,22,6,7,13,27,40
2011,5,22,6,8,29,65,94
2011,5,22,6,9,59,130,189
2011,5,22,6,10,135,169,304
2011,5,22,6,11,164,209,373
2011,5,22,6,12,146,255,401
2011,5,22,6,13,180,274,454
2011,5,22,6,14,125,190,315
2011,5,22,6,15,110,219,329
2011,5,22,6,16,72,201,273
2011,5,22,6,17,93,212,305
2011,5,22,6,18,120,238,358
2011,5,22,6,19,107,193,300
2011,5,22,6,20,57,174,231
2011,5,22,6,21,27,109,136
2011,5,22,6,22,35,86,121
2011,5,22,6,23,19,46,65
2011,5,23,0,0,23,18,41
2011,5,23,0,1,4,5,9
2011,5,23,0,2,2,3,5
2011,5,23,0,3,0,4,4
2011,5,23,0,4,2,2,4
2011,5,23,0,5,0,11,11
2011,5,23,0,6,4,92,96
2011,5,23,0,7,13,222,235
2011,5,23,0,8,50,359,409
2011,5,23,0,9,36,130,166
2011,5,23,0,10,49,72,121
2011,5,23,0,11,72,107,179
2011,5,23,0,12,65,139,204
2011,5,23,0,13,48,155,203
2011,5,23,0,14,57,130,187
2011,5,23,0,15,57,119,176
2011,5,23,0,16,56,223,279
2011,5,23,0,17,56,373,429
2011,5,23,0,18,68,384,452
2011,5,23,0,19,56,302,358
2011,5,23,0,20,39,271,310
2011,5,23,0,21,33,155,188
2011,5,23,0,22,25,106,131
2011,5,23,0,23,19,53,72
2011,5,24,1,0,12,23,35
2011,5,24,1,1,6,9,15
2011,5,24,1,2,2,8,10
2011,5,24,1,3,0,2,2
2011,5,24,1,4,1,3,4
2011,5,24,1,5,2,22,24
2011,5,24,1,6,10,102,112
2011,5,24,1,7,26,287,313
2011,5,24,1,8,31,401,432
2011,5,24,1,9,27,111,138
2011,5,24,1,10,18,90,108
2011,5,24,1,11,33,142,175
2011,5,24,1,12,41,129,170
2011,5,24,1,13,38,152,190
2011,5,24,1,14,27,126,153
2011,5,24,1,15,59,129,188
2011,5,24,1,16,52,223,275
2011,5,24,1,17,56,492,548
2011,5,24,1,18,74,490,564
2011,5,24,1,19,45,310,355
2011,5,24,1,20,39,241,280
2011,5,24,1,21,21,168,189
2011,5,24,1,22,26,115,141
2011,5,24,1,23,13,53,66
2011,5,25,2,0,3,32,35
2011,5,25,2,1,6,2,8
2011,5,25,2,2,0,8,8
2011,5,25,2,3,0,9,9
2011,5,25,2,4,0,3,3
2011,5,25,2,5,2,23,25
2011,5,25,2,6,4,113,117
2011,5,25,2,7,29,282,311
2011,5,25,2,8,36,492,528
2011,5,25,2,9,27,206,233
2011,5,25,2,10,30,104,134
2011,5,25,2,11,36,104,140
2011,5,25,2,12,32,178,210
2011,5,25,2,13,39,163,202
2011,5,25,2,14,47,121,168
2011,5,25,2,15,37,145,182
2011,5,25,2,16,61,237,298
2011,5,25,2,17,77,524,601
2011,5,25,2,18,66,449,515
2011,5,25,2,19,72,331,403
2011,5,25,2,20,56,284,340
2011,5,25,2,21,33,203,236
2011,5,25,2,22,34,140,174
2011,5,25,2,23,12,74,86
2011,5,26,3,0,11,34,45
2011,5,26,3,1,3,13,16
2011,5,26,3,2,7,7,14
2011,5,26,3,3,0,4,4
2011,5,26,3,4,0,2,2
2011,5,26,3,5,2,25,27
2011,5,26,3,6,4,94,98
2011,5,26,3,7,16,268,284
2011,5,26,3,8,31,453,484
2011,5,26,3,9,22,194,216
2011,5,26,3,10,49,94,143
2011,5,26,3,11,36,123,159
2011,5,26,3,12,53,141,194
2011,5,26,3,13,52,145,197
2011,5,26,3,14,44,145,189
2011,5,26,3,15,40,101,141
2011,5,26,3,16,58,233,291
2011,5,26,3,17,49,445,494
2011,5,26,3,18,74,402,476
2011,5,26,3,19,67,311,378
2011,5,26,3,20,55,266,321
2011,5,26,3,21,44,178,222
2011,5,26,3,22,23,157,180
2011,5,26,3,23,17,73,90
2011,5,27,4,0,14,55,69
2011,5,27,4,1,14,36,50
2011,5,27,4,2,6,12,18
2011,5,27,4,3,1,11,12
2011,5,27,4,4,2,5,7
2011,5,27,4,5,2,29,31
2011,5,27,4,6,8,73,81
2011,5,27,4,7,19,229,248
2011,5,27,4,8,25,392,417
2011,5,27,4,9,37,190,227
2011,5,27,4,10,42,111,153
2011,5,27,4,11,40,125,165
2011,5,27,4,12,53,189,242
2011,5,27,4,13,51,158,209
2011,5,27,4,14,51,188,239
2011,5,27,4,15,97,257,354
2011,5,27,4,16,63,356,419
2011,5,27,4,17,77,412,489
2011,5,27,4,18,89,309,398
2011,5,27,4,19,69,210,279
2011,5,27,4,20,24,120,144
2011,5,27,4,21,37,114,151
2011,5,27,4,22,25,116,141
2011,5,27,4,23,23,104,127
2011,5,28,5,0,15,79,94
2011,5,28,5,1,8,47,55
2011,5,28,5,2,13,35,48
2011,5,28,5,3,2,13,15
2011,5,28,5,4,0,4,4
2011,5,28,5,5,4,3,7
2011,5,28,5,6,3,16,19
2011,5,28,5,7,17,33,50
2011,5,28,5,8,27,75,102
2011,5,28,5,9,61,116,177
2011,5,28,5,10,110,166,276
2011,5,28,5,11,171,178,349
2011,5,28,5,12,145,212,357
2011,5,28,5,13,168,217,385
2011,5,28,5,14,172,210,382
2011,5,28,5,15,187,187,374
2011,5,28,5,16,201,201,402
2011,5,28,5,17,180,161,341
2011,5,28,5,18,173,211,384
2011,5,28,5,19,99,153,252
2011,5,28,5,20,68,128,196
2011,5,28,5,21,87,114,201
2011,5,28,5,22,46,115,161
2011,5,28,5,23,44,81,125
2011,5,29,6,0,32,51,83
2011,5,29,6,1,17,49,66
2011,5,29,6,2,12,49,61
2011,5,29,6,3,2,24,26
2011,5,29,6,4,13,10,23
2011,5,29,6,5,3,3,6
2011,5,29,6,6,5,10,15
2011,5,29,6,7,13,17,30
2011,5,29,6,8,34,62,96
2011,5,29,6,9,74,77,151
2011,5,29,6,10,130,121,251
2011,5,29,6,11,139,180,319
2011,5,29,6,12,216,186,402
2011,5,29,6,13,237,181,418
2011,5,29,6,14,183,168,351
2011,5,29,6,15,221,154,375
2011,5,29,6,16,194,167,361
2011,5,29,6,17,214,169,383
2011,5,29,6,18,150,177,327
2011,5,29,6,19,141,146,287
2011,5,29,6,20,91,128,219
2011,5,29,6,21,107,122,229
2011,5,29,6,22,78,93,171
2011,5,29,6,23,48,87,135
2011,5,30,0,0,38,65,103
2011,5,30,0,1,26,53,79
2011,5,30,0,2,17,28,45
2011,5,30,0,3,10,8,18
2011,5,30,0,4,2,4,6
2011,5,30,0,5,1,6,7
2011,5,30,0,6,6,10,16
2011,5,30,0,7,12,19,31
2011,5,30,0,8,36,58,94
2011,5,30,0,9,47,79,126
2011,5,30,0,10,116,153,269
2011,5,30,0,11,153,168,321
2011,5,30,0,12,179,187,366
2011,5,30,0,13,133,217,350
2011,5,30,0,14,142,185,327
2011,5,30,0,15,132,178,310
2011,5,30,0,16,101,206,307
2011,5,30,0,17,102,202,304
2011,5,30,0,18,77,172,249
2011,5,30,0,19,68,157,225
2011,5,30,0,20,69,167,236
2011,5,30,0,21,42,107,149
2011,5,30,0,22,26,80,106
2011,5,30,0,23,14,34,48
2011,5,31,1,0,9,20,29
2011,5,31,1,1,8,9,17
2011,5,31,1,2,5,7,12
2011,5,31,1,3,1,3,4
2011,5,31,1,4,0,3,3
2011,5,31,1,5,0,26,26
2011,5,31,1,6,11,98,109
2011,5,31,1,7,16,217,233
2011,5,31,1,8,33,372,405
2011,5,31,1,9,22,153,175
2011,5,31,1,10,37,71,108
2011,5,31,1,11,28,78,106
2011,5,31,1,12,37,124,161
2011,5,31,1,13,37,110,147
2011,5,31,1,14,40,99,139
2011,5,31,1,15,42,133,175
2011,5,31,1,16,44,205,249
2011,5,31,1,17,67,428,495
2011,5,31,1,18,55,361,416
2011,5,31,1,19,39,246,285
2011,5,31,1,20,38,213,251
2011,5,31,1,21,45,165,210
2011,5,31,1,22,42,116,158
2011,5,31,1,23,15,46,61
2011,6,1,2,0,9,25,34
2011,6,1,2,1,8,9,17
2011,6,1,2,2,0,3,3
2011,6,1,2,3,0,6,6
2011,6,1,2,4,0,4,4
2011,6,1,2,5,2,19,21
2011,6,1,2,6,7,120,127
2011,6,1,2,7,18,265,283
2011,6,1,2,8,37,416,453
2011,6,1,2,9,34,173,207
2011,6,1,2,10,31,83,114
2011,6,1,2,11,26,86,112
2011,6,1,2,12,32,137,169
2011,6,1,2,13,29,124,153
2011,6,1,2,14,40,105,145
2011,6,1,2,15,25,127,152
2011,6,1,2,16,39,227,266
2011,6,1,2,17,52,433,485
2011,6,1,2,18,31,277,308
2011,6,1,2,19,16,247,263
2011,6,1,2,20,23,232,255
2011,6,1,2,21,29,161,190
2011,6,1,2,22,14,115,129
2011,6,1,2,23,10,59,69
2011,6,2,3,0,11,31,42
2011,6,2,3,1,3,12,15
2011,6,2,3,2,0,6,6
2011,6,2,3,3,0,4,4
2011,6,2,3,4,0,3,3
2011,6,2,3,5,3,28,31
2011,6,2,3,6,7,106,113
2011,6,2,3,7,19,285,304
2011,6,2,3,8,25,437,462
2011,6,2,3,9,28,197,225
2011,6,2,3,10,33,106,139
2011,6,2,3,11,42,123,165
2011,6,2,3,12,39,193,232
2011,6,2,3,13,35,168,203
2011,6,2,3,14,43,142,185
2011,6,2,3,15,44,144,188
2011,6,2,3,16,63,255,318
2011,6,2,3,17,88,484,572
2011,6,2,3,18,74,451,525
2011,6,2,3,19,58,321,379
2011,6,2,3,20,51,286,337
2011,6,2,3,21,33,215,248
2011,6,2,3,22,14,141,155
2011,6,2,3,23,23,88,111
2011,6,3,4,0,15,53,68
2011,6,3,4,1,7,15,22
2011,6,3,4,2,0,12,12
2011,6,3,4,3,0,5,5
2011,6,3,4,4,1,5,6
2011,6,3,4,5,4,24,28
2011,6,3,4,6,8,98,106
2011,6,3,4,7,25,249,274
2011,6,3,4,8,31,469,500
2011,6,3,4,9,36,193,229
2011,6,3,4,10,54,106,160
2011,6,3,4,11,57,134,191
2011,6,3,4,12,51,207,258
2011,6,3,4,13,58,189,247
2011,6,3,4,14,66,174,240
2011,6,3,4,15,56,156,212
2011,6,3,4,16,63,286,349
2011,6,3,4,17,73,485,558
2011,6,3,4,18,76,487,563
2011,6,3,4,19,53,338,391
2011,6,3,4,20,57,236,293
2011,6,3,4,21,51,196,247
2011,6,3,4,22,26,142,168
2011,6,3,4,23,30,141,171
2011,6,4,5,0,24,69,93
2011,6,4,5,1,14,80,94
2011,6,4,5,2,18,41,59
2011,6,4,5,3,8,10,18
2011,6,4,5,4,4,11,15
2011,6,4,5,5,3,5,8
2011,6,4,5,6,11,17,28
2011,6,4,5,7,27,60,87
2011,6,4,5,8,29,96,125
2011,6,4,5,9,55,169,224
2011,6,4,5,10,115,202,317
2011,6,4,5,11,120,249,369
2011,6,4,5,12,150,270,420
2011,6,4,5,13,188,268,456
2011,6,4,5,14,193,258,451
2011,6,4,5,15,180,224,404
2011,6,4,5,16,168,272,440
2011,6,4,5,17,142,202,344
2011,6,4,5,18,127,213,340
2011,6,4,5,19,78,205,283
2011,6,4,5,20,90,149,239
2011,6,4,5,21,46,139,185
2011,6,4,5,22,49,141,190
2011,6,4,5,23,29,121,150
2011,6,5,6,0,23,90,113
2011,6,5,6,1,26,70,96
2011,6,5,6,2,16,48,64
2011,6,5,6,3,22,25,47
2011,6,5,6,4,4,8,12
2011,6,5,6,5,1,5,6
2011,6,5,6,6,10,11,21
2011,6,5,6,7,8,19,27
2011,6,5,6,8,24,74,98
2011,6,5,6,9,53,111,164
2011,6,5,6,10,83,168,251
2011,6,5,6,11,121,214,335
2011,6,5,6,12,123,211,334
2011,6,5,6,13,154,213,367
2011,6,5,6,14,161,224,385
2011,6,5,6,15,160,255,415
2011,6,5,6,16,138,260,398
2011,6,5,6,17,126,264,390
2011,6,5,6,18,124,238,362
2011,6,5,6,19,108,249,357
2011,6,5,6,20,84,195,279
2011,6,5,6,21,54,111,165
2011,6,5,6,22,36,94,130
2011,6,5,6,23,25,61,86
2011,6,6,0,0,11,18,29
2011,6,6,0,1,9,5,14
2011,6,6,0,2,4,4,8
2011,6,6,0,3,2,3,5
2011,6,6,0,4,4,4,8
2011,6,6,0,5,7,24,31
2011,6,6,0,6,11,101,112
2011,6,6,0,7,18,277,295
2011,6,6,0,8,28,408,436
2011,6,6,0,9,26,162,188
2011,6,6,0,10,31,64,95
2011,6,6,0,11,39,72,111
2011,6,6,0,12,25,128,153
2011,6,6,0,13,28,152,180
2011,6,6,0,14,46,99,145
2011,6,6,0,15,38,127,165
2011,6,6,0,16,34,233,267
2011,6,6,0,17,63,516,579
2011,6,6,0,18,56,500,556
2011,6,6,0,19,64,339,403
2011,6,6,0,20,59,277,336
2011,6,6,0,21,29,160,189
2011,6,6,0,22,36,137,173
2011,6,6,0,23,5,55,60
2011,6,7,1,0,5,15,20
2011,6,7,1,1,2,2,4
2011,6,7,1,2,3,2,5
2011,6,7,1,3,1,1,2
2011,6,7,1,4,2,3,5
2011,6,7,1,5,2,30,32
2011,6,7,1,6,10,116,126
2011,6,7,1,7,23,308,331
2011,6,7,1,8,45,431,476
2011,6,7,1,9,27,188,215
2011,6,7,1,10,37,86,123
2011,6,7,1,11,38,113,151
2011,6,7,1,12,42,140,182
2011,6,7,1,13,54,141,195
2011,6,7,1,14,34,111,145
2011,6,7,1,15,56,127,183
2011,6,7,1,16,55,252,307
2011,6,7,1,17,64,475,539
2011,6,7,1,18,71,478,549
2011,6,7,1,19,69,355,424
2011,6,7,1,20,45,300,345
2011,6,7,1,21,31,187,218
2011,6,7,1,22,27,126,153
2011,6,7,1,23,18,72,90
2011,6,8,2,0,12,29,41
2011,6,8,2,1,3,20,23
2011,6,8,2,2,0,7,7
2011,6,8,2,3,2,1,3
2011,6,8,2,4,0,6,6
2011,6,8,2,5,0,21,21
2011,6,8,2,6,13,103,116
2011,6,8,2,7,24,325,349
2011,6,8,2,8,46,434,480
2011,6,8,2,9,34,167,201
2011,6,8,2,10,27,62,89
2011,6,8,2,11,28,106,134
2011,6,8,2,12,15,134,149
2011,6,8,2,13,20,116,136
2011,6,8,2,14,44,110,154
2011,6,8,2,15,28,99,127
2011,6,8,2,16,34,199,233
2011,6,8,2,17,79,426,505
2011,6,8,2,18,61,397,458
2011,6,8,2,19,61,323,384
2011,6,8,2,20,55,225,280
2011,6,8,2,21,34,168,202
2011,6,8,2,22,37,139,176
2011,6,8,2,23,18,98,116
2011,6,9,3,0,7,40,47
2011,6,9,3,1,3,13,16
2011,6,9,3,2,0,6,6
2011,6,9,3,3,0,2,2
2011,6,9,3,4,2,4,6
2011,6,9,3,5,1,19,20
2011,6,9,3,6,13,105,118
2011,6,9,3,7,31,282,313
2011,6,9,3,8,32,399,431
2011,6,9,3,9,20,148,168
2011,6,9,3,10,20,74,94
2011,6,9,3,11,36,82,118
2011,6,9,3,12,40,100,140
2011,6,9,3,13,18,118,136
2011,6,9,3,14,25,93,118
2011,6,9,3,15,18,86,104
2011,6,9,3,16,30,169,199
2011,6,9,3,17,54,355,409
2011,6,9,3,18,51,414,465
2011,6,9,3,19,55,271,326
2011,6,9,3,20,40,214,254
2011,6,9,3,21,29,142,171
2011,6,9,3,22,22,131,153
2011,6,9,3,23,15,82,97
2011,6,10,4,0,8,61,69
2011,6,10,4,1,5,18,23
2011,6,10,4,2,6,7,13
2011,6,10,4,3,3,3,6
2011,6,10,4,4,0,4,4
2011,6,10,4,5,0,28,28
2011,6,10,4,6,10,94,104
2011,6,10,4,7,25,240,265
2011,6,10,4,8,29,422,451
2011,6,10,4,9,37,175,212
2011,6,10,4,10,23,88,111
2011,6,10,4,11,46,107,153
2011,6,10,4,12,40,166,206
2011,6,10,4,13,40,149,189
2011,6,10,4,14,44,120,164
2011,6,10,4,15,49,163,212
2011,6,10,4,16,46,239,285
2011,6,10,4,17,63,453,516
2011,6,10,4,18,96,367,463
2011,6,10,4,19,61,245,306
2011,6,10,4,20,53,196,249
2011,6,10,4,21,55,163,218
2011,6,10,4,22,40,145,185
2011,6,10,4,23,36,110,146
2011,6,11,5,0,28,89,117
2011,6,11,5,1,10,67,77
2011,6,11,5,2,10,50,60
2011,6,11,5,3,10,18,28
2011,6,11,5,4,4,9,13
2011,6,11,5,5,4,12,16
2011,6,11,5,6,9,31,40
2011,6,11,5,7,18,50,68
2011,6,11,5,8,32,111,143
2011,6,11,5,9,59,171,230
2011,6,11,5,10,91,173,264
2011,6,11,5,11,110,215,325
2011,6,11,5,12,112,235,347
2011,6,11,5,13,150,237,387
2011,6,11,5,14,148,232,380
2011,6,11,5,15,142,231,373
2011,6,11,5,16,169,225,394
2011,6,11,5,17,147,190,337
2011,6,11,5,18,131,154,285
2011,6,11,5,19,97,167,264
2011,6,11,5,20,95,180,275
2011,6,11,5,21,76,144,220
2011,6,11,5,22,53,137,190
2011,6,11,5,23,24,107,131
2011,6,12,6,0,19,100,119
2011,6,12,6,1,19,74,93
2011,6,12,6,2,9,57,66
2011,6,12,6,3,8,20,28
2011,6,12,6,4,8,6,14
2011,6,12,6,5,5,5,10
2011,6,12,6,6,5,9,14
2011,6,12,6,7,7,27,34
2011,6,12,6,8,28,64,92
2011,6,12,6,9,75,107,182
2011,6,12,6,10,120,191,311
2011,6,12,6,11,131,236,367
2011,6,12,6,12,176,244,420
2011,6,12,6,13,109,263,372
2011,6,12,6,14,96,218,314
2011,6,12,6,15,142,218,360
2011,6,12,6,16,115,235,350
2011,6,12,6,17,94,158,252
2011,6,12,6,18,69,187,256
2011,6,12,6,19,67,156,223
2011,6,12,6,20,62,144,206
2011,6,12,6,21,39,101,140
2011,6,12,6,22,31,97,128
2011,6,12,6,23,33,74,107
2011,6,13,0,0,8,20,28
2011,6,13,0,1,6,10,16
2011,6,13,0,2,2,8,10
2011,6,13,0,3,1,6,7
2011,6,13,0,4,1,3,4
2011,6,13,0,5,2,27,29
2011,6,13,0,6,7,98,105
2011,6,13,0,7,26,301,327
2011,6,13,0,8,44,430,474
2011,6,13,0,9,35,189,224
2011,6,13,0,10,38,80,118
2011,6,13,0,11,53,106,159
2011,6,13,0,12,35,160,195
2011,6,13,0,13,53,174,227
2011,6,13,0,14,55,145,200
2011,6,13,0,15,58,126,184
2011,6,13,0,16,64,262,326
2011,6,13,0,17,72,529,601
2011,6,13,0,18,76,507,583
2011,6,13,0,19,75,348,423
2011,6,13,0,20,78,253,331
2011,6,13,0,21,40,178,218
2011,6,13,0,22,20,114,134
2011,6,13,0,23,14,75,89
2011,6,14,1,0,13,18,31
2011,6,14,1,1,3,10,13
2011,6,14,1,2,2,8,10
2011,6,14,1,3,1,1,2
2011,6,14,1,4,0,3,3
2011,6,14,1,5,3,23,26
2011,6,14,1,6,6,107,113
2011,6,14,1,7,19,344,363
2011,6,14,1,8,45,436,481
2011,6,14,1,9,19,173,192
2011,6,14,1,10,33,97,130
2011,6,14,1,11,40,103,143
2011,6,14,1,12,30,139,169
2011,6,14,1,13,33,176,209
2011,6,14,1,14,41,118,159
2011,6,14,1,15,42,136,178
2011,6,14,1,16,51,279,330
2011,6,14,1,17,85,484,569
2011,6,14,1,18,65,471,536
2011,6,14,1,19,51,335,386
2011,6,14,1,20,60,236,296
2011,6,14,1,21,37,205,242
2011,6,14,1,22,29,159,188
2011,6,14,1,23,19,91,110
2011,6,15,2,0,8,44,52
2011,6,15,2,1,0,14,14
2011,6,15,2,2,0,9,9
2011,6,15,2,3,0,1,1
2011,6,15,2,4,0,4,4
2011,6,15,2,5,1,20,21
2011,6,15,2,6,11,110,121
2011,6,15,2,7,22,344,366
2011,6,15,2,8,53,444,497
2011,6,15,2,9,22,185,207
2011,6,15,2,10,27,108,135
2011,6,15,2,11,49,115,164
2011,6,15,2,12,33,178,211
2011,6,15,2,13,43,146,189
2011,6,15,2,14,50,128,178
2011,6,15,2,15,33,131,164
2011,6,15,2,16,47,264,311
2011,6,15,2,17,83,553,636
2011,6,15,2,18,80,527,607
2011,6,15,2,19,54,361,415
2011,6,15,2,20,57,272,329
2011,6,15,2,21,48,207,255
2011,6,15,2,22,31,144,175
2011,6,15,2,23,17,89,106
2011,6,16,3,0,9,38,47
2011,6,16,3,1,4,13,17
2011,6,16,3,2,1,4,5
2011,6,16,3,3,0,4,4
2011,6,16,3,4,0,6,6
2011,6,16,3,5,7,18,25
2011,6,16,3,6,8,104,112
2011,6,16,3,7,16,170,186
2011,6,16,3,8,24,362,386
2011,6,16,3,9,29,232,261
2011,6,16,3,10,18,103,121
2011,6,16,3,11,33,117,150
2011,6,16,3,12,41,164,205
2011,6,16,3,13,37,113,150
2011,6,16,3,14,39,114,153
2011,6,16,3,15,32,126,158
2011,6,16,3,16,36,258,294
2011,6,16,3,17,42,229,271
2011,6,16,3,18,26,298,324
2011,6,16,3,19,58,269,327
2011,6,16,3,20,25,176,201
2011,6,16,3,21,34,154,188
2011,6,16,3,22,24,127,151
2011,6,16,3,23,2,14,16
2011,6,17,4,0,3,21,24
2011,6,17,4,1,4,19,23
2011,6,17,4,2,2,11,13
2011,6,17,4,3,1,5,6
2011,6,17,4,4,1,5,6
2011,6,17,4,5,1,12,13
2011,6,17,4,6,8,89,97
2011,6,17,4,7,25,223,248
2011,6,17,4,8,28,422,450
2011,6,17,4,9,27,196,223
2011,6,17,4,10,44,126,170
2011,6,17,4,11,43,138,181
2011,6,17,4,12,49,193,242
2011,6,17,4,13,48,154,202
2011,6,17,4,14,73,142,215
2011,6,17,4,15,62,181,243
2011,6,17,4,16,69,286,355
2011,6,17,4,17,85,467,552
2011,6,17,4,18,62,388,450
2011,6,17,4,19,53,273,326
2011,6,17,4,20,40,192,232
2011,6,17,4,21,49,159,208
2011,6,17,4,22,48,127,175
2011,6,17,4,23,37,141,178
2011,6,18,5,0,21,83,104
2011,6,18,5,1,15,80,95
2011,6,18,5,2,16,37,53
2011,6,18,5,3,4,16,20
2011,6,18,5,4,1,4,5
2011,6,18,5,5,1,6,7
2011,6,18,5,6,9,18,27
2011,6,18,5,7,12,45,57
2011,6,18,5,8,28,103,131
2011,6,18,5,9,62,156,218
2011,6,18,5,10,68,176,244
2011,6,18,5,11,134,270,404
2011,6,18,5,12,162,258,420
2011,6,18,5,13,135,192,327
2011,6,18,5,14,138,196,334
2011,6,18,5,15,153,214,367
2011,6,18,5,16,193,275,468
2011,6,18,5,17,210,238,448
2011,6,18,5,18,118,263,381
2011,6,18,5,19,99,227,326
2011,6,18,5,20,61,127,188
2011,6,18,5,21,58,125,183
2011,6,18,5,22,56,105,161
2011,6,18,5,23,53,97,150
2011,6,19,6,0,18,71,89
2011,6,19,6,1,17,59,76
2011,6,19,6,2,13,59,72
2011,6,19,6,3,14,16,30
2011,6,19,6,4,7,10,17
2011,6,19,6,5,7,12,19
2011,6,19,6,6,11,22,33
2011,6,19,6,7,35,36,71
2011,6,19,6,8,25,59,84
2011,6,19,6,9,58,111,169
2011,6,19,6,10,86,158,244
2011,6,19,6,11,141,236,377
2011,6,19,6,12,141,254,395
2011,6,19,6,13,149,214,363
2011,6,19,6,14,124,193,317
2011,6,19,6,15,146,216,362
2011,6,19,6,16,120,257,377
2011,6,19,6,17,159,238,397
2011,6,19,6,18,78,218,296
2011,6,19,6,19,94,217,311
2011,6,19,6,20,86,146,232
2011,6,19,6,21,57,110,167
2011,6,19,6,22,38,114,152
2011,6,19,6,23,14,78,92
2011,6,20,0,0,7,19,26
2011,6,20,0,1,9,3,12
2011,6,20,0,2,2,0,2
2011,6,20,0,3,1,0,1
2011,6,20,0,4,1,2,3
2011,6,20,0,5,0,3,3
2011,6,20,0,6,1,25,26
2011,6,20,0,7,0,46,46
2011,6,20,0,8,12,209,221
2011,6,20,0,9,19,200,219
2011,6,20,0,10,33,58,91
2011,6,20,0,11,27,66,93
2011,6,20,0,12,33,129,162
2011,6,20,0,13,50,129,179
2011,6,20,0,14,45,130,175
2011,6,20,0,15,66,139,205
2011,6,20,0,16,61,237,298
2011,6,20,0,17,81,483,564
2011,6,20,0,18,64,474,538
2011,6,20,0,19,62,369,431
2011,6,20,0,20,52,263,315
2011,6,20,0,21,39,167,206
2011,6,20,0,22,24,106,130
2011,6,20,0,23,10,49,59
2011,6,21,1,0,10,23,33
2011,6,21,1,1,2,12,14
2011,6,21,1,2,1,5,6
2011,6,21,1,3,0,2,2
2011,6,21,1,4,2,7,9
2011,6,21,1,5,3,22,25
2011,6,21,1,6,8,106,114
2011,6,21,1,7,21,286,307
2011,6,21,1,8,33,366,399
2011,6,21,1,9,32,243,275
2011,6,21,1,10,41,120,161
2011,6,21,1,11,51,118,169
2011,6,21,1,12,40,148,188
2011,6,21,1,13,48,157,205
2011,6,21,1,14,44,108,152
2011,6,21,1,15,42,128,170
2011,6,21,1,16,61,272,333
2011,6,21,1,17,65,507,572
2011,6,21,1,18,67,469,536
2011,6,21,1,19,67,357,424
2011,6,21,1,20,72,254,326
2011,6,21,1,21,38,191,229
2011,6,21,1,22,12,97,109
2011,6,21,1,23,11,53,64
2011,6,22,2,0,15,17,32
2011,6,22,2,1,2,19,21
2011,6,22,2,2,2,5,7
2011,6,22,2,3,0,7,7
2011,6,22,2,4,3,8,11
2011,6,22,2,5,2,21,23
2011,6,22,2,6,12,110,122
2011,6,22,2,7,23,286,309
2011,6,22,2,8,27,395,422
2011,6,22,2,9,14,205,219
2011,6,22,2,10,31,104,135
2011,6,22,2,11,37,106,143
2011,6,22,2,12,44,144,188
2011,6,22,2,13,33,112,145
2011,6,22,2,14,31,113,144
2011,6,22,2,15,32,114,146
2011,6,22,2,16,34,223,257
2011,6,22,2,17,67,462,529
2011,6,22,2,18,66,447,513
2011,6,22,2,19,62,278,340
2011,6,22,2,20,52,230,282
2011,6,22,2,21,31,215,246
2011,6,22,2,22,25,123,148
2011,6,22,2,23,14,91,105
2011,6,23,3,0,5,43,48
2011,6,23,3,1,5,26,31
2011,6,23,3,2,0,4,4
2011,6,23,3,3,1,4,5
2011,6,23,3,4,0,7,7
2011,6,23,3,5,2,22,24
2011,6,23,3,6,8,92,100
2011,6,23,3,7,26,299,325
2011,6,23,3,8,20,411,431
2011,6,23,3,9,33,194,227
2011,6,23,3,10,39,88,127
2011,6,23,3,11,28,108,136
2011,6,23,3,12,30,130,160
2011,6,23,3,13,37,149,186
2011,6,23,3,14,46,103,149
2011,6,23,3,15,62,126,188
2011,6,23,3,16,58,217,275
2011,6,23,3,17,74,495,569
2011,6,23,3,18,57,483,540
2011,6,23,3,19,56,341,397
2011,6,23,3,20,75,277,352
2011,6,23,3,21,46,188,234
2011,6,23,3,22,23,139,162
2011,6,23,3,23,15,90,105
2011,6,24,4,0,10,51,61
2011,6,24,4,1,8,20,28
2011,6,24,4,2,4,10,14
2011,6,24,4,3,1,4,5
2011,6,24,4,4,1,8,9
2011,6,24,4,5,2,18,20
2011,6,24,4,6,4,87,91
2011,6,24,4,7,21,247,268
2011,6,24,4,8,27,436,463
2011,6,24,4,9,28,203,231
2011,6,24,4,10,43,102,145
2011,6,24,4,11,56,146,202
2011,6,24,4,12,51,150,201
2011,6,24,4,13,43,178,221
2011,6,24,4,14,67,162,229
2011,6,24,4,15,69,146,215
2011,6,24,4,16,80,247,327
2011,6,24,4,17,85,470,555
2011,6,24,4,18,87,365,452
2011,6,24,4,19,92,293,385
2011,6,24,4,20,66,222,288
2011,6,24,4,21,50,183,233
2011,6,24,4,22,41,126,167
2011,6,24,4,23,33,139,172
2011,6,25,5,0,19,97,116
2011,6,25,5,1,20,75,95
2011,6,25,5,2,8,51,59
2011,6,25,5,3,18,21,39
2011,6,25,5,4,7,4,11
2011,6,25,5,5,6,7,13
2011,6,25,5,6,12,17,29
2011,6,25,5,7,7,35,42
2011,6,25,5,8,27,85,112
2011,6,25,5,9,47,139,186
2011,6,25,5,10,99,203,302
2011,6,25,5,11,122,209,331
2011,6,25,5,12,140,251,391
2011,6,25,5,13,140,231,371
2011,6,25,5,14,151,231,382
2011,6,25,5,15,157,235,392
2011,6,25,5,16,175,235,410
2011,6,25,5,17,152,247,399
2011,6,25,5,18,108,199,307
2011,6,25,5,19,121,254,375
2011,6,25,5,20,74,195,269
2011,6,25,5,21,62,140,202
2011,6,25,5,22,61,126,187
2011,6,25,5,23,49,130,179
2011,6,26,6,0,30,85,115
2011,6,26,6,1,17,73,90
2011,6,26,6,2,17,70,87
2011,6,26,6,3,12,22,34
2011,6,26,6,4,3,8,11
2011,6,26,6,5,3,9,12
2011,6,26,6,6,7,13,20
2011,6,26,6,7,24,27,51
2011,6,26,6,8,29,78,107
2011,6,26,6,9,75,131,206
2011,6,26,6,10,136,196,332
2011,6,26,6,11,127,219,346
2011,6,26,6,12,175,268,443
2011,6,26,6,13,197,245,442
2011,6,26,6,14,197,246,443
2011,6,26,6,15,174,229,403
2011,6,26,6,16,177,278,455
2011,6,26,6,17,178,243,421
2011,6,26,6,18,117,265,382
2011,6,26,6,19,89,227,316
2011,6,26,6,20,54,156,210
2011,6,26,6,21,47,134,181
2011,6,26,6,22,19,95,114
2011,6,26,6,23,14,64,78
2011,6,27,0,0,7,25,32
2011,6,27,0,1,4,11,15
2011,6,27,0,2,3,3,6
2011,6,27,0,3,0,2,2
2011,6,27,0,4,1,8,9
2011,6,27,0,5,1,21,22
2011,6,27,0,6,4,90,94
2011,6,27,0,7,14,247,261
2011,6,27,0,8,28,415,443
2011,6,27,0,9,37,150,187
2011,6,27,0,10,55,95,150
2011,6,27,0,11,55,95,150
2011,6,27,0,12,40,130,170
2011,6,27,0,13,37,124,161
2011,6,27,0,14,58,100,158
2011,6,27,0,15,76,125,201
2011,6,27,0,16,53,222,275
2011,6,27,0,17,90,512,602
2011,6,27,0,18,79,512,591
2011,6,27,0,19,56,340,396
2011,6,27,0,20,54,251,305
2011,6,27,0,21,52,190,242
2011,6,27,0,22,33,112,145
2011,6,27,0,23,16,65,81
2011,6,28,1,0,5,25,30
2011,6,28,1,1,5,8,13
2011,6,28,1,2,2,9,11
2011,6,28,1,3,0,2,2
2011,6,28,1,4,1,7,8
2011,6,28,1,5,1,20,21
2011,6,28,1,6,7,116,123
2011,6,28,1,7,27,319,346
2011,6,28,1,8,39,414,453
2011,6,28,1,9,38,208,246
2011,6,28,1,10,45,111,156
2011,6,28,1,11,49,116,165
2011,6,28,1,12,39,161,200
2011,6,28,1,13,33,156,189
2011,6,28,1,14,43,116,159
2011,6,28,1,15,39,127,166
2011,6,28,1,16,41,220,261
2011,6,28,1,17,70,508,578
2011,6,28,1,18,67,436,503
2011,6,28,1,19,44,255,299
2011,6,28,1,20,50,246,296
2011,6,28,1,21,31,164,195
2011,6,28,1,22,30,104,134
2011,6,28,1,23,23,58,81
2011,6,29,2,0,11,25,36
2011,6,29,2,1,10,18,28
2011,6,29,2,2,7,9,16
2011,6,29,2,3,2,3,5
2011,6,29,2,4,0,5,5
2011,6,29,2,5,3,19,22
2011,6,29,2,6,12,104,116
2011,6,29,2,7,18,317,335
2011,6,29,2,8,41,497,538
2011,6,29,2,9,32,189,221
2011,6,29,2,10,31,95,126
2011,6,29,2,11,53,117,170
2011,6,29,2,12,55,188,243
2011,6,29,2,13,45,185,230
2011,6,29,2,14,50,137,187
2011,6,29,2,15,43,146,189
2011,6,29,2,16,60,268,328
2011,6,29,2,17,78,492,570
2011,6,29,2,18,78,509,587
2011,6,29,2,19,60,341,401
2011,6,29,2,20,69,263,332
2011,6,29,2,21,26,195,221
2011,6,29,2,22,32,151,183
2011,6,29,2,23,32,97,129
2011,6,30,3,0,15,39,54
2011,6,30,3,1,13,19,32
2011,6,30,3,2,2,6,8
2011,6,30,3,3,2,7,9
2011,6,30,3,4,2,4,6
2011,6,30,3,5,1,24,25
2011,6,30,3,6,4,119,123
2011,6,30,3,7,28,289,317
2011,6,30,3,8,44,508,552
2011,6,30,3,9,33,227,260
2011,6,30,3,10,35,97,132
2011,6,30,3,11,47,121,168
2011,6,30,3,12,50,183,233
2011,6,30,3,13,70,160,230
2011,6,30,3,14,46,117,163
2011,6,30,3,15,64,176,240
2011,6,30,3,16,63,260,323
2011,6,30,3,17,98,496,594
2011,6,30,3,18,114,472,586
2011,6,30,3,19,89,365,454
2011,6,30,3,20,55,285,340
2011,6,30,3,21,81,242,323
2011,6,30,3,22,42,163,205
2011,6,30,3,23,27,99,126
2011,7,1,4,0,20,48,68
2011,7,1,4,1,15,16,31
2011,7,1,4,2,6,7,13
2011,7,1,4,3,5,6,11
2011,7,1,4,4,1,5,6
2011,7,1,4,5,3,27,30
2011,7,1,4,6,11,97,108
2011,7,1,4,7,24,216,240
2011,7,1,4,8,39,452,491
2011,7,1,4,9,58,201,259
2011,7,1,4,10,61,109,170
2011,7,1,4,11,68,146,214
2011,7,1,4,12,83,179,262
2011,7,1,4,13,83,209,292
2011,7,1,4,14,78,224,302
2011,7,1,4,15,81,297,378
2011,7,1,4,16,85,342,427
2011,7,1,4,17,99,361,460
2011,7,1,4,18,98,324,422
2011,7,1,4,19,80,238,318
2011,7,1,4,20,84,185,269
2011,7,1,4,21,69,149,218
2011,7,1,4,22,49,173,222
2011,7,1,4,23,44,96,140
2011,7,2,5,0,31,84,115
2011,7,2,5,1,20,58,78
2011,7,2,5,2,9,43,52
2011,7,2,5,3,5,21,26
2011,7,2,5,4,3,8,11
2011,7,2,5,5,1,13,14
2011,7,2,5,6,11,21,32
2011,7,2,5,7,10,35,45
2011,7,2,5,8,38,94,132
2011,7,2,5,9,55,124,179
2011,7,2,5,10,103,168,271
2011,7,2,5,11,144,212,356
2011,7,2,5,12,142,231,373
2011,7,2,5,13,178,226,404
2011,7,2,5,14,177,215,392
2011,7,2,5,15,168,162,330
2011,7,2,5,16,206,191,397
2011,7,2,5,17,179,169,348
2011,7,2,5,18,193,190,383
2011,7,2,5,19,156,149,305
2011,7,2,5,20,136,148,284
2011,7,2,5,21,95,137,232
2011,7,2,5,22,78,123,201
2011,7,2,5,23,66,88,154
2011,7,3,6,0,47,97,144
2011,7,3,6,1,23,55,78
2011,7,3,6,2,19,50,69
2011,7,3,6,3,8,25,33
2011,7,3,6,4,3,2,5
2011,7,3,6,5,0,1,1
2011,7,3,6,6,0,3,3
2011,7,3,6,7,3,22,25
2011,7,3,6,8,39,53,92
2011,7,3,6,9,82,99,181
2011,7,3,6,10,131,133,264
2011,7,3,6,11,215,175,390
2011,7,3,6,12,198,206,404
2011,7,3,6,13,247,173,420
2011,7,3,6,14,225,150,375
2011,7,3,6,15,194,182,376
2011,7,3,6,16,195,219,414
2011,7,3,6,17,181,177,358
2011,7,3,6,18,74,107,181
2011,7,3,6,19,100,83,183
2011,7,3,6,20,83,93,176
2011,7,3,6,21,75,92,167
2011,7,3,6,22,69,93,162
2011,7,3,6,23,70,77,147
2011,7,4,0,0,63,77,140
2011,7,4,0,1,43,76,119
2011,7,4,0,2,33,30,63
2011,7,4,0,3,13,13,26
2011,7,4,0,4,8,4,12
2011,7,4,0,5,1,3,4
2011,7,4,0,6,5,11,16
2011,7,4,0,7,17,19,36
2011,7,4,0,8,42,44,86
2011,7,4,0,9,142,96,238
2011,7,4,0,10,166,113,279
2011,7,4,0,11,177,172,349
2011,7,4,0,12,237,210,447
2011,7,4,0,13,242,181,423
2011,7,4,0,14,235,173,408
2011,7,4,0,15,222,183,405
2011,7,4,0,16,236,216,452
2011,7,4,0,17,240,196,436
2011,7,4,0,18,222,196,418
2011,7,4,0,19,170,205,375
2011,7,4,0,20,195,191,386
2011,7,4,0,21,192,261,453
2011,7,4,0,22,115,211,326
2011,7,4,0,23,44,94,138
2011,7,5,1,0,19,36,55
2011,7,5,1,1,15,24,39
2011,7,5,1,2,8,5,13
2011,7,5,1,3,1,7,8
2011,7,5,1,4,1,4,5
2011,7,5,1,5,1,19,20
2011,7,5,1,6,3,90,93
2011,7,5,1,7,22,246,268
2011,7,5,1,8,41,388,429
2011,7,5,1,9,50,176,226
2011,7,5,1,10,55,84,139
2011,7,5,1,11,75,97,172
2011,7,5,1,12,71,130,201
2011,7,5,1,13,67,135,202
2011,7,5,1,14,66,112,178
2011,7,5,1,15,51,111,162
2011,7,5,1,16,78,201,279
2011,7,5,1,17,79,466,545
2011,7,5,1,18,70,424,494
2011,7,5,1,19,71,296,367
2011,7,5,1,20,59,225,284
2011,7,5,1,21,77,168,245
2011,7,5,1,22,31,124,155
2011,7,5,1,23,19,54,73
2011,7,6,2,0,11,26,37
2011,7,6,2,1,4,11,15
2011,7,6,2,2,1,4,5
2011,7,6,2,3,0,6,6
2011,7,6,2,4,0,6,6
2011,7,6,2,5,5,30,35
2011,7,6,2,6,9,112,121
2011,7,6,2,7,24,286,310
2011,7,6,2,8,31,394,425
2011,7,6,2,9,31,158,189
2011,7,6,2,10,13,30,43
2011,7,6,2,11,24,103,127
2011,7,6,2,12,38,113,151
2011,7,6,2,13,33,107,140
2011,7,6,2,14,50,111,161
2011,7,6,2,15,55,130,185
2011,7,6,2,16,57,218,275
2011,7,6,2,17,79,517,596
2011,7,6,2,18,77,486,563
2011,7,6,2,19,71,321,392
2011,7,6,2,20,55,257,312
2011,7,6,2,21,66,175,241
2011,7,6,2,22,30,156,186
2011,7,6,2,23,20,78,98
2011,7,7,3,0,6,29,35
2011,7,7,3,1,2,14,16
2011,7,7,3,2,1,7,8
2011,7,7,3,3,2,2,4
2011,7,7,3,4,0,4,4
2011,7,7,3,5,2,30,32
2011,7,7,3,6,11,107,118
2011,7,7,3,7,13,275,288
2011,7,7,3,8,28,413,441
2011,7,7,3,9,25,154,179
2011,7,7,3,10,29,72,101
2011,7,7,3,11,30,111,141
2011,7,7,3,12,32,138,170
2011,7,7,3,13,48,107,155
2011,7,7,3,14,39,121,160
2011,7,7,3,15,47,119,166
2011,7,7,3,16,47,218,265
2011,7,7,3,17,80,488,568
2011,7,7,3,18,70,492,562
2011,7,7,3,19,79,284,363
2011,7,7,3,20,61,221,282
2011,7,7,3,21,39,170,209
2011,7,7,3,22,32,150,182
2011,7,7,3,23,31,98,129
2011,7,8,4,0,6,41,47
2011,7,8,4,1,9,25,34
2011,7,8,4,2,10,12,22
2011,7,8,4,3,2,4,6
2011,7,8,4,4,7,4,11
2011,7,8,4,5,3,24,27
2011,7,8,4,6,11,91,102
2011,7,8,4,7,30,299,329
2011,7,8,4,8,36,418,454
2011,7,8,4,9,30,211,241
2011,7,8,4,10,30,108,138
2011,7,8,4,11,61,104,165
2011,7,8,4,12,49,164,213
2011,7,8,4,13,54,175,229
2011,7,8,4,14,53,163,216
2011,7,8,4,15,39,101,140
2011,7,8,4,16,27,104,131
2011,7,8,4,17,6,161,167
2011,7,8,4,18,35,281,316
2011,7,8,4,19,45,224,269
2011,7,8,4,20,30,220,250
2011,7,8,4,21,46,158,204
2011,7,8,4,22,33,136,169
2011,7,8,4,23,40,111,151
2011,7,9,5,0,31,90,121
2011,7,9,5,1,5,48,53
2011,7,9,5,2,12,43,55
2011,7,9,5,3,7,23,30
2011,7,9,5,4,2,4,6
2011,7,9,5,5,4,11,15
2011,7,9,5,6,11,27,38
2011,7,9,5,7,21,50,71
2011,7,9,5,8,68,113,181
2011,7,9,5,9,77,169,246
2011,7,9,5,10,87,176,263
2011,7,9,5,11,101,188,289
2011,7,9,5,12,145,221,366
2011,7,9,5,13,167,249,416
2011,7,9,5,14,158,215,373
2011,7,9,5,15,182,219,401
2011,7,9,5,16,171,245,416
2011,7,9,5,17,160,240,400
2011,7,9,5,18,132,246,378
2011,7,9,5,19,128,178,306
2011,7,9,5,20,129,185,314
2011,7,9,5,21,83,155,238
2011,7,9,5,22,60,154,214
2011,7,9,5,23,47,93,140
2011,7,10,6,0,42,112,154
2011,7,10,6,1,19,94,113
2011,7,10,6,2,28,68,96
2011,7,10,6,3,6,19,25
2011,7,10,6,4,0,5,5
2011,7,10,6,5,7,10,17
2011,7,10,6,6,8,17,25
2011,7,10,6,7,27,37,64
2011,7,10,6,8,27,65,92
2011,7,10,6,9,62,107,169
2011,7,10,6,10,95,173,268
2011,7,10,6,11,110,177,287
2011,7,10,6,12,133,244,377
2011,7,10,6,13,139,228,367
2011,7,10,6,14,122,227,349
2011,7,10,6,15,142,219,361
2011,7,10,6,16,128,244,372
2011,7,10,6,17,146,217,363
2011,7,10,6,18,141,222,363
2011,7,10,6,19,120,182,302
2011,7,10,6,20,101,167,268
2011,7,10,6,21,65,161,226
2011,7,10,6,22,56,87,143
2011,7,10,6,23,19,53,72
2011,7,11,0,0,10,25,35
2011,7,11,0,1,5,5,10
2011,7,11,0,2,8,4,12
2011,7,11,0,3,2,8,10
2011,7,11,0,4,0,4,4
2011,7,11,0,5,5,21,26
2011,7,11,0,6,19,101,120
2011,7,11,0,7,28,289,317
2011,7,11,0,8,35,384,419
2011,7,11,0,9,40,167,207
2011,7,11,0,10,44,73,117
2011,7,11,0,11,39,89,128
2011,7,11,0,12,40,108,148
2011,7,11,0,13,22,119,141
2011,7,11,0,14,40,93,133
2011,7,11,0,15,38,107,145
2011,7,11,0,16,57,181,238
2011,7,11,0,17,58,455,513
2011,7,11,0,18,57,414,471
2011,7,11,0,19,80,293,373
2011,7,11,0,20,42,194,236
2011,7,11,0,21,21,109,130
2011,7,11,0,22,20,70,90
2011,7,11,0,23,11,44,55
2011,7,12,1,0,3,19,22
2011,7,12,1,1,6,8,14
2011,7,12,1,2,2,7,9
2011,7,12,1,3,2,6,8
2011,7,12,1,4,0,6,6
2011,7,12,1,5,4,21,25
2011,7,12,1,6,13,101,114
2011,7,12,1,7,29,300,329
2011,7,12,1,8,35,381,416
2011,7,12,1,9,27,149,176
2011,7,12,1,10,38,85,123
2011,7,12,1,11,39,86,125
2011,7,12,1,12,38,124,162
2011,7,12,1,13,32,103,135
2011,7,12,1,14,33,90,123
2011,7,12,1,15,37,110,147
2011,7,12,1,16,24,177,201
2011,7,12,1,17,48,380,428
2011,7,12,1,18,39,471,510
2011,7,12,1,19,42,293,335
2011,7,12,1,20,57,251,308
2011,7,12,1,21,49,209,258
2011,7,12,1,22,44,150,194
2011,7,12,1,23,20,59,79
2011,7,13,2,0,9,37,46
2011,7,13,2,1,1,11,12
2011,7,13,2,2,2,3,5
2011,7,13,2,3,0,4,4
2011,7,13,2,4,0,5,5
2011,7,13,2,5,4,22,26
2011,7,13,2,6,18,103,121
2011,7,13,2,7,32,279,311
2011,7,13,2,8,31,417,448
2011,7,13,2,9,23,162,185
2011,7,13,2,10,33,79,112
2011,7,13,2,11,55,108,163
2011,7,13,2,12,40,134,174
2011,7,13,2,13,39,118,157
2011,7,13,2,14,27,89,116
2011,7,13,2,15,13,33,46
2011,7,13,2,16,23,118,141
2011,7,13,2,17,70,418,488
2011,7,13,2,18,51,411,462
2011,7,13,2,19,79,340,419
2011,7,13,2,20,61,281,342
2011,7,13,2,21,56,194,250
2011,7,13,2,22,48,136,184
2011,7,13,2,23,33,83,116
2011,7,14,3,0,14,32,46
2011,7,14,3,1,4,21,25
2011,7,14,3,2,3,7,10
2011,7,14,3,3,1,5,6
2011,7,14,3,4,0,6,6
2011,7,14,3,5,6,22,28
2011,7,14,3,6,14,115,129
2011,7,14,3,7,23,307,330
2011,7,14,3,8,53,433,486
2011,7,14,3,9,29,194,223
2011,7,14,3,10,32,95,127
2011,7,14,3,11,38,110,148
2011,7,14,3,12,51,172,223
2011,7,14,3,13,39,138,177
2011,7,14,3,14,49,128,177
2011,7,14,3,15,42,137,179
2011,7,14,3,16,43,231,274
2011,7,14,3,17,78,517,595
2011,7,14,3,18,94,482,576
2011,7,14,3,19,67,330,397
2011,7,14,3,20,81,267,348
2011,7,14,3,21,58,203,261
2011,7,14,3,22,42,134,176
2011,7,14,3,23,27,97,124
2011,7,15,4,0,23,57,80
2011,7,15,4,1,7,13,20
2011,7,15,4,2,16,22,38
2011,7,15,4,3,1,6,7
2011,7,15,4,4,2,8,10
2011,7,15,4,5,7,16,23
2011,7,15,4,6,12,107,119
2011,7,15,4,7,17,253,270
2011,7,15,4,8,50,513,563
2011,7,15,4,9,31,176,207
2011,7,15,4,10,59,107,166
2011,7,15,4,11,73,137,210
2011,7,15,4,12,61,177,238
2011,7,15,4,13,85,162,247
2011,7,15,4,14,105,160,265
2011,7,15,4,15,74,161,235
2011,7,15,4,16,96,265,361
2011,7,15,4,17,104,482,586
2011,7,15,4,18,102,393,495
2011,7,15,4,19,114,280,394
2011,7,15,4,20,92,251,343
2011,7,15,4,21,75,186,261
2011,7,15,4,22,71,152,223
2011,7,15,4,23,41,126,167
2011,7,16,5,0,42,68,110
2011,7,16,5,1,24,51,75
2011,7,16,5,2,10,48,58
2011,7,16,5,3,6,20,26
2011,7,16,5,4,9,7,16
2011,7,16,5,5,4,6,10
2011,7,16,5,6,16,21,37
2011,7,16,5,7,14,38,52
2011,7,16,5,8,37,90,127
2011,7,16,5,9,72,150,222
2011,7,16,5,10,114,208,322
2011,7,16,5,11,171,225,396
2011,7,16,5,12,187,276,463
2011,7,16,5,13,221,275,496
2011,7,16,5,14,201,232,433
2011,7,16,5,15,205,223,428
2011,7,16,5,16,183,242,425
2011,7,16,5,17,234,240,474
2011,7,16,5,18,185,243,428
2011,7,16,5,19,164,242,406
2011,7,16,5,20,108,188,296
2011,7,16,5,21,85,167,252
2011,7,16,5,22,65,136,201
2011,7,16,5,23,61,107,168
2011,7,17,6,0,34,91,125
2011,7,17,6,1,16,86,102
2011,7,17,6,2,28,66,94
2011,7,17,6,3,21,26,47
2011,7,17,6,4,4,5,9
2011,7,17,6,5,4,8,12
2011,7,17,6,6,10,10,20
2011,7,17,6,7,20,30,50
2011,7,17,6,8,45,73,118
2011,7,17,6,9,74,110,184
2011,7,17,6,10,127,177,304
2011,7,17,6,11,147,244,391
2011,7,17,6,12,177,243,420
2011,7,17,6,13,200,272,472
2011,7,17,6,14,168,262,430
2011,7,17,6,15,129,194,323
2011,7,17,6,16,129,186,315
2011,7,17,6,17,133,236,369
2011,7,17,6,18,147,243,390
2011,7,17,6,19,145,234,379
2011,7,17,6,20,85,177,262
2011,7,17,6,21,59,148,207
2011,7,17,6,22,65,116,181
2011,7,17,6,23,39,54,93
2011,7,18,0,0,21,30,51
2011,7,18,0,1,17,8,25
2011,7,18,0,2,2,8,10
2011,7,18,0,3,3,4,7
2011,7,18,0,4,1,3,4
2011,7,18,0,5,2,15,17
2011,7,18,0,6,10,95,105
2011,7,18,0,7,22,252,274
2011,7,18,0,8,18,328,346
2011,7,18,0,9,33,169,202
2011,7,18,0,10,52,78,130
2011,7,18,0,11,42,99,141
2011,7,18,0,12,39,125,164
2011,7,18,0,13,27,124,151
2011,7,18,0,14,32,105,137
2011,7,18,0,15,53,111,164
2011,7,18,0,16,45,220,265
2011,7,18,0,17,72,473,545
2011,7,18,0,18,80,476,556
2011,7,18,0,19,63,332,395
2011,7,18,0,20,91,232,323
2011,7,18,0,21,48,154,202
2011,7,18,0,22,36,104,140
2011,7,18,0,23,32,59,91
2011,7,19,1,0,25,26,51
2011,7,19,1,1,7,6,13
2011,7,19,1,2,9,4,13
2011,7,19,1,3,2,1,3
2011,7,19,1,4,1,4,5
2011,7,19,1,5,0,19,19
2011,7,19,1,6,8,126,134
2011,7,19,1,7,28,284,312
2011,7,19,1,8,31,380,411
2011,7,19,1,9,22,177,199
2011,7,19,1,10,29,112,141
2011,7,19,1,11,29,98,127
2011,7,19,1,12,26,127,153
2011,7,19,1,13,33,139,172
2011,7,19,1,14,41,111,152
2011,7,19,1,15,48,110,158
2011,7,19,1,16,61,215,276
2011,7,19,1,17,68,444,512
2011,7,19,1,18,80,450,530
2011,7,19,1,19,54,333,387
2011,7,19,1,20,47,229,276
2011,7,19,1,21,47,194,241
2011,7,19,1,22,36,120,156
2011,7,19,1,23,19,73,92
2011,7,20,2,0,11,29,40
2011,7,20,2,1,4,7,11
2011,7,20,2,2,2,7,9
2011,7,20,2,3,2,4,6
2011,7,20,2,4,0,4,4
2011,7,20,2,5,4,19,23
2011,7,20,2,6,5,110,115
2011,7,20,2,7,27,274,301
2011,7,20,2,8,34,403,437
2011,7,20,2,9,28,180,208
2011,7,20,2,10,34,75,109
2011,7,20,2,11,26,116,142
2011,7,20,2,12,28,121,149
2011,7,20,2,13,23,96,119
2011,7,20,2,14,44,83,127
2011,7,20,2,15,36,101,137
2011,7,20,2,16,30,204,234
2011,7,20,2,17,50,405,455
2011,7,20,2,18,68,429,497
2011,7,20,2,19,59,322,381
2011,7,20,2,20,45,264,309
2011,7,20,2,21,33,209,242
2011,7,20,2,22,25,144,169
2011,7,20,2,23,26,73,99
2011,7,21,3,0,13,29,42
2011,7,21,3,1,5,16,21
2011,7,21,3,2,2,4,6
2011,7,21,3,3,1,5,6
2011,7,21,3,4,0,4,4
2011,7,21,3,5,2,16,18
2011,7,21,3,6,6,111,117
2011,7,21,3,7,23,249,272
2011,7,21,3,8,23,354,377
2011,7,21,3,9,34,166,200
2011,7,21,3,10,31,47,78
2011,7,21,3,11,27,78,105
2011,7,21,3,12,29,106,135
2011,7,21,3,13,21,81,102
2011,7,21,3,14,50,97,147
2011,7,21,3,15,40,93,133
2011,7,21,3,16,43,166,209
2011,7,21,3,17,40,374,414
2011,7,21,3,18,39,342,381
2011,7,21,3,19,51,233,284
2011,7,21,3,20,38,198,236
2011,7,21,3,21,38,187,225
2011,7,21,3,22,36,113,149
2011,7,21,3,23,40,73,113
2011,7,22,4,0,9,51,60
2011,7,22,4,1,7,17,24
2011,7,22,4,2,0,14,14
2011,7,22,4,3,1,6,7
2011,7,22,4,4,8,5,13
2011,7,22,4,5,2,17,19
2011,7,22,4,6,13,83,96
2011,7,22,4,7,20,228,248
2011,7,22,4,8,30,290,320
2011,7,22,4,9,31,177,208
2011,7,22,4,10,32,82,114
2011,7,22,4,11,23,86,109
2011,7,22,4,12,20,95,115
2011,7,22,4,13,25,98,123
2011,7,22,4,14,24,77,101
2011,7,22,4,15,32,101,133
2011,7,22,4,16,29,153,182
2011,7,22,4,17,35,271,306
2011,7,22,4,18,34,250,284
2011,7,22,4,19,40,210,250
2011,7,22,4,20,46,166,212
2011,7,22,4,21,38,152,190
2011,7,22,4,22,44,105,149
2011,7,22,4,23,19,84,103
2011,7,23,5,0,16,85,101
2011,7,23,5,1,13,57,70
2011,7,23,5,2,13,48,61
2011,7,23,5,3,6,16,22
2011,7,23,5,4,5,4,9
2011,7,23,5,5,1,6,7
2011,7,23,5,6,6,19,25
2011,7,23,5,7,7,38,45
2011,7,23,5,8,24,85,109
2011,7,23,5,9,30,101,131
2011,7,23,5,10,61,137,198
2011,7,23,5,11,62,154,216
2011,7,23,5,12,71,164,235
2011,7,23,5,13,78,167,245
2011,7,23,5,14,84,152,236
2011,7,23,5,15,78,137,215
2011,7,23,5,16,70,151,221
2011,7,23,5,17,70,127,197
2011,7,23,5,18,62,134,196
2011,7,23,5,19,80,136,216
2011,7,23,5,20,47,98,145
2011,7,23,5,21,39,114,153
2011,7,23,5,22,37,88,125
2011,7,23,5,23,27,77,104
2011,7,24,6,0,42,77,119
2011,7,24,6,1,33,63,96
2011,7,24,6,2,12,48,60
2011,7,24,6,3,16,20,36
2011,7,24,6,4,1,5,6
2011,7,24,6,5,5,3,8
2011,7,24,6,6,9,13,22
2011,7,24,6,7,6,29,35
2011,7,24,6,8,22,82,104
2011,7,24,6,9,42,112,154
2011,7,24,6,10,61,165,226
2011,7,24,6,11,74,169,243
2011,7,24,6,12,85,161,246
2011,7,24,6,13,90,162,252
2011,7,24,6,14,79,204,283
2011,7,24,6,15,68,170,238
2011,7,24,6,16,62,187,249
2011,7,24,6,17,75,174,249
2011,7,24,6,18,67,176,243
2011,7,24,6,19,70,170,240
2011,7,24,6,20,52,143,195
2011,7,24,6,21,42,111,153
2011,7,24,6,22,23,75,98
2011,7,24,6,23,13,37,50
2011,7,25,0,0,17,17,34
2011,7,25,0,1,4,8,12
2011,7,25,0,2,3,3,6
2011,7,25,0,3,2,2,4
2011,7,25,0,4,0,6,6
2011,7,25,0,5,2,22,24
2011,7,25,0,6,7,100,107
2011,7,25,0,7,20,256,276
2011,7,25,0,8,34,353,387
2011,7,25,0,9,11,124,135
2011,7,25,0,10,30,54,84
2011,7,25,0,11,24,83,107
2011,7,25,0,12,17,49,66
2011,7,25,0,13,14,64,78
2011,7,25,0,14,28,61,89
2011,7,25,0,15,16,96,112
2011,7,25,0,16,37,160,197
2011,7,25,0,17,48,437,485
2011,7,25,0,18,60,473,533
2011,7,25,0,19,62,322,384
2011,7,25,0,20,55,247,302
2011,7,25,0,21,41,153,194
2011,7,25,0,22,13,112,125
2011,7,25,0,23,23,64,87
2011,7,26,1,0,8,20,28
2011,7,26,1,1,6,6,12
2011,7,26,1,2,1,6,7
2011,7,26,1,3,2,2,4
2011,7,26,1,4,0,6,6
2011,7,26,1,5,3,24,27
2011,7,26,1,6,2,108,110
2011,7,26,1,7,30,285,315
2011,7,26,1,8,32,388,420
2011,7,26,1,9,25,161,186
2011,7,26,1,10,42,96,138
2011,7,26,1,11,49,102,151
2011,7,26,1,12,25,122,147
2011,7,26,1,13,43,139,182
2011,7,26,1,14,46,100,146
2011,7,26,1,15,49,114,163
2011,7,26,1,16,41,212,253
2011,7,26,1,17,72,465,537
2011,7,26,1,18,68,477,545
2011,7,26,1,19,69,327,396
2011,7,26,1,20,47,243,290
2011,7,26,1,21,45,222,267
2011,7,26,1,22,27,131,158
2011,7,26,1,23,18,71,89
2011,7,27,2,0,19,26,45
2011,7,27,2,1,1,9,10
2011,7,27,2,2,1,5,6
2011,7,27,2,3,0,4,4
2011,7,27,2,4,1,3,4
2011,7,27,2,5,0,18,18
2011,7,27,2,6,4,119,123
2011,7,27,2,7,34,311,345
2011,7,27,2,8,28,401,429
2011,7,27,2,9,26,189,215
2011,7,27,2,10,32,81,113
2011,7,27,2,11,42,94,136
2011,7,27,2,12,37,132,169
2011,7,27,2,13,29,151,180
2011,7,27,2,14,20,106,126
2011,7,27,2,15,37,103,140
2011,7,27,2,16,40,227,267
2011,7,27,2,17,80,491,571
2011,7,27,2,18,78,462,540
2011,7,27,2,19,87,288,375
2011,7,27,2,20,55,239,294
2011,7,27,2,21,49,196,245
2011,7,27,2,22,37,143,180
2011,7,27,2,23,16,93,109
2011,7,28,3,0,14,31,45
2011,7,28,3,1,3,26,29
2011,7,28,3,2,2,5,7
2011,7,28,3,3,0,5,5
2011,7,28,3,4,0,6,6
2011,7,28,3,5,1,26,27
2011,7,28,3,6,6,110,116
2011,7,28,3,7,27,276,303
2011,7,28,3,8,47,409,456
2011,7,28,3,9,21,188,209
2011,7,28,3,10,30,86,116
2011,7,28,3,11,41,111,152
2011,7,28,3,12,35,151,186
2011,7,28,3,13,26,126,152
2011,7,28,3,14,27,110,137
2011,7,28,3,15,22,122,144
2011,7,28,3,16,42,214,256
2011,7,28,3,17,45,423,468
2011,7,28,3,18,55,428,483
2011,7,28,3,19,37,283,320
2011,7,28,3,20,41,229,270
2011,7,28,3,21,31,164,195
2011,7,28,3,22,25,149,174
2011,7,28,3,23,28,95,123
2011,7,29,4,0,12,45,57
2011,7,29,4,1,12,22,34
2011,7,29,4,2,3,10,13
2011,7,29,4,3,2,9,11
2011,7,29,4,4,2,4,6
2011,7,29,4,5,4,23,27
2011,7,29,4,6,7,83,90
2011,7,29,4,7,26,228,254
2011,7,29,4,8,30,354,384
2011,7,29,4,9,28,151,179
2011,7,29,4,10,37,69,106
2011,7,29,4,11,43,118,161
2011,7,29,4,12,40,95,135
2011,7,29,4,13,42,114,156
2011,7,29,4,14,34,114,148
2011,7,29,4,15,40,129,169
2011,7,29,4,16,35,197,232
2011,7,29,4,17,47,374,421
2011,7,29,4,18,49,312,361
2011,7,29,4,19,22,219,241
2011,7,29,4,20,53,153,206
2011,7,29,4,21,29,134,163
2011,7,29,4,22,47,127,174
2011,7,29,4,23,26,90,116
2011,7,30,5,0,60,73,133
2011,7,30,5,1,15,75,90
2011,7,30,5,2,11,31,42
2011,7,30,5,3,18,25,43
2011,7,30,5,4,4,6,10
2011,7,30,5,5,4,9,13
2011,7,30,5,6,6,18,24
2011,7,30,5,7,3,39,42
2011,7,30,5,8,27,87,114
2011,7,30,5,9,49,125,174
2011,7,30,5,10,79,182,261
2011,7,30,5,11,110,206,316
2011,7,30,5,12,111,230,341
2011,7,30,5,13,125,183,308
2011,7,30,5,14,112,193,305
2011,7,30,5,15,113,189,302
2011,7,30,5,16,126,176,302
2011,7,30,5,17,93,209,302
2011,7,30,5,18,92,207,299
2011,7,30,5,19,101,155,256
2011,7,30,5,20,74,132,206
2011,7,30,5,21,82,123,205
2011,7,30,5,22,80,129,209
2011,7,30,5,23,63,114,177
2011,7,31,6,0,33,80,113
2011,7,31,6,1,8,71,79
2011,7,31,6,2,19,48,67
2011,7,31,6,3,24,26,50
2011,7,31,6,4,6,7,13
2011,7,31,6,5,4,4,8
2011,7,31,6,6,5,8,13
2011,7,31,6,7,19,26,45
2011,7,31,6,8,54,88,142
2011,7,31,6,9,55,128,183
2011,7,31,6,10,91,163,254
2011,7,31,6,11,112,162,274
2011,7,31,6,12,146,192,338
2011,7,31,6,13,142,152,294
2011,7,31,6,14,130,195,325
2011,7,31,6,15,109,184,293
2011,7,31,6,16,98,208,306
2011,7,31,6,17,114,206,320
2011,7,31,6,18,91,213,304
2011,7,31,6,19,87,187,274
2011,7,31,6,20,70,205,275
2011,7,31,6,21,68,96,164
2011,7,31,6,22,25,71,96
2011,7,31,6,23,14,56,70
2011,8,1,0,0,7,22,29
2011,8,1,0,1,5,12,17
2011,8,1,0,2,4,7,11
2011,8,1,0,3,0,4,4
2011,8,1,0,4,2,2,4
2011,8,1,0,5,2,24,26
2011,8,1,0,6,3,97,100
2011,8,1,0,7,24,256,280
2011,8,1,0,8,35,345,380
2011,8,1,0,9,27,139,166
2011,8,1,0,10,27,69,96
2011,8,1,0,11,53,66,119
2011,8,1,0,12,53,115,168
2011,8,1,0,13,38,112,150
2011,8,1,0,14,37,86,123
2011,8,1,0,15,52,76,128
2011,8,1,0,16,34,197,231
2011,8,1,0,17,69,445,514
2011,8,1,0,18,68,473,541
2011,8,1,0,19,63,348,411
2011,8,1,0,20,49,256,305
2011,8,1,0,21,42,177,219
2011,8,1,0,22,21,116,137
2011,8,1,0,23,14,82,96
2011,8,2,1,0,11,18,29
2011,8,2,1,1,4,8,12
2011,8,2,1,2,2,6,8
2011,8,2,1,3,0,5,5
2011,8,2,1,4,0,10,10
2011,8,2,1,5,4,17,21
2011,8,2,1,6,12,104,116
2011,8,2,1,7,15,317,332
2011,8,2,1,8,37,398,435
2011,8,2,1,9,31,182,213
2011,8,2,1,10,50,90,140
2011,8,2,1,11,32,96,128
2011,8,2,1,12,45,112,157
2011,8,2,1,13,50,152,202
2011,8,2,1,14,45,113,158
2011,8,2,1,15,48,120,168
2011,8,2,1,16,58,216,274
2011,8,2,1,17,63,492,555
2011,8,2,1,18,64,489,553
2011,8,2,1,19,85,369,454
2011,8,2,1,20,40,248,288
2011,8,2,1,21,53,201,254
2011,8,2,1,22,22,169,191
2011,8,2,1,23,29,103,132
2011,8,3,2,0,11,32,43
2011,8,3,2,1,7,9,16
2011,8,3,2,2,2,9,11
2011,8,3,2,3,0,4,4
2011,8,3,2,4,0,7,7
2011,8,3,2,5,2,22,24
2011,8,3,2,6,9,101,110
2011,8,3,2,7,19,252,271
2011,8,3,2,8,29,407,436
2011,8,3,2,9,23,172,195
2011,8,3,2,10,9,59,68
2011,8,3,2,11,29,92,121
2011,8,3,2,12,19,142,161
2011,8,3,2,13,37,107,144
2011,8,3,2,14,43,103,146
2011,8,3,2,15,31,87,118
2011,8,3,2,16,21,128,149
2011,8,3,2,17,47,378,425
2011,8,3,2,18,49,443,492
2011,8,3,2,19,51,270,321
2011,8,3,2,20,7,80,87
2011,8,3,2,21,7,81,88
2011,8,3,2,22,11,66,77
2011,8,3,2,23,4,52,56
2011,8,4,3,0,2,15,17
2011,8,4,3,1,3,14,17
2011,8,4,3,2,2,5,7
2011,8,4,3,3,0,3,3
2011,8,4,3,4,0,7,7
2011,8,4,3,5,3,17,20
2011,8,4,3,6,7,90,97
2011,8,4,3,7,11,271,282
2011,8,4,3,8,29,365,394
2011,8,4,3,9,25,161,186
2011,8,4,3,10,24,89,113
2011,8,4,3,11,37,112,149
2011,8,4,3,12,53,152,205
2011,8,4,3,13,63,142,205
2011,8,4,3,14,53,114,167
2011,8,4,3,15,50,115,165
2011,8,4,3,16,70,220,290
2011,8,4,3,17,91,464,555
2011,8,4,3,18,88,433,521
2011,8,4,3,19,65,301,366
2011,8,4,3,20,41,245,286
2011,8,4,3,21,25,186,211
2011,8,4,3,22,33,141,174
2011,8,4,3,23,24,108,132
2011,8,5,4,0,13,41,54
2011,8,5,4,1,3,16,19
2011,8,5,4,2,5,14,19
2011,8,5,4,3,0,6,6
2011,8,5,4,4,1,6,7
2011,8,5,4,5,0,16,16
2011,8,5,4,6,7,94,101
2011,8,5,4,7,23,245,268
2011,8,5,4,8,39,414,453
2011,8,5,4,9,43,183,226
2011,8,5,4,10,50,113,163
2011,8,5,4,11,44,103,147
2011,8,5,4,12,57,159,216
2011,8,5,4,13,40,164,204
2011,8,5,4,14,81,164,245
2011,8,5,4,15,50,160,210
2011,8,5,4,16,76,253,329
2011,8,5,4,17,84,463,547
2011,8,5,4,18,105,361,466
2011,8,5,4,19,90,282,372
2011,8,5,4,20,70,221,291
2011,8,5,4,21,54,119,173
2011,8,5,4,22,51,136,187
2011,8,5,4,23,37,102,139
2011,8,6,5,0,29,104,133
2011,8,6,5,1,17,50,67
2011,8,6,5,2,14,39,53
2011,8,6,5,3,14,28,42
2011,8,6,5,4,5,5,10
2011,8,6,5,5,2,4,6
2011,8,6,5,6,5,22,27
2011,8,6,5,7,14,49,63
2011,8,6,5,8,27,94,121
2011,8,6,5,9,60,155,215
2011,8,6,5,10,91,198,289
2011,8,6,5,11,138,211,349
2011,8,6,5,12,130,252,382
2011,8,6,5,13,176,265,441
2011,8,6,5,14,176,204,380
2011,8,6,5,15,130,232,362
2011,8,6,5,16,155,188,343
2011,8,6,5,17,61,88,149
2011,8,6,5,18,81,130,211
2011,8,6,5,19,57,114,171
2011,8,6,5,20,58,79,137
2011,8,6,5,21,28,86,114
2011,8,6,5,22,24,96,120
2011,8,6,5,23,29,78,107
2011,8,7,6,0,14,66,80
2011,8,7,6,1,10,63,73
2011,8,7,6,2,18,48,66
2011,8,7,6,3,9,23,32
2011,8,7,6,4,1,5,6
2011,8,7,6,5,1,4,5
2011,8,7,6,6,3,10,13
2011,8,7,6,7,11,28,39
2011,8,7,6,8,23,66,89
2011,8,7,6,9,82,102,184
2011,8,7,6,10,88,178,266
2011,8,7,6,11,113,155,268
2011,8,7,6,12,161,209,370
2011,8,7,6,13,118,206,324
2011,8,7,6,14,130,191,321
2011,8,7,6,15,118,208,326
2011,8,7,6,16,74,118,192
2011,8,7,6,17,63,131,194
2011,8,7,6,18,74,155,229
2011,8,7,6,19,68,160,228
2011,8,7,6,20,50,132,182
2011,8,7,6,21,36,100,136
2011,8,7,6,22,21,82,103
2011,8,7,6,23,12,43,55
2011,8,8,0,0,13,17,30
2011,8,8,0,1,4,8,12
2011,8,8,0,2,4,3,7
2011,8,8,0,3,1,0,1
2011,8,8,0,4,2,8,10
2011,8,8,0,5,1,14,15
2011,8,8,0,6,8,87,95
2011,8,8,0,7,18,245,263
2011,8,8,0,8,29,319,348
2011,8,8,0,9,37,145,182
2011,8,8,0,10,62,61,123
2011,8,8,0,11,89,89,178
2011,8,8,0,12,48,134,182
2011,8,8,0,13,43,108,151
2011,8,8,0,14,41,109,150
2011,8,8,0,15,40,86,126
2011,8,8,0,16,64,218,282
2011,8,8,0,17,67,459,526
2011,8,8,0,18,64,464,528
2011,8,8,0,19,64,351,415
2011,8,8,0,20,71,215,286
2011,8,8,0,21,30,156,186
2011,8,8,0,22,26,121,147
2011,8,8,0,23,19,53,72
2011,8,9,1,0,10,25,35
2011,8,9,1,1,5,9,14
2011,8,9,1,2,9,3,12
2011,8,9,1,3,0,3,3
2011,8,9,1,4,1,6,7
2011,8,9,1,5,5,25,30
2011,8,9,1,6,6,95,101
2011,8,9,1,7,30,309,339
2011,8,9,1,8,40,350,390
2011,8,9,1,9,34,139,173
2011,8,9,1,10,55,88,143
2011,8,9,1,11,60,88,148
2011,8,9,1,12,60,125,185
2011,8,9,1,13,48,127,175
2011,8,9,1,14,53,94,147
2011,8,9,1,15,58,106,164
2011,8,9,1,16,57,228,285
2011,8,9,1,17,79,450,529
2011,8,9,1,18,97,488,585
2011,8,9,1,19,69,302,371
2011,8,9,1,20,34,258,292
2011,8,9,1,21,46,184,230
2011,8,9,1,22,28,127,155
2011,8,9,1,23,22,53,75
2011,8,10,2,0,19,18,37
2011,8,10,2,1,7,10,17
2011,8,10,2,2,1,10,11
2011,8,10,2,3,1,3,4
2011,8,10,2,4,1,4,5
2011,8,10,2,5,2,30,32
2011,8,10,2,6,9,110,119
2011,8,10,2,7,16,287,303
2011,8,10,2,8,38,360,398
2011,8,10,2,9,32,146,178
2011,8,10,2,10,41,72,113
2011,8,10,2,11,54,95,149
2011,8,10,2,12,74,166,240
2011,8,10,2,13,41,150,191
2011,8,10,2,14,62,115,177
2011,8,10,2,15,53,141,194
2011,8,10,2,16,76,206,282
2011,8,10,2,17,71,513,584
2011,8,10,2,18,70,488,558
2011,8,10,2,19,79,331,410
2011,8,10,2,20,59,252,311
2011,8,10,2,21,47,162,209
2011,8,10,2,22,17,122,139
2011,8,10,2,23,14,92,106
2011,8,11,3,0,6,40,46
2011,8,11,3,1,9,17,26
2011,8,11,3,2,3,8,11
2011,8,11,3,3,2,7,9
2011,8,11,3,4,1,4,5
2011,8,11,3,5,2,23,25
2011,8,11,3,6,5,101,106
2011,8,11,3,7,15,288,303
2011,8,11,3,8,29,359,388
2011,8,11,3,9,31,166,197
2011,8,11,3,10,36,96,132
2011,8,11,3,11,59,127,186
2011,8,11,3,12,50,164,214
2011,8,11,3,13,51,166,217
2011,8,11,3,14,39,103,142
2011,8,11,3,15,52,126,178
2011,8,11,3,16,57,241,298
2011,8,11,3,17,96,486,582
2011,8,11,3,18,74,495,569
2011,8,11,3,19,48,323,371
2011,8,11,3,20,56,232,288
2011,8,11,3,21,35,168,203
2011,8,11,3,22,34,123,157
2011,8,11,3,23,22,105,127
2011,8,12,4,0,12,53,65
2011,8,12,4,1,4,19,23
2011,8,12,4,2,0,15,15
2011,8,12,4,3,0,9,9
2011,8,12,4,4,0,5,5
2011,8,12,4,5,2,24,26
2011,8,12,4,6,3,73,76
2011,8,12,4,7,17,245,262
2011,8,12,4,8,29,394,423
2011,8,12,4,9,27,176,203
2011,8,12,4,10,44,86,130
2011,8,12,4,11,48,107,155
2011,8,12,4,12,55,167,222
2011,8,12,4,13,74,179,253
2011,8,12,4,14,51,133,184
2011,8,12,4,15,59,190,249
2011,8,12,4,16,68,266,334
2011,8,12,4,17,93,422,515
2011,8,12,4,18,89,376,465
2011,8,12,4,19,101,284,385
2011,8,12,4,20,77,210,287
2011,8,12,4,21,73,153,226
2011,8,12,4,22,74,157,231
2011,8,12,4,23,51,100,151
2011,8,13,5,0,15,69,84
2011,8,13,5,1,13,64,77
2011,8,13,5,2,16,58,74
2011,8,13,5,3,9,18,27
2011,8,13,5,4,5,5,10
2011,8,13,5,5,3,15,18
2011,8,13,5,6,3,19,22
2011,8,13,5,7,10,34,44
2011,8,13,5,8,28,90,118
2011,8,13,5,9,70,137,207
2011,8,13,5,10,97,163,260
2011,8,13,5,11,122,192,314
2011,8,13,5,12,175,246,421
2011,8,13,5,13,61,91,152
2011,8,13,5,14,111,144,255
2011,8,13,5,15,150,208,358
2011,8,13,5,16,148,131,279
2011,8,13,5,17,97,172,269
2011,8,13,5,18,123,169,292
2011,8,13,5,19,67,169,236
2011,8,13,5,20,78,105,183
2011,8,13,5,21,40,127,167
2011,8,13,5,22,36,118,154
2011,8,13,5,23,25,95,120
2011,8,14,6,0,19,71,90
2011,8,14,6,1,16,57,73
2011,8,14,6,2,13,49,62
2011,8,14,6,3,5,22,27
2011,8,14,6,4,1,2,3
2011,8,14,6,5,1,9,10
2011,8,14,6,6,2,4,6
2011,8,14,6,7,4,20,24
2011,8,14,6,8,20,21,41
2011,8,14,6,9,27,76,103
2011,8,14,6,10,67,116,183
2011,8,14,6,11,81,117,198
2011,8,14,6,12,98,183,281
2011,8,14,6,13,144,233,377
2011,8,14,6,14,126,244,370
2011,8,14,6,15,128,202,330
2011,8,14,6,16,116,176,292
2011,8,14,6,17,133,196,329
2011,8,14,6,18,125,222,347
2011,8,14,6,19,75,184,259
2011,8,14,6,20,67,126,193
2011,8,14,6,21,51,104,155
2011,8,14,6,22,14,25,39
2011,8,14,6,23,5,22,27
2011,8,15,0,0,7,18,25
2011,8,15,0,1,1,9,10
2011,8,15,0,2,0,3,3
2011,8,15,0,3,1,6,7
2011,8,15,0,4,1,4,5
2011,8,15,0,5,3,14,17
2011,8,15,0,6,3,87,90
2011,8,15,0,7,10,248,258
2011,8,15,0,8,29,326,355
2011,8,15,0,9,52,170,222
2011,8,15,0,10,54,86,140
2011,8,15,0,11,41,112,153
2011,8,15,0,12,62,116,178
2011,8,15,0,13,53,140,193
2011,8,15,0,14,56,95,151
2011,8,15,0,15,49,133,182
2011,8,15,0,16,58,225,283
2011,8,15,0,17,59,471,530
2011,8,15,0,18,70,413,483
2011,8,15,0,19,54,343,397
2011,8,15,0,20,45,240,285
2011,8,15,0,21,34,150,184
2011,8,15,0,22,22,76,98
2011,8,15,0,23,11,77,88
2011,8,16,1,0,8,23,31
2011,8,16,1,1,4,12,16
2011,8,16,1,2,1,3,4
2011,8,16,1,3,1,5,6
2011,8,16,1,4,0,5,5
2011,8,16,1,5,1,29,30
2011,8,16,1,6,4,115,119
2011,8,16,1,7,18,326,344
2011,8,16,1,8,24,415,439
2011,8,16,1,9,27,171,198
2011,8,16,1,10,28,83,111
2011,8,16,1,11,40,109,149
2011,8,16,1,12,42,119,161
2011,8,16,1,13,45,147,192
2011,8,16,1,14,65,117,182
2011,8,16,1,15,36,122,158
2011,8,16,1,16,55,247,302
2011,8,16,1,17,75,523,598
2011,8,16,1,18,54,516,570
2011,8,16,1,19,56,320,376
2011,8,16,1,20,48,232,280
2011,8,16,1,21,38,177,215
2011,8,16,1,22,31,121,152
2011,8,16,1,23,20,57,77
2011,8,17,2,0,8,16,24
2011,8,17,2,1,2,12,14
2011,8,17,2,2,0,6,6
2011,8,17,2,3,1,4,5
2011,8,17,2,4,0,5,5
2011,8,17,2,5,0,28,28
2011,8,17,2,6,4,101,105
2011,8,17,2,7,12,295,307
2011,8,17,2,8,35,449,484
2011,8,17,2,9,31,177,208
2011,8,17,2,10,27,91,118
2011,8,17,2,11,20,108,128
2011,8,17,2,12,26,162,188
2011,8,17,2,13,38,138,176
2011,8,17,2,14,54,134,188
2011,8,17,2,15,42,117,159
2011,8,17,2,16,62,237,299
2011,8,17,2,17,46,506,552
2011,8,17,2,18,86,470,556
2011,8,17,2,19,50,297,347
2011,8,17,2,20,37,243,280
2011,8,17,2,21,38,190,228
2011,8,17,2,22,29,142,171
2011,8,17,2,23,20,85,105
2011,8,18,3,0,18,38,56
2011,8,18,3,1,13,11,24
2011,8,18,3,2,2,4,6
2011,8,18,3,3,0,6,6
2011,8,18,3,4,0,9,9
2011,8,18,3,5,0,27,27
2011,8,18,3,6,6,97,103
2011,8,18,3,7,19,287,306
2011,8,18,3,8,27,393,420
2011,8,18,3,9,42,186,228
2011,8,18,3,10,37,91,128
2011,8,18,3,11,44,96,140
2011,8,18,3,12,34,139,173
2011,8,18,3,13,33,154,187
2011,8,18,3,14,67,114,181
2011,8,18,3,15,56,117,173
2011,8,18,3,16,49,196,245
2011,8,18,3,17,44,365,409
2011,8,18,3,18,48,224,272
2011,8,18,3,19,26,115,141
2011,8,18,3,20,24,141,165
2011,8,18,3,21,12,137,149
2011,8,18,3,22,18,117,135
2011,8,18,3,23,20,94,114
2011,8,19,4,0,9,53,62
2011,8,19,4,1,1,19,20
2011,8,19,4,2,0,8,8
2011,8,19,4,3,2,1,3
2011,8,19,4,4,1,6,7
2011,8,19,4,5,1,16,17
2011,8,19,4,6,2,90,92
2011,8,19,4,7,12,249,261
2011,8,19,4,8,30,367,397
2011,8,19,4,9,31,187,218
2011,8,19,4,10,57,108,165
2011,8,19,4,11,45,119,164
2011,8,19,4,12,54,168,222
2011,8,19,4,13,63,168,231
2011,8,19,4,14,78,142,220
2011,8,19,4,15,66,156,222
2011,8,19,4,16,66,261,327
2011,8,19,4,17,85,441,526
2011,8,19,4,18,88,337,425
2011,8,19,4,19,33,132,165
2011,8,19,4,20,12,46,58
2011,8,19,4,21,18,89,107
2011,8,19,4,22,25,97,122
2011,8,19,4,23,18,88,106
2011,8,20,5,0,21,107,128
2011,8,20,5,1,12,35,47
2011,8,20,5,2,10,59,69
2011,8,20,5,3,9,42,51
2011,8,20,5,4,1,5,6
2011,8,20,5,5,0,8,8
2011,8,20,5,6,6,18,24
2011,8,20,5,7,8,36,44
2011,8,20,5,8,27,106,133
2011,8,20,5,9,51,139,190
2011,8,20,5,10,114,192,306
2011,8,20,5,11,115,223,338
2011,8,20,5,12,156,253,409
2011,8,20,5,13,158,220,378
2011,8,20,5,14,147,228,375
2011,8,20,5,15,175,215,390
2011,8,20,5,16,151,222,373
2011,8,20,5,17,180,203,383
2011,8,20,5,18,169,225,394
2011,8,20,5,19,109,182,291
2011,8,20,5,20,78,170,248
2011,8,20,5,21,81,144,225
2011,8,20,5,22,77,146,223
2011,8,20,5,23,59,98,157
2011,8,21,6,0,6,68,74
2011,8,21,6,1,17,69,86
2011,8,21,6,2,13,51,64
2011,8,21,6,3,25,26,51
2011,8,21,6,4,1,5,6
2011,8,21,6,5,0,8,8
2011,8,21,6,6,4,10,14
2011,8,21,6,7,12,19,31
2011,8,21,6,8,30,62,92
2011,8,21,6,9,80,151,231
2011,8,21,6,10,97,177,274
2011,8,21,6,11,132,180,312
2011,8,21,6,12,135,238,373
2011,8,21,6,13,94,216,310
2011,8,21,6,14,78,157,235
2011,8,21,6,15,17,51,68
2011,8,21,6,16,97,161,258
2011,8,21,6,17,91,179,270
2011,8,21,6,18,96,215,311
2011,8,21,6,19,81,201,282
2011,8,21,6,20,41,140,181
2011,8,21,6,21,45,93,138
2011,8,21,6,22,37,97,134
2011,8,21,6,23,20,48,68
2011,8,22,0,0,18,22,40
2011,8,22,0,1,8,13,21
2011,8,22,0,2,2,6,8
2011,8,22,0,3,0,5,5
2011,8,22,0,4,2,10,12
2011,8,22,0,5,1,23,24
2011,8,22,0,6,6,106,112
2011,8,22,0,7,11,269,280
2011,8,22,0,8,20,330,350
2011,8,22,0,9,36,151,187
2011,8,22,0,10,36,85,121
2011,8,22,0,11,46,85,131
2011,8,22,0,12,54,153,207
2011,8,22,0,13,47,158,205
2011,8,22,0,14,88,137,225
2011,8,22,0,15,72,127,199
2011,8,22,0,16,65,254,319
2011,8,22,0,17,81,509,590
2011,8,22,0,18,72,537,609
2011,8,22,0,19,66,350,416
2011,8,22,0,20,21,247,268
2011,8,22,0,21,28,180,208
2011,8,22,0,22,32,121,153
2011,8,22,0,23,19,45,64
2011,8,23,1,0,13,22,35
2011,8,23,1,1,6,13,19
2011,8,23,1,2,2,4,6
2011,8,23,1,3,2,4,6
2011,8,23,1,4,0,5,5
2011,8,23,1,5,1,35,36
2011,8,23,1,6,3,111,114
2011,8,23,1,7,11,333,344
2011,8,23,1,8,43,458,501
2011,8,23,1,9,34,191,225
2011,8,23,1,10,56,92,148
2011,8,23,1,11,62,124,186
2011,8,23,1,12,60,177,237
2011,8,23,1,13,70,164,234
2011,8,23,1,14,148,501,649
2011,8,23,1,15,175,422,597
2011,8,23,1,16,132,310,442
2011,8,23,1,17,133,337,470
2011,8,23,1,18,98,420,518
2011,8,23,1,19,70,297,367
2011,8,23,1,20,54,206,260
2011,8,23,1,21,38,173,211
2011,8,23,1,22,46,145,191
2011,8,23,1,23,19,61,80
2011,8,24,2,0,9,29,38
2011,8,24,2,1,7,17,24
2011,8,24,2,2,2,4,6
2011,8,24,2,3,0,1,1
2011,8,24,2,4,0,5,5
2011,8,24,2,5,1,26,27
2011,8,24,2,6,3,105,108
2011,8,24,2,7,11,296,307
2011,8,24,2,8,32,434,466
2011,8,24,2,9,44,169,213
2011,8,24,2,10,51,95,146
2011,8,24,2,11,57,128,185
2011,8,24,2,12,60,172,232
2011,8,24,2,13,54,180,234
2011,8,24,2,14,77,127,204
2011,8,24,2,15,61,141,202
2011,8,24,2,16,49,222,271
2011,8,24,2,17,83,482,565
2011,8,24,2,18,102,518,620
2011,8,24,2,19,93,346,439
2011,8,24,2,20,45,289,334
2011,8,24,2,21,47,189,236
2011,8,24,2,22,41,140,181
2011,8,24,2,23,16,54,70
2011,8,25,3,0,11,41,52
2011,8,25,3,1,4,11,15
2011,8,25,3,2,3,2,5
2011,8,25,3,3,2,2,4
2011,8,25,3,4,1,5,6
2011,8,25,3,5,1,25,26
2011,8,25,3,6,1,101,102
2011,8,25,3,7,17,295,312
2011,8,25,3,8,23,458,481
2011,8,25,3,9,21,140,161
2011,8,25,3,10,37,105,142
2011,8,25,3,11,39,112,151
2011,8,25,3,12,9,32,41
2011,8,25,3,13,7,30,37
2011,8,25,3,14,27,86,113
2011,8,25,3,15,28,104,132
2011,8,25,3,16,16,105,121
2011,8,25,3,17,28,284,312
2011,8,25,3,18,31,374,405
2011,8,25,3,19,31,241,272
2011,8,25,3,20,33,192,225
2011,8,25,3,21,29,158,187
2011,8,25,3,22,21,126,147
2011,8,25,3,23,15,69,84
2011,8,26,4,0,9,42,51
2011,8,26,4,1,10,13,23
2011,8,26,4,2,4,16,20
2011,8,26,4,3,3,8,11
2011,8,26,4,4,2,6,8
2011,8,26,4,5,3,23,26
2011,8,26,4,6,5,100,105
2011,8,26,4,7,3,262,265
2011,8,26,4,8,17,386,403
2011,8,26,4,9,39,190,229
2011,8,26,4,10,34,89,123
2011,8,26,4,11,63,151,214
2011,8,26,4,12,70,173,243
2011,8,26,4,13,72,165,237
2011,8,26,4,14,55,163,218
2011,8,26,4,15,53,196,249
2011,8,26,4,16,50,292,342
2011,8,26,4,17,56,433,489
2011,8,26,4,18,40,370,410
2011,8,26,4,19,55,234,289
2011,8,26,4,20,39,183,222
2011,8,26,4,21,38,152,190
2011,8,26,4,22,26,126,152
2011,8,26,4,23,22,114,136
2011,8,27,5,0,33,112,145
2011,8,27,5,1,13,51,64
2011,8,27,5,2,18,59,77
2011,8,27,5,3,8,22,30
2011,8,27,5,4,1,3,4
2011,8,27,5,5,1,11,12
2011,8,27,5,6,3,15,18
2011,8,27,5,7,2,26,28
2011,8,27,5,8,14,62,76
2011,8,27,5,9,28,128,156
2011,8,27,5,10,51,154,205
2011,8,27,5,11,15,73,88
2011,8,27,5,12,11,65,76
2011,8,27,5,13,10,33,43
2011,8,27,5,14,4,19,23
2011,8,27,5,15,2,28,30
2011,8,27,5,16,10,14,24
2011,8,27,5,17,2,14,16
2011,8,28,6,7,0,1,1
2011,8,28,6,8,2,6,8
2011,8,28,6,9,7,46,53
2011,8,28,6,10,27,115,142
2011,8,28,6,11,59,177,236
2011,8,28,6,12,87,218,305
2011,8,28,6,13,129,302,431
2011,8,28,6,14,157,290,447
2011,8,28,6,15,155,314,469
2011,8,28,6,16,196,294,490
2011,8,28,6,17,145,253,398
2011,8,28,6,18,145,257,402
2011,8,28,6,19,140,247,387
2011,8,28,6,20,64,150,214
2011,8,28,6,21,60,126,186
2011,8,28,6,22,25,73,98
2011,8,28,6,23,16,48,64
2011,8,29,0,0,13,21,34
2011,8,29,0,1,5,15,20
2011,8,29,0,2,8,5,13
2011,8,29,0,3,1,5,6
2011,8,29,0,4,0,3,3
2011,8,29,0,5,0,17,17
2011,8,29,0,6,3,99,102
2011,8,29,0,7,11,272,283
2011,8,29,0,8,20,384,404
2011,8,29,0,9,22,163,185
2011,8,29,0,10,42,72,114
2011,8,29,0,11,38,100,138
2011,8,29,0,12,48,158,206
2011,8,29,0,13,48,170,218
2011,8,29,0,14,55,127,182
2011,8,29,0,15,56,163,219
2011,8,29,0,16,56,225,281
2011,8,29,0,17,67,523,590
2011,8,29,0,18,60,486,546
2011,8,29,0,19,50,316,366
2011,8,29,0,20,50,227,277
2011,8,29,0,21,34,168,202
2011,8,29,0,22,23,119,142
2011,8,29,0,23,19,56,75
2011,8,30,1,0,10,17,27
2011,8,30,1,1,6,7,13
2011,8,30,1,2,2,8,10
2011,8,30,1,3,2,2,4
2011,8,30,1,4,0,5,5
2011,8,30,1,5,1,27,28
2011,8,30,1,6,4,115,119
2011,8,30,1,7,19,337,356
2011,8,30,1,8,34,458,492
2011,8,30,1,9,38,178,216
2011,8,30,1,10,28,109,137
2011,8,30,1,11,60,115,175
2011,8,30,1,12,65,172,237
2011,8,30,1,13,59,170,229
2011,8,30,1,14,58,150,208
2011,8,30,1,15,34,162,196
2011,8,30,1,16,42,295,337
2011,8,30,1,17,61,546,607
2011,8,30,1,18,60,516,576
2011,8,30,1,19,68,397,465
2011,8,30,1,20,39,259,298
2011,8,30,1,21,43,180,223
2011,8,30,1,22,22,121,143
2011,8,30,1,23,19,74,93
2011,8,31,2,0,8,24,32
2011,8,31,2,1,2,13,15
2011,8,31,2,2,1,5,6
2011,8,31,2,3,2,4,6
2011,8,31,2,4,0,5,5
2011,8,31,2,5,2,25,27
2011,8,31,2,6,4,107,111
2011,8,31,2,7,12,313,325
2011,8,31,2,8,27,439,466
2011,8,31,2,9,27,216,243
2011,8,31,2,10,33,105,138
2011,8,31,2,11,28,142,170
2011,8,31,2,12,68,192,260
2011,8,31,2,13,39,181,220
2011,8,31,2,14,48,147,195
2011,8,31,2,15,34,138,172
2011,8,31,2,16,46,263,309
2011,8,31,2,17,83,524,607
2011,8,31,2,18,70,495,565
2011,8,31,2,19,53,391,444
2011,8,31,2,20,30,259,289
2011,8,31,2,21,27,174,201
2011,8,31,2,22,20,137,157
2011,8,31,2,23,24,60,84
2011,9,1,3,0,18,33,51
2011,9,1,3,1,7,14,21
2011,9,1,3,2,14,11,25
2011,9,1,3,3,7,7,14
2011,9,1,3,4,0,7,7
2011,9,1,3,5,1,22,23
2011,9,1,3,6,2,103,105
2011,9,1,3,7,7,334,341
2011,9,1,3,8,31,462,493
2011,9,1,3,9,29,177,206
2011,9,1,3,10,46,92,138
2011,9,1,3,11,51,141,192
2011,9,1,3,12,64,165,229
2011,9,1,3,13,50,167,217
2011,9,1,3,14,54,144,198
2011,9,1,3,15,39,135,174
2011,9,1,3,16,55,252,307
2011,9,1,3,17,61,565,626
2011,9,1,3,18,69,460,529
2011,9,1,3,19,79,363,442
2011,9,1,3,20,33,247,280
2011,9,1,3,21,17,160,177
2011,9,1,3,22,34,145,179
2011,9,1,3,23,15,111,126
2011,9,2,4,0,6,58,64
2011,9,2,4,1,4,28,32
2011,9,2,4,2,9,11,20
2011,9,2,4,3,4,4,8
2011,9,2,4,4,2,2,4
2011,9,2,4,5,0,20,20
2011,9,2,4,6,3,73,76
2011,9,2,4,7,6,253,259
2011,9,2,4,8,22,431,453
2011,9,2,4,9,29,189,218
2011,9,2,4,10,34,106,140
2011,9,2,4,11,51,141,192
2011,9,2,4,12,82,177,259
2011,9,2,4,13,72,207,279
2011,9,2,4,14,75,208,283
2011,9,2,4,15,68,277,345
2011,9,2,4,16,82,299,381
2011,9,2,4,17,78,375,453
2011,9,2,4,18,50,305,355
2011,9,2,4,19,67,220,287
2011,9,2,4,20,38,158,196
2011,9,2,4,21,28,121,149
2011,9,2,4,22,33,114,147
2011,9,2,4,23,30,68,98
2011,9,3,5,0,22,65,87
2011,9,3,5,1,17,57,74
2011,9,3,5,2,15,26,41
2011,9,3,5,3,17,18,35
2011,9,3,5,4,3,4,7
2011,9,3,5,5,3,9,12
2011,9,3,5,6,4,19,23
2011,9,3,5,7,5,33,38
2011,9,3,5,8,24,65,89
2011,9,3,5,9,83,118,201
2011,9,3,5,10,90,168,258
2011,9,3,5,11,66,128,194
2011,9,3,5,12,97,160,257
2011,9,3,5,13,153,199,352
2011,9,3,5,14,204,176,380
2011,9,3,5,15,187,201,388
2011,9,3,5,16,186,187,373
2011,9,3,5,17,170,201,371
2011,9,3,5,18,158,179,337
2011,9,3,5,19,147,148,295
2011,9,3,5,20,99,120,219
2011,9,3,5,21,71,93,164
2011,9,3,5,22,66,96,162
2011,9,3,5,23,46,77,123
2011,9,4,6,0,33,76,109
2011,9,4,6,1,37,38,75
2011,9,4,6,2,17,43,60
2011,9,4,6,3,20,23,43
2011,9,4,6,4,0,4,4
2011,9,4,6,5,1,5,6
2011,9,4,6,6,0,3,3
2011,9,4,6,7,10,20,30
2011,9,4,6,8,21,49,70
2011,9,4,6,9,87,102,189
2011,9,4,6,10,150,147,297
2011,9,4,6,11,174,163,337
2011,9,4,6,12,214,220,434
2011,9,4,6,13,245,174,419
2011,9,4,6,14,205,156,361
2011,9,4,6,15,218,192,410
2011,9,4,6,16,196,141,337
2011,9,4,6,17,204,172,376
2011,9,4,6,18,187,169,356
2011,9,4,6,19,178,150,328
2011,9,4,6,20,104,125,229
2011,9,4,6,21,104,103,207
2011,9,4,6,22,70,85,155
2011,9,4,6,23,46,58,104
2011,9,5,0,0,31,66,97
2011,9,5,0,1,19,35,54
2011,9,5,0,2,17,22,39
2011,9,5,0,3,4,12,16
2011,9,5,0,4,3,5,8
2011,9,5,0,5,2,4,6
2011,9,5,0,6,6,5,11
2011,9,5,0,7,11,30,41
2011,9,5,0,8,45,56,101
2011,9,5,0,9,63,89,152
2011,9,5,0,10,107,137,244
2011,9,5,0,11,101,207,308
2011,9,5,0,12,141,212,353
2011,9,5,0,13,154,235,389
2011,9,5,0,14,145,212,357
2011,9,5,0,15,111,142,253
2011,9,5,0,16,92,192,284
2011,9,5,0,17,37,77,114
2011,9,5,0,18,31,92,123
2011,9,5,0,19,52,123,175
2011,9,5,0,20,26,56,82
2011,9,5,0,21,20,40,60
2011,9,5,0,22,15,49,64
2011,9,5,0,23,3,17,20
2011,9,6,1,0,1,7,8
2011,9,6,1,2,0,2,2
2011,9,6,1,3,1,0,1
2011,9,6,1,4,1,3,4
2011,9,6,1,5,1,18,19
2011,9,6,1,6,0,71,71
2011,9,6,1,7,6,165,171
2011,9,6,1,8,15,347,362
2011,9,6,1,9,18,166,184
2011,9,6,1,10,16,89,105
2011,9,6,1,11,11,78,89
2011,9,6,1,12,16,51,67
2011,9,6,1,13,5,24,29
2011,9,6,1,14,3,21,24
2011,9,6,1,15,18,70,88
2011,9,6,1,16,11,95,106
2011,9,6,1,17,15,275,290
2011,9,6,1,18,22,350,372
2011,9,6,1,19,12,268,280
2011,9,6,1,20,13,150,163
2011,9,6,1,21,12,109,121
2011,9,6,1,22,5,79,84
2011,9,6,1,23,2,56,58
2011,9,7,2,0,1,12,13
2011,9,7,2,1,2,3,5
2011,9,7,2,2,2,4,6
2011,9,7,2,3,1,1,2
2011,9,7,2,4,0,4,4
2011,9,7,2,5,1,15,16
2011,9,7,2,6,1,73,74
2011,9,7,2,7,3,83,86
2011,9,7,2,8,9,316,325
2011,9,7,2,9,14,174,188
2011,9,7,2,10,3,63,66
2011,9,7,2,11,1,9,10
2011,9,7,2,12,1,21,22
2011,9,7,2,13,2,9,11
2011,9,7,2,14,1,23,24
2011,9,7,2,15,3,55,58
2011,9,7,2,16,7,137,144
2011,9,7,2,17,21,264,285
2011,9,7,2,18,18,219,237
2011,9,7,2,19,14,210,224
2011,9,7,2,20,3,93,96
2011,9,7,2,21,4,34,38
2011,9,7,2,22,3,26,29
2011,9,7,2,23,3,21,24
2011,9,8,3,0,3,11,14
2011,9,8,3,1,0,4,4
2011,9,8,3,3,0,2,2
2011,9,8,3,4,0,3,3
2011,9,8,3,5,1,13,14
2011,9,8,3,6,1,54,55
2011,9,8,3,7,7,171,178
2011,9,8,3,8,7,186,193
2011,9,8,3,9,4,63,67
2011,9,8,3,10,8,55,63
2011,9,8,3,11,16,81,97
2011,9,8,3,12,17,85,102
2011,9,8,3,13,14,112,126
2011,9,8,3,14,15,104,119
2011,9,8,3,15,24,114,138
2011,9,8,3,16,5,151,156
2011,9,8,3,17,11,102,113
2011,9,8,3,18,2,66,68
2011,9,8,3,19,1,51,52
2011,9,8,3,20,6,82,88
2011,9,8,3,21,6,76,82
2011,9,8,3,22,5,65,70
2011,9,8,3,23,0,26,26
2011,9,9,4,0,1,15,16
2011,9,9,4,1,0,8,8
2011,9,9,4,2,1,7,8
2011,9,9,4,3,1,1,2
2011,9,9,4,4,0,3,3
2011,9,9,4,5,0,14,14
2011,9,9,4,6,3,54,57
2011,9,9,4,7,4,104,108
2011,9,9,4,8,12,272,284
2011,9,9,4,9,5,130,135
2011,9,9,4,10,2,27,29
2011,9,9,4,11,6,64,70
2011,9,9,4,12,4,71,75
2011,9,9,4,13,14,108,122
2011,9,9,4,14,29,119,148
2011,9,9,4,15,27,161,188
2011,9,9,4,16,41,244,285
2011,9,9,4,17,54,451,505
2011,9,9,4,18,33,376,409
2011,9,9,4,19,33,315,348
2011,9,9,4,20,30,179,209
2011,9,9,4,21,49,154,203
2011,9,9,4,22,33,127,160
2011,9,9,4,23,35,113,148
2011,9,10,5,0,32,84,116
2011,9,10,5,1,16,67,83
2011,9,10,5,2,18,46,64
2011,9,10,5,3,8,29,37
2011,9,10,5,4,3,4,7
2011,9,10,5,5,2,5,7
2011,9,10,5,6,0,6,6
2011,9,10,5,7,9,43,52
2011,9,10,5,8,16,103,119
2011,9,10,5,9,39,168,207
2011,9,10,5,10,85,233,318
2011,9,10,5,11,108,252,360
2011,9,10,5,12,144,260,404
2011,9,10,5,13,130,239,369
2011,9,10,5,14,129,230,359
2011,9,10,5,15,217,262,479
2011,9,10,5,16,170,261,431
2011,9,10,5,17,184,275,459
2011,9,10,5,18,118,241,359
2011,9,10,5,19,101,214,315
2011,9,10,5,20,78,167,245
2011,9,10,5,21,59,171,230
2011,9,10,5,22,49,126,175
2011,9,10,5,23,32,107,139
2011,9,11,6,0,29,79,108
2011,9,11,6,1,22,66,88
2011,9,11,6,2,16,60,76
2011,9,11,6,3,15,30,45
2011,9,11,6,4,3,6,9
2011,9,11,6,5,15,24,39
2011,9,11,6,6,4,16,20
2011,9,11,6,7,9,28,37
2011,9,11,6,8,25,68,93
2011,9,11,6,9,59,168,227
2011,9,11,6,10,120,214,334
2011,9,11,6,11,144,258,402
2011,9,11,6,12,113,298,411
2011,9,11,6,13,119,230,349
2011,9,11,6,14,120,220,340
2011,9,11,6,15,134,269,403
2011,9,11,6,16,180,302,482
2011,9,11,6,17,152,228,380
2011,9,11,6,18,110,228,338
2011,9,11,6,19,101,232,333
2011,9,11,6,20,65,161,226
2011,9,11,6,21,45,114,159
2011,9,11,6,22,21,73,94
2011,9,11,6,23,12,33,45
2011,9,12,0,0,5,11,16
2011,9,12,0,1,1,11,12
2011,9,12,0,2,2,0,2
2011,9,12,0,4,0,4,4
2011,9,12,0,5,1,22,23
2011,9,12,0,6,1,107,108
2011,9,12,0,7,12,300,312
2011,9,12,0,8,25,380,405
2011,9,12,0,9,21,154,175
2011,9,12,0,10,40,89,129
2011,9,12,0,11,34,130,164
2011,9,12,0,12,37,146,183
2011,9,12,0,13,43,120,163
2011,9,12,0,14,60,129,189
2011,9,12,0,15,60,152,212
2011,9,12,0,16,60,238,298
2011,9,12,0,17,74,515,589
2011,9,12,0,18,56,513,569
2011,9,12,0,19,63,372,435
2011,9,12,0,20,41,258,299
2011,9,12,0,21,29,166,195
2011,9,12,0,22,16,134,150
2011,9,12,0,23,7,62,69
2011,9,13,1,0,7,19,26
2011,9,13,1,1,4,6,10
2011,9,13,1,2,2,0,2
2011,9,13,1,3,2,2,4
2011,9,13,1,4,2,6,8
2011,9,13,1,5,1,18,19
2011,9,13,1,6,6,114,120
2011,9,13,1,7,14,346,360
2011,9,13,1,8,26,398,424
2011,9,13,1,9,35,179,214
2011,9,13,1,10,41,93,134
2011,9,13,1,11,33,120,153
2011,9,13,1,12,43,142,185
2011,9,13,1,13,47,136,183
2011,9,13,1,14,51,139,190
2011,9,13,1,15,35,144,179
2011,9,13,1,16,41,250,291
2011,9,13,1,17,72,506,578
2011,9,13,1,18,67,471,538
2011,9,13,1,19,55,340,395
2011,9,13,1,20,31,240,271
2011,9,13,1,21,45,199,244
2011,9,13,1,22,24,120,144
2011,9,13,1,23,15,59,74
2011,9,14,2,0,5,28,33
2011,9,14,2,1,1,7,8
2011,9,14,2,2,1,4,5
2011,9,14,2,3,1,7,8
2011,9,14,2,4,1,8,9
2011,9,14,2,5,1,30,31
2011,9,14,2,6,7,137,144
2011,9,14,2,7,20,348,368
2011,9,14,2,8,33,395,428
2011,9,14,2,9,19,182,201
2011,9,14,2,10,27,115,142
2011,9,14,2,11,43,121,164
2011,9,14,2,12,56,156,212
2011,9,14,2,13,39,139,178
2011,9,14,2,14,19,105,124
2011,9,14,2,15,29,146,175
2011,9,14,2,16,36,241,277
2011,9,14,2,17,87,511,598
2011,9,14,2,18,83,502,585
2011,9,14,2,19,44,337,381
2011,9,14,2,20,40,220,260
2011,9,14,2,21,24,189,213
2011,9,14,2,22,20,140,160
2011,9,14,2,23,10,62,72
2011,9,15,3,0,3,34,37
2011,9,15,3,1,0,20,20
2011,9,15,3,2,0,5,5
2011,9,15,3,3,3,5,8
2011,9,15,3,4,2,5,7
2011,9,15,3,5,1,30,31
2011,9,15,3,6,5,118,123
2011,9,15,3,7,17,320,337
2011,9,15,3,8,27,360,387
2011,9,15,3,9,23,186,209
2011,9,15,3,10,25,95,120
2011,9,15,3,11,39,120,159
2011,9,15,3,12,31,148,179
2011,9,15,3,13,38,151,189
2011,9,15,3,14,36,133,169
2011,9,15,3,15,25,108,133
2011,9,15,3,16,29,193,222
2011,9,15,3,17,31,230,261
2011,9,15,3,18,22,221,243
2011,9,15,3,19,20,211,231
2011,9,15,3,20,25,222,247
2011,9,15,3,21,11,134,145
2011,9,15,3,22,7,108,115
2011,9,15,3,23,8,61,69
2011,9,16,4,0,5,43,48
2011,9,16,4,1,7,19,26
2011,9,16,4,2,3,7,10
2011,9,16,4,3,2,4,6
2011,9,16,4,4,1,3,4
2011,9,16,4,5,2,30,32
2011,9,16,4,6,6,85,91
2011,9,16,4,7,16,281,297
2011,9,16,4,8,23,382,405
2011,9,16,4,9,21,188,209
2011,9,16,4,10,36,102,138
2011,9,16,4,11,40,138,178
2011,9,16,4,12,39,212,251
2011,9,16,4,13,55,168,223
2011,9,16,4,14,49,176,225
2011,9,16,4,15,38,164,202
2011,9,16,4,16,67,291,358
2011,9,16,4,17,86,477,563
2011,9,16,4,18,55,426,481
2011,9,16,4,19,59,255,314
2011,9,16,4,20,41,184,225
2011,9,16,4,21,39,124,163
2011,9,16,4,22,32,135,167
2011,9,16,4,23,20,106,126
2011,9,17,5,0,28,80,108
2011,9,17,5,1,28,52,80
2011,9,17,5,2,18,61,79
2011,9,17,5,3,7,21,28
2011,9,17,5,4,1,4,5
2011,9,17,5,5,2,3,5
2011,9,17,5,6,5,17,22
2011,9,17,5,7,4,33,37
2011,9,17,5,8,27,81,108
2011,9,17,5,9,32,145,177
2011,9,17,5,10,72,177,249
2011,9,17,5,11,119,248,367
2011,9,17,5,12,115,257,372
2011,9,17,5,13,123,225,348
2011,9,17,5,14,123,174,297
2011,9,17,5,15,148,206,354
2011,9,17,5,16,116,189,305
2011,9,17,5,17,140,218,358
2011,9,17,5,18,95,234,329
2011,9,17,5,19,70,186,256
2011,9,17,5,20,43,133,176
2011,9,17,5,21,49,121,170
2011,9,17,5,22,31,112,143
2011,9,17,5,23,36,100,136
2011,9,18,6,0,24,88,112
2011,9,18,6,1,13,66,79
2011,9,18,6,2,21,68,89
2011,9,18,6,3,11,25,36
2011,9,18,6,4,1,0,1
2011,9,18,6,5,1,5,6
2011,9,18,6,6,2,10,12
2011,9,18,6,7,15,29,44
2011,9,18,6,8,16,53,69
2011,9,18,6,9,46,94,140
2011,9,18,6,10,82,178,260
2011,9,18,6,11,116,201,317
2011,9,18,6,12,135,229,364
2011,9,18,6,13,162,214,376
2011,9,18,6,14,127,184,311
2011,9,18,6,15,132,233,365
2011,9,18,6,16,134,235,369
2011,9,18,6,17,95,230,325
2011,9,18,6,18,66,223,289
2011,9,18,6,19,54,191,245
2011,9,18,6,20,44,136,180
2011,9,18,6,21,37,110,147
2011,9,18,6,22,9,75,84
2011,9,18,6,23,10,44,54
2011,9,19,0,0,14,23,37
2011,9,19,0,1,3,7,10
2011,9,19,0,2,6,7,13
2011,9,19,0,3,1,4,5
2011,9,19,0,4,2,5,7
2011,9,19,0,5,2,26,28
2011,9,19,0,6,6,107,113
2011,9,19,0,7,20,310,330
2011,9,19,0,8,28,388,416
2011,9,19,0,9,32,183,215
2011,9,19,0,10,21,84,105
2011,9,19,0,11,41,96,137
2011,9,19,0,12,51,138,189
2011,9,19,0,13,53,124,177
2011,9,19,0,14,45,143,188
2011,9,19,0,15,44,143,187
2011,9,19,0,16,55,208,263
2011,9,19,0,17,85,483,568
2011,9,19,0,18,56,483,539
2011,9,19,0,19,41,331,372
2011,9,19,0,20,27,203,230
2011,9,19,0,21,19,181,200
2011,9,19,0,22,25,104,129
2011,9,19,0,23,13,55,68
2011,9,20,1,0,4,21,25
2011,9,20,1,1,3,11,14
2011,9,20,1,2,1,4,5
2011,9,20,1,3,0,3,3
2011,9,20,1,4,2,3,5
2011,9,20,1,5,1,21,22
2011,9,20,1,6,3,111,114
2011,9,20,1,7,23,306,329
2011,9,20,1,8,13,193,206
2011,9,20,1,9,5,63,68
2011,9,20,1,10,4,26,30
2011,9,20,1,11,8,48,56
2011,9,20,1,12,13,47,60
2011,9,20,1,13,22,81,103
2011,9,20,1,14,27,85,112
2011,9,20,1,15,34,158,192
2011,9,20,1,16,23,241,264
2011,9,20,1,17,66,444,510
2011,9,20,1,18,39,453,492
2011,9,20,1,19,43,293,336
2011,9,20,1,20,41,211,252
2011,9,20,1,21,29,177,206
2011,9,20,1,22,23,125,148
2011,9,20,1,23,11,70,81
2011,9,21,2,0,7,20,27
2011,9,21,2,1,0,17,17
2011,9,21,2,2,1,5,6
2011,9,21,2,3,0,6,6
2011,9,21,2,4,2,5,7
2011,9,21,2,5,1,30,31
2011,9,21,2,6,5,111,116
2011,9,21,2,7,17,312,329
2011,9,21,2,8,18,440,458
2011,9,21,2,9,21,186,207
2011,9,21,2,10,30,103,133
2011,9,21,2,11,42,138,180
2011,9,21,2,12,42,151,193
2011,9,21,2,13,37,144,181
2011,9,21,2,14,40,139,179
2011,9,21,2,15,43,142,185
2011,9,21,2,16,51,230,281
2011,9,21,2,17,61,475,536
2011,9,21,2,18,24,384,408
2011,9,21,2,19,30,252,282
2011,9,21,2,20,11,148,159
2011,9,21,2,21,25,175,200
2011,9,21,2,22,15,112,127
2011,9,21,2,23,15,80,95
2011,9,22,3,0,11,30,41
2011,9,22,3,1,5,6,11
2011,9,22,3,2,2,8,10
2011,9,22,3,3,5,7,12
2011,9,22,3,4,0,2,2
2011,9,22,3,5,2,28,30
2011,9,22,3,6,7,94,101
2011,9,22,3,7,16,294,310
2011,9,22,3,8,26,385,411
2011,9,22,3,9,35,168,203
2011,9,22,3,10,19,101,120
2011,9,22,3,11,23,141,164
2011,9,22,3,12,25,151,176
2011,9,22,3,13,38,155,193
2011,9,22,3,14,41,142,183
2011,9,22,3,15,32,149,181
2011,9,22,3,16,39,260,299
2011,9,22,3,17,50,513,563
2011,9,22,3,18,50,500,550
2011,9,22,3,19,32,387,419
2011,9,22,3,20,35,250,285
2011,9,22,3,21,27,193,220
2011,9,22,3,22,21,166,187
2011,9,22,3,23,14,99,113
2011,9,23,4,0,11,41,52
2011,9,23,4,1,2,29,31
2011,9,23,4,2,6,14,20
2011,9,23,4,3,3,5,8
2011,9,23,4,4,6,6,12
2011,9,23,4,5,2,20,22
2011,9,23,4,6,5,98,103
2011,9,23,4,7,14,239,253
2011,9,23,4,8,20,294,314
2011,9,23,4,9,3,107,110
2011,9,23,4,10,7,28,35
2011,9,23,4,11,1,20,21
2011,9,23,4,12,1,28,29
2011,9,23,4,13,7,27,34
2011,9,23,4,14,3,21,24
2011,9,23,4,15,9,52,61
2011,9,23,4,16,5,51,56
2011,9,23,4,17,13,86,99
2011,9,23,4,18,14,220,234
2011,9,23,4,19,16,231,247
2011,9,23,4,20,21,158,179
2011,9,23,4,21,17,121,138
2011,9,23,4,22,31,125,156
2011,9,23,4,23,41,107,148
2011,9,24,5,0,7,86,93
2011,9,24,5,1,18,61,79
2011,9,24,5,2,14,54,68
2011,9,24,5,3,4,27,31
2011,9,24,5,4,1,7,8
2011,9,24,5,5,2,3,5
2011,9,24,5,6,6,12,18
2011,9,24,5,7,12,34,46
2011,9,24,5,8,19,102,121
2011,9,24,5,9,41,132,173
2011,9,24,5,10,90,203,293
2011,9,24,5,11,118,267,385
2011,9,24,5,12,141,266,407
2011,9,24,5,13,170,288,458
2011,9,24,5,14,164,225,389
2011,9,24,5,15,168,284,452
2011,9,24,5,16,167,281,448
2011,9,24,5,17,180,246,426
2011,9,24,5,18,157,243,400
2011,9,24,5,19,77,231,308
2011,9,24,5,20,77,166,243
2011,9,24,5,21,66,156,222
2011,9,24,5,22,50,143,193
2011,9,24,5,23,27,123,150
2011,9,25,6,0,37,136,173
2011,9,25,6,1,31,93,124
2011,9,25,6,2,27,79,106
2011,9,25,6,3,20,39,59
2011,9,25,6,4,3,5,8
2011,9,25,6,5,1,2,3
2011,9,25,6,6,4,13,17
2011,9,25,6,7,15,23,38
2011,9,25,6,8,27,59,86
2011,9,25,6,9,55,100,155
2011,9,25,6,10,85,189,274
2011,9,25,6,11,131,230,361
2011,9,25,6,12,143,270,413
2011,9,25,6,13,122,247,369
2011,9,25,6,14,116,231,347
2011,9,25,6,15,119,234,353
2011,9,25,6,16,144,320,464
2011,9,25,6,17,145,275,420
2011,9,25,6,18,125,278,403
2011,9,25,6,19,87,242,329
2011,9,25,6,20,51,135,186
2011,9,25,6,21,24,113,137
2011,9,25,6,22,20,84,104
2011,9,25,6,23,12,67,79
2011,9,26,0,0,6,23,29
2011,9,26,0,1,3,14,17
2011,9,26,0,2,4,4,8
2011,9,26,0,3,0,5,5
2011,9,26,0,4,2,4,6
2011,9,26,0,5,0,25,25
2011,9,26,0,6,6,107,113
2011,9,26,0,7,17,314,331
2011,9,26,0,8,29,326,355
2011,9,26,0,9,44,160,204
2011,9,26,0,10,37,116,153
2011,9,26,0,11,43,116,159
2011,9,26,0,12,48,161,209
2011,9,26,0,13,48,138,186
2011,9,26,0,14,44,109,153
2011,9,26,0,15,52,156,208
2011,9,26,0,16,74,239,313
2011,9,26,0,17,61,507,568
2011,9,26,0,18,63,490,553
2011,9,26,0,19,36,346,382
2011,9,26,0,20,24,226,250
2011,9,26,0,21,18,164,182
2011,9,26,0,22,14,122,136
2011,9,26,0,23,11,64,75
2011,9,27,1,0,9,28,37
2011,9,27,1,1,4,6,10
2011,9,27,1,2,7,4,11
2011,9,27,1,3,5,5,10
2011,9,27,1,4,5,3,8
2011,9,27,1,5,0,24,24
2011,9,27,1,6,8,115,123
2011,9,27,1,7,15,234,249
2011,9,27,1,8,27,397,424
2011,9,27,1,9,20,173,193
2011,9,27,1,10,21,100,121
2011,9,27,1,11,26,97,123
2011,9,27,1,12,33,128,161
2011,9,27,1,13,29,121,150
2011,9,27,1,14,29,123,152
2011,9,27,1,15,35,170,205
2011,9,27,1,16,33,224,257
2011,9,27,1,17,50,478,528
2011,9,27,1,18,31,324,355
2011,9,27,1,19,26,292,318
2011,9,27,1,20,17,221,238
2011,9,27,1,21,17,179,196
2011,9,27,1,22,19,102,121
2011,9,27,1,23,11,82,93
2011,9,28,2,0,7,29,36
2011,9,28,2,1,1,13,14
2011,9,28,2,2,0,9,9
2011,9,28,2,3,0,3,3
2011,9,28,2,4,1,3,4
2011,9,28,2,5,2,20,22
2011,9,28,2,6,3,110,113
2011,9,28,2,7,8,176,184
2011,9,28,2,8,17,269,286
2011,9,28,2,9,14,140,154
2011,9,28,2,10,20,109,129
2011,9,28,2,11,24,127,151
2011,9,28,2,12,25,159,184
2011,9,28,2,13,24,138,162
2011,9,28,2,14,25,145,170
2011,9,28,2,15,35,146,181
2011,9,28,2,16,39,241,280
2011,9,28,2,17,64,526,590
2011,9,28,2,18,65,459,524
2011,9,28,2,19,57,315,372
2011,9,28,2,20,11,91,102
2011,9,28,2,21,7,67,74
2011,9,28,2,22,19,68,87
2011,9,28,2,23,12,59,71
2011,9,29,3,0,7,33,40
2011,9,29,3,1,3,20,23
2011,9,29,3,2,0,2,2
2011,9,29,3,3,0,8,8
2011,9,29,3,4,2,5,7
2011,9,29,3,5,0,22,22
2011,9,29,3,6,5,106,111
2011,9,29,3,7,14,269,283
2011,9,29,3,8,29,400,429
2011,9,29,3,9,27,198,225
2011,9,29,3,10,24,103,127
2011,9,29,3,11,36,122,158
2011,9,29,3,12,38,157,195
2011,9,29,3,13,36,175,211
2011,9,29,3,14,33,134,167
2011,9,29,3,15,42,185,227
2011,9,29,3,16,64,227,291
2011,9,29,3,17,62,527,589
2011,9,29,3,18,84,500,584
2011,9,29,3,19,36,347,383
2011,9,29,3,20,39,234,273
2011,9,29,3,21,30,195,225
2011,9,29,3,22,25,150,175
2011,9,29,3,23,17,64,81
2011,9,30,4,0,7,53,60
2011,9,30,4,1,5,18,23
2011,9,30,4,2,6,9,15
2011,9,30,4,3,0,3,3
2011,9,30,4,4,2,6,8
2011,9,30,4,5,3,23,26
2011,9,30,4,6,0,98,98
2011,9,30,4,7,14,282,296
2011,9,30,4,8,31,424,455
2011,9,30,4,9,23,213,236
2011,9,30,4,10,46,122,168
2011,9,30,4,11,49,168,217
2011,9,30,4,12,59,194,253
2011,9,30,4,13,72,192,264
2011,9,30,4,14,93,173,266
2011,9,30,4,15,52,193,245
2011,9,30,4,16,62,298,360
2011,9,30,4,17,94,495,589
2011,9,30,4,18,62,448,510
2011,9,30,4,19,42,329,371
2011,9,30,4,20,28,201,229
2011,9,30,4,21,27,179,206
2011,9,30,4,22,30,129,159
2011,9,30,4,23,23,109,132
2011,10,1,5,0,24,106,130
2011,10,1,5,1,11,47,58
2011,10,1,5,2,21,46,67
2011,10,1,5,3,8,17,25
2011,10,1,5,4,2,6,8
2011,10,1,5,5,1,4,5
2011,10,1,5,6,4,15,19
2011,10,1,5,7,6,30,36
2011,10,1,5,8,9,58,67
2011,10,1,5,9,17,112,129
2011,10,1,5,10,21,100,121
2011,10,1,5,11,30,101,131
2011,10,1,5,12,28,130,158
2011,10,1,5,13,26,97,123
2011,10,1,5,14,33,147,180
2011,10,1,5,15,41,154,195
2011,10,1,5,16,57,165,222
2011,10,1,5,17,58,170,228
2011,10,1,5,18,23,117,140
2011,10,1,5,19,27,98,125
2011,10,1,5,20,8,58,66
2011,10,1,5,21,3,53,56
2011,10,1,5,22,12,58,70
2011,10,1,5,23,8,57,65
2011,10,2,6,0,4,43,47
2011,10,2,6,1,1,23,24
2011,10,2,6,2,3,27,30
2011,10,2,6,3,4,5,9
2011,10,2,6,4,4,3,7
2011,10,2,6,5,0,7,7
2011,10,2,6,6,2,13,15
2011,10,2,6,7,5,24,29
2011,10,2,6,8,14,50,64
2011,10,2,6,9,19,96,115
2011,10,2,6,10,60,188,248
2011,10,2,6,11,74,218,292
2011,10,2,6,12,78,243,321
2011,10,2,6,13,84,224,308
2011,10,2,6,14,61,195,256
2011,10,2,6,15,29,144,173
2011,10,2,6,16,44,162,206
2011,10,2,6,17,32,135,167
2011,10,2,6,18,16,158,174
2011,10,2,6,19,34,128,162
2011,10,2,6,20,16,71,87
2011,10,2,6,21,17,71,88
2011,10,2,6,22,9,55,64
2011,10,2,6,23,6,19,25
2011,10,3,0,0,3,13,16
2011,10,3,0,1,1,5,6
2011,10,3,0,2,0,4,4
2011,10,3,0,3,1,6,7
2011,10,3,0,4,2,6,8
2011,10,3,0,5,4,17,21
2011,10,3,0,6,3,91,94
2011,10,3,0,7,8,240,248
2011,10,3,0,8,13,358,371
2011,10,3,0,9,12,140,152
2011,10,3,0,10,19,82,101
2011,10,3,0,11,26,100,126
2011,10,3,0,12,29,117,146
2011,10,3,0,13,16,102,118
2011,10,3,0,14,26,93,119
2011,10,3,0,15,22,79,101
2011,10,3,0,16,16,202,218
2011,10,3,0,17,40,455,495
2011,10,3,0,18,28,384,412
2011,10,3,0,19,15,298,313
2011,10,3,0,20,13,191,204
2011,10,3,0,21,10,128,138
2011,10,3,0,22,12,79,91
2011,10,3,0,23,11,42,53
2011,10,4,1,0,5,22,27
2011,10,4,1,1,1,7,8
2011,10,4,1,2,1,2,3
2011,10,4,1,3,3,3,6
2011,10,4,1,4,3,4,7
2011,10,4,1,5,2,25,27
2011,10,4,1,6,3,108,111
2011,10,4,1,7,11,297,308
2011,10,4,1,8,28,371,399
2011,10,4,1,9,19,167,186
2011,10,4,1,10,19,107,126
2011,10,4,1,11,22,102,124
2011,10,4,1,12,39,160,199
2011,10,4,1,13,20,153,173
2011,10,4,1,14,27,155,182
2011,10,4,1,15,28,166,194
2011,10,4,1,16,36,272,308
2011,10,4,1,17,55,529,584
2011,10,4,1,18,68,454,522
2011,10,4,1,19,35,309,344
2011,10,4,1,20,25,235,260
2011,10,4,1,21,22,144,166
2011,10,4,1,22,8,106,114
2011,10,4,1,23,6,59,65
2011,10,5,2,0,7,36,43
2011,10,5,2,1,4,7,11
2011,10,5,2,2,1,2,3
2011,10,5,2,3,1,5,6
2011,10,5,2,4,1,4,5
2011,10,5,2,5,3,29,32
2011,10,5,2,6,5,111,116
2011,10,5,2,7,9,291,300
2011,10,5,2,8,26,437,463
2011,10,5,2,9,32,187,219
2011,10,5,2,10,30,103,133
2011,10,5,2,11,32,137,169
2011,10,5,2,12,34,180,214
2011,10,5,2,13,30,188,218
2011,10,5,2,14,34,156,190
2011,10,5,2,15,35,147,182
2011,10,5,2,16,37,245,282
2011,10,5,2,17,66,525,591
2011,10,5,2,18,57,535,592
2011,10,5,2,19,40,333,373
2011,10,5,2,20,18,228,246
2011,10,5,2,21,28,172,200
2011,10,5,2,22,20,134,154
2011,10,5,2,23,9,64,73
2011,10,6,3,0,6,34,40
2011,10,6,3,1,5,17,22
2011,10,6,3,2,2,8,10
2011,10,6,3,3,1,4,5
2011,10,6,3,4,0,5,5
2011,10,6,3,5,0,24,24
2011,10,6,3,6,4,107,111
2011,10,6,3,7,15,286,301
2011,10,6,3,8,20,435,455
2011,10,6,3,9,20,186,206
2011,10,6,3,10,24,105,129
2011,10,6,3,11,29,115,144
2011,10,6,3,12,46,180,226
2011,10,6,3,13,33,158,191
2011,10,6,3,14,56,138,194
2011,10,6,3,15,62,156,218
2011,10,6,3,16,51,272,323
2011,10,6,3,17,63,504,567
2011,10,6,3,18,59,479,538
2011,10,6,3,19,38,305,343
2011,10,6,3,20,29,229,258
2011,10,6,3,21,34,160,194
2011,10,6,3,22,24,124,148
2011,10,6,3,23,18,81,99
2011,10,7,4,0,19,48,67
2011,10,7,4,1,3,25,28
2011,10,7,4,2,0,5,5
2011,10,7,4,3,1,9,10
2011,10,7,4,4,0,5,5
2011,10,7,4,5,3,24,27
2011,10,7,4,6,3,84,87
2011,10,7,4,7,5,235,240
2011,10,7,4,8,31,382,413
2011,10,7,4,9,34,206,240
2011,10,7,4,10,48,126,174
2011,10,7,4,11,80,149,229
2011,10,7,4,12,61,174,235
2011,10,7,4,13,95,210,305
2011,10,7,4,14,77,179,256
2011,10,7,4,15,68,202,270
2011,10,7,4,16,73,345,418
2011,10,7,4,17,101,461,562
2011,10,7,4,18,94,370,464
2011,10,7,4,19,51,243,294
2011,10,7,4,20,30,166,196
2011,10,7,4,21,22,143,165
2011,10,7,4,22,27,119,146
2011,10,7,4,23,23,112,135
2011,10,8,5,0,17,72,89
2011,10,8,5,1,14,51,65
2011,10,8,5,2,4,41,45
2011,10,8,5,3,4,16,20
2011,10,8,5,4,3,7,10
2011,10,8,5,5,1,7,8
2011,10,8,5,6,6,16,22
2011,10,8,5,7,27,46,73
2011,10,8,5,8,14,89,103
2011,10,8,5,9,54,163,217
2011,10,8,5,10,120,217,337
2011,10,8,5,11,176,221,397
2011,10,8,5,12,191,255,446
2011,10,8,5,13,256,228,484
2011,10,8,5,14,251,214,465
2011,10,8,5,15,262,234,496
2011,10,8,5,16,221,230,451
2011,10,8,5,17,174,219,393
2011,10,8,5,18,135,224,359
2011,10,8,5,19,76,172,248
2011,10,8,5,20,78,124,202
2011,10,8,5,21,54,133,187
2011,10,8,5,22,45,104,149
2011,10,8,5,23,52,90,142
2011,10,9,6,0,46,83,129
2011,10,9,6,1,15,63,78
2011,10,9,6,2,20,35,55
2011,10,9,6,3,10,20,30
2011,10,9,6,4,7,7,14
2011,10,9,6,5,1,14,15
2011,10,9,6,6,7,14,21
2011,10,9,6,7,18,26,44
2011,10,9,6,8,25,82,107
2011,10,9,6,9,66,119,185
2011,10,9,6,10,155,210,365
2011,10,9,6,11,189,233,422
2011,10,9,6,12,212,243,455
2011,10,9,6,13,225,193,418
2011,10,9,6,14,272,227,499
2011,10,9,6,15,198,209,407
2011,10,9,6,16,223,247,470
2011,10,9,6,17,208,230,438
2011,10,9,6,18,186,228,414
2011,10,9,6,19,116,186,302
2011,10,9,6,20,59,134,193
2011,10,9,6,21,53,120,173
2011,10,9,6,22,48,104,152
2011,10,9,6,23,38,85,123
2011,10,10,0,0,11,42,53
2011,10,10,0,1,4,30,34
2011,10,10,0,2,4,15,19
2011,10,10,0,3,2,9,11
2011,10,10,0,4,2,4,6
2011,10,10,0,5,2,19,21
2011,10,10,0,6,5,38,43
2011,10,10,0,7,12,102,114
2011,10,10,0,8,27,227,254
2011,10,10,0,9,58,161,219
2011,10,10,0,10,107,157,264
2011,10,10,0,11,139,183,322
2011,10,10,0,12,164,201,365
2011,10,10,0,13,146,219,365
2011,10,10,0,14,147,223,370
2011,10,10,0,15,130,254,384
2011,10,10,0,16,154,248,402
2011,10,10,0,17,125,332,457
2011,10,10,0,18,108,363,471
2011,10,10,0,19,69,267,336
2011,10,10,0,20,37,187,224
2011,10,10,0,21,27,148,175
2011,10,10,0,22,22,104,126
2011,10,10,0,23,12,63,75
2011,10,11,1,0,14,16,30
2011,10,11,1,1,2,9,11
2011,10,11,1,2,1,4,5
2011,10,11,1,3,2,1,3
2011,10,11,1,4,0,5,5
2011,10,11,1,5,0,20,20
2011,10,11,1,6,9,114,123
2011,10,11,1,7,19,330,349
2011,10,11,1,8,31,373,404
2011,10,11,1,9,40,194,234
2011,10,11,1,10,38,111,149
2011,10,11,1,11,31,92,123
2011,10,11,1,12,51,130,181
2011,10,11,1,13,42,138,180
2011,10,11,1,14,54,117,171
2011,10,11,1,15,36,138,174
2011,10,11,1,16,63,257,320
2011,10,11,1,17,70,533,603
2011,10,11,1,18,45,492,537
2011,10,11,1,19,33,284,317
2011,10,11,1,20,31,202,233
2011,10,11,1,21,17,158,175
2011,10,11,1,22,27,119,146
2011,10,11,1,23,10,47,57
2011,10,12,2,0,2,23,25
2011,10,12,2,1,2,8,10
2011,10,12,2,2,0,2,2
2011,10,12,2,3,0,2,2
2011,10,12,2,4,1,6,7
2011,10,12,2,5,0,22,22
2011,10,12,2,6,5,106,111
2011,10,12,2,7,15,242,257
2011,10,12,2,8,27,375,402
2011,10,12,2,9,14,182,196
2011,10,12,2,10,15,98,113
2011,10,12,2,11,18,102,120
2011,10,12,2,12,9,53,62
2011,10,12,2,13,25,76,101
2011,10,12,2,14,8,70,78
2011,10,12,2,15,3,42,45
2011,10,12,2,16,5,50,55
2011,10,12,2,17,16,235,251
2011,10,12,2,18,11,161,172
2011,10,12,2,19,7,101,108
2011,10,12,2,20,9,80,89
2011,10,12,2,21,9,73,82
2011,10,12,2,22,3,40,43
2011,10,12,2,23,13,41,54
2011,10,13,3,0,1,14,15
2011,10,13,3,1,3,9,12
2011,10,13,3,2,0,4,4
2011,10,13,3,3,2,4,6
2011,10,13,3,4,2,5,7
2011,10,13,3,5,1,15,16
2011,10,13,3,6,1,51,52
2011,10,13,3,7,5,74,79
2011,10,13,3,8,10,198,208
2011,10,13,3,9,3,106,109
2011,10,13,3,10,16,53,69
2011,10,13,3,11,8,75,83
2011,10,13,3,12,10,95,105
2011,10,13,3,13,20,141,161
2011,10,13,3,14,22,111,133
2011,10,13,3,15,27,128,155
2011,10,13,3,16,36,239,275
2011,10,13,3,17,47,431,478
2011,10,13,3,18,20,246,266
2011,10,13,3,19,18,187,205
2011,10,13,3,20,15,166,181
2011,10,13,3,21,8,115,123
2011,10,13,3,22,13,101,114
2011,10,13,3,23,2,45,47
2011,10,14,4,0,10,29,39
2011,10,14,4,1,8,16,24
2011,10,14,4,2,0,6,6
2011,10,14,4,3,1,6,7
2011,10,14,4,4,0,8,8
2011,10,14,4,5,0,17,17
2011,10,14,4,6,4,90,94
2011,10,14,4,7,9,136,145
2011,10,14,4,8,23,186,209
2011,10,14,4,9,16,162,178
2011,10,14,4,10,17,107,124
2011,10,14,4,11,11,76,87
2011,10,14,4,12,13,62,75
2011,10,14,4,13,18,113,131
2011,10,14,4,14,37,119,156
2011,10,14,4,15,61,168,229
2011,10,14,4,16,80,264,344
2011,10,14,4,17,55,424,479
2011,10,14,4,18,62,361,423
2011,10,14,4,19,27,220,247
2011,10,14,4,20,19,177,196
2011,10,14,4,21,22,156,178
2011,10,14,4,22,20,123,143
2011,10,14,4,23,15,80,95
2011,10,15,5,0,18,88,106
2011,10,15,5,1,9,64,73
2011,10,15,5,2,17,39,56
2011,10,15,5,3,5,18,23
2011,10,15,5,4,0,6,6
2011,10,15,5,5,1,6,7
2011,10,15,5,6,5,15,20
2011,10,15,5,7,17,40,57
2011,10,15,5,8,24,101,125
2011,10,15,5,9,50,157,207
2011,10,15,5,10,115,207,322
2011,10,15,5,11,153,221,374
2011,10,15,5,12,195,261,456
2011,10,15,5,13,171,223,394
2011,10,15,5,14,242,230,472
2011,10,15,5,15,166,211,377
2011,10,15,5,16,179,262,441
2011,10,15,5,17,177,263,440
2011,10,15,5,18,121,251,372
2011,10,15,5,19,61,177,238
2011,10,15,5,20,42,137,179
2011,10,15,5,21,53,115,168
2011,10,15,5,22,45,121,166
2011,10,15,5,23,33,102,135
2011,10,16,6,0,22,85,107
2011,10,16,6,1,13,64,77
2011,10,16,6,2,13,52,65
2011,10,16,6,3,11,31,42
2011,10,16,6,4,5,7,12
2011,10,16,6,5,1,6,7
2011,10,16,6,6,3,7,10
2011,10,16,6,7,9,39,48
2011,10,16,6,8,28,71,99
2011,10,16,6,9,39,151,190
2011,10,16,6,10,121,225,346
2011,10,16,6,11,159,218,377
2011,10,16,6,12,167,277,444
2011,10,16,6,13,169,269,438
2011,10,16,6,14,204,258,462
2011,10,16,6,15,182,229,411
2011,10,16,6,16,177,289,466
2011,10,16,6,17,152,253,405
2011,10,16,6,18,102,226,328
2011,10,16,6,19,52,181,233
2011,10,16,6,20,49,129,178
2011,10,16,6,21,14,88,102
2011,10,16,6,22,42,88,130
2011,10,16,6,23,14,48,62
2011,10,17,0,0,12,25,37
2011,10,17,0,1,2,15,17
2011,10,17,0,2,4,3,7
2011,10,17,0,3,0,2,2
2011,10,17,0,4,2,3,5
2011,10,17,0,5,1,28,29
2011,10,17,0,6,7,107,114
2011,10,17,0,7,10,299,309
2011,10,17,0,8,33,381,414
2011,10,17,0,9,26,180,206
2011,10,17,0,10,43,91,134
2011,10,17,0,11,35,131,166
2011,10,17,0,12,39,166,205
2011,10,17,0,13,49,156,205
2011,10,17,0,14,44,122,166
2011,10,17,0,15,66,141,207
2011,10,17,0,16,64,238,302
2011,10,17,0,17,80,539,619
2011,10,17,0,18,49,468,517
2011,10,17,0,19,45,287,332
2011,10,17,0,20,40,189,229
2011,10,17,0,21,36,141,177
2011,10,17,0,22,16,88,104
2011,10,17,0,23,10,52,62
2011,10,18,1,0,8,23,31
2011,10,18,1,1,4,7,11
2011,10,18,1,2,1,4,5
2011,10,18,1,3,0,1,1
2011,10,18,1,4,0,4,4
2011,10,18,1,5,2,19,21
2011,10,18,1,6,4,104,108
2011,10,18,1,7,15,324,339
2011,10,18,1,8,25,472,497
2011,10,18,1,9,29,196,225
2011,10,18,1,10,27,75,102
2011,10,18,1,11,35,112,147
2011,10,18,1,12,42,159,201
2011,10,18,1,13,48,171,219
2011,10,18,1,14,32,136,168
2011,10,18,1,15,66,139,205
2011,10,18,1,16,58,246,304
2011,10,18,1,17,72,553,625
2011,10,18,1,18,57,511,568
2011,10,18,1,19,30,286,316
2011,10,18,1,20,23,204,227
2011,10,18,1,21,28,177,205
2011,10,18,1,22,22,115,137
2011,10,18,1,23,7,63,70
2011,10,19,2,0,11,23,34
2011,10,19,2,1,7,9,16
2011,10,19,2,2,1,6,7
2011,10,19,2,4,0,3,3
2011,10,19,2,5,0,3,3
2011,10,19,2,6,3,27,30
2011,10,19,2,7,1,66,67
2011,10,19,2,8,10,197,207
2011,10,19,2,9,17,185,202
2011,10,19,2,10,14,109,123
2011,10,19,2,11,33,116,149
2011,10,19,2,12,13,117,130
2011,10,19,2,13,20,86,106
2011,10,19,2,14,17,79,96
2011,10,19,2,15,21,99,120
2011,10,19,2,16,21,180,201
2011,10,19,2,17,11,170,181
2011,10,19,2,18,8,131,139
2011,10,19,2,19,8,189,197
2011,10,19,2,20,5,140,145
2011,10,19,2,21,6,79,85
2011,10,19,2,22,13,94,107
2011,10,19,2,23,14,55,69
2011,10,20,3,0,4,22,26
2011,10,20,3,1,4,11,15
2011,10,20,3,2,0,4,4
2011,10,20,3,3,0,1,1
2011,10,20,3,4,2,6,8
2011,10,20,3,5,2,24,26
2011,10,20,3,6,5,87,92
2011,10,20,3,7,15,299,314
2011,10,20,3,8,17,408,425
2011,10,20,3,9,26,196,222
2011,10,20,3,10,25,105,130
2011,10,20,3,11,30,98,128
2011,10,20,3,12,28,171,199
2011,10,20,3,13,28,135,163
2011,10,20,3,14,38,116,154
2011,10,20,3,15,22,138,160
2011,10,20,3,16,31,203,234
2011,10,20,3,17,56,438,494
2011,10,20,3,18,39,430,469
2011,10,20,3,19,20,278,298
2011,10,20,3,20,34,207,241
2011,10,20,3,21,16,149,165
2011,10,20,3,22,22,106,128
2011,10,20,3,23,7,83,90
2011,10,21,4,0,8,42,50
2011,10,21,4,1,7,19,26
2011,10,21,4,2,6,12,18
2011,10,21,4,3,0,7,7
2011,10,21,4,4,0,6,6
2011,10,21,4,5,0,31,31
2011,10,21,4,6,7,78,85
2011,10,21,4,7,5,224,229
2011,10,21,4,8,16,384,400
2011,10,21,4,9,33,189,222
2011,10,21,4,10,32,105,137
2011,10,21,4,11,39,135,174
2011,10,21,4,12,47,193,240
2011,10,21,4,13,43,162,205
2011,10,21,4,14,67,131,198
2011,10,21,4,15,57,178,235
2011,10,21,4,16,60,242,302
2011,10,21,4,17,79,445,524
2011,10,21,4,18,43,354,397
2011,10,21,4,19,25,228,253
2011,10,21,4,20,29,155,184
2011,10,21,4,21,31,112,143
2011,10,21,4,22,24,89,113
2011,10,21,4,23,18,99,117
2011,10,22,5,0,16,80,96
2011,10,22,5,1,20,50,70
2011,10,22,5,2,6,25,31
2011,10,22,5,3,1,19,20
2011,10,22,5,4,4,4,8
2011,10,22,5,5,1,7,8
2011,10,22,5,6,1,17,18
2011,10,22,5,7,8,49,57
2011,10,22,5,8,26,87,113
2011,10,22,5,9,47,122,169
2011,10,22,5,10,87,149,236
2011,10,22,5,11,110,172,282
2011,10,22,5,12,132,211,343
2011,10,22,5,13,136,186,322
2011,10,22,5,14,133,177,310
2011,10,22,5,15,159,223,382
2011,10,22,5,16,169,190,359
2011,10,22,5,17,143,216,359
2011,10,22,5,18,111,224,335
2011,10,22,5,19,47,173,220
2011,10,22,5,20,48,111,159
2011,10,22,5,21,37,120,157
2011,10,22,5,22,30,114,144
2011,10,22,5,23,27,81,108
2011,10,23,6,0,24,64,88
2011,10,23,6,1,11,60,71
2011,10,23,6,2,10,40,50
2011,10,23,6,3,15,31,46
2011,10,23,6,4,5,1,6
2011,10,23,6,5,1,2,3
2011,10,23,6,6,0,12,12
2011,10,23,6,7,3,18,21
2011,10,23,6,8,32,56,88
2011,10,23,6,9,48,95,143
2011,10,23,6,10,104,184,288
2011,10,23,6,11,131,202,333
2011,10,23,6,12,164,249,413
2011,10,23,6,13,160,255,415
2011,10,23,6,14,191,216,407
2011,10,23,6,15,171,216,387
2011,10,23,6,16,188,217,405
2011,10,23,6,17,120,220,340
2011,10,23,6,18,88,196,284
2011,10,23,6,19,53,140,193
2011,10,23,6,20,32,112,144
2011,10,23,6,21,24,75,99
2011,10,23,6,22,25,69,94
2011,10,23,6,23,18,31,49
2011,10,24,0,0,6,26,32
2011,10,24,0,1,7,8,15
2011,10,24,0,2,1,6,7
2011,10,24,0,3,1,3,4
2011,10,24,0,4,1,5,6
2011,10,24,0,5,2,19,21
2011,10,24,0,6,3,82,85
2011,10,24,0,7,11,272,283
2011,10,24,0,8,20,376,396
2011,10,24,0,9,29,166,195
2011,10,24,0,10,47,81,128
2011,10,24,0,11,59,109,168
2011,10,24,0,12,64,156,220
2011,10,24,0,13,60,137,197
2011,10,24,0,14,63,143,206
2011,10,24,0,15,52,123,175
2011,10,24,0,16,68,242,310
2011,10,24,0,17,87,527,614
2011,10,24,0,18,58,428,486
2011,10,24,0,19,25,212,237
2011,10,24,0,20,11,117,128
2011,10,24,0,21,12,114,126
2011,10,24,0,22,3,76,79
2011,10,24,0,23,9,50,59
2011,10,25,1,0,4,26,30
2011,10,25,1,1,5,6,11
2011,10,25,1,2,2,3,5
2011,10,25,1,3,1,3,4
2011,10,25,1,4,0,4,4
2011,10,25,1,5,0,24,24
2011,10,25,1,6,3,94,97
2011,10,25,1,7,15,299,314
2011,10,25,1,8,25,383,408
2011,10,25,1,9,28,192,220
2011,10,25,1,10,26,102,128
2011,10,25,1,11,46,120,166
2011,10,25,1,12,35,163,198
2011,10,25,1,13,37,161,198
2011,10,25,1,14,66,134,200
2011,10,25,1,15,62,171,233
2011,10,25,1,16,52,232,284
2011,10,25,1,17,68,516,584
2011,10,25,1,18,65,453,518
2011,10,25,1,19,44,293,337
2011,10,25,1,20,40,208,248
2011,10,25,1,21,32,169,201
2011,10,25,1,22,22,148,170
2011,10,25,1,23,15,79,94
2011,10,26,2,0,4,28,32
2011,10,26,2,1,3,9,12
2011,10,26,2,2,2,1,3
2011,10,26,2,3,0,3,3
2011,10,26,2,4,0,5,5
2011,10,26,2,5,0,21,21
2011,10,26,2,6,0,91,91
2011,10,26,2,7,15,283,298
2011,10,26,2,8,26,438,464
2011,10,26,2,9,14,225,239
2011,10,26,2,10,26,105,131
2011,10,26,2,11,23,132,155
2011,10,26,2,12,39,155,194
2011,10,26,2,13,20,61,81
2011,10,26,2,14,14,52,66
2011,10,26,2,15,11,59,70
2011,10,26,2,16,17,196,213
2011,10,26,2,17,40,414,454
2011,10,26,2,18,55,398,453
2011,10,26,2,19,25,305,330
2011,10,26,2,20,27,179,206
2011,10,26,2,21,17,138,155
2011,10,26,2,22,23,112,135
2011,10,26,2,23,3,72,75
2011,10,27,3,0,3,22,25
2011,10,27,3,1,2,9,11
2011,10,27,3,2,3,5,8
2011,10,27,3,3,1,3,4
2011,10,27,3,4,1,3,4
2011,10,27,3,5,1,14,15
2011,10,27,3,6,4,40,44
2011,10,27,3,7,9,128,137
2011,10,27,3,8,12,303,315
2011,10,27,3,9,16,154,170
2011,10,27,3,10,10,52,62
2011,10,27,3,11,8,44,52
2011,10,27,3,12,8,45,53
2011,10,27,3,13,10,64,74
2011,10,27,3,14,16,76,92
2011,10,27,3,15,12,95,107
2011,10,27,3,16,14,193,207
2011,10,27,3,17,31,291,322
2011,10,27,3,18,14,225,239
2011,10,27,3,19,19,200,219
2011,10,27,3,20,11,171,182
2011,10,27,3,21,13,118,131
2011,10,27,3,22,14,97,111
2011,10,27,3,23,8,60,68
2011,10,28,4,0,4,40,44
2011,10,28,4,1,7,9,16
2011,10,28,4,2,1,3,4
2011,10,28,4,3,4,4,8
2011,10,28,4,4,5,5,10
2011,10,28,4,5,0,25,25
2011,10,28,4,6,1,74,75
2011,10,28,4,7,6,199,205
2011,10,28,4,8,13,361,374
2011,10,28,4,9,19,209,228
2011,10,28,4,10,28,101,129
2011,10,28,4,11,40,128,168
2011,10,28,4,12,46,167,213
2011,10,28,4,13,43,185,228
2011,10,28,4,14,33,152,185
2011,10,28,4,15,44,171,215
2011,10,28,4,16,46,262,308
2011,10,28,4,17,35,411,446
2011,10,28,4,18,36,331,367
2011,10,28,4,19,16,188,204
2011,10,28,4,20,12,131,143
2011,10,28,4,21,5,69,74
2011,10,28,4,22,4,32,36
2011,10,28,4,23,8,31,39
2011,10,29,5,0,0,19,19
2011,10,29,5,1,0,18,18
2011,10,29,5,2,1,16,17
2011,10,29,5,3,0,8,8
2011,10,29,5,4,0,1,1
2011,10,29,5,5,0,1,1
2011,10,29,5,6,4,1,5
2011,10,29,5,7,1,6,7
2011,10,29,5,8,4,16,20
2011,10,29,5,9,1,19,20
2011,10,29,5,10,0,12,12
2011,10,29,5,11,1,26,27
2011,10,29,5,12,6,44,50
2011,10,29,5,13,0,30,30
2011,10,29,5,14,0,29,29
2011,10,29,5,15,3,38,41
2011,10,29,5,16,3,19,22
2011,10,29,5,17,3,28,31
2011,10,29,5,18,6,37,43
2011,10,29,5,19,3,36,39
2011,10,29,5,20,7,40,47
2011,10,29,5,21,1,49,50
2011,10,29,5,22,10,44,54
2011,10,29,5,23,3,33,36
2011,10,30,6,0,7,47,54
2011,10,30,6,1,9,34,43
2011,10,30,6,2,7,43,50
2011,10,30,6,3,7,26,33
2011,10,30,6,4,1,9,10
2011,10,30,6,5,0,4,4
2011,10,30,6,6,2,8,10
2011,10,30,6,7,7,15,22
2011,10,30,6,8,20,60,80
2011,10,30,6,9,55,92,147
2011,10,30,6,10,53,125,178
2011,10,30,6,11,58,182,240
2011,10,30,6,12,85,229,314
2011,10,30,6,13,113,232,345
2011,10,30,6,14,91,209,300
2011,10,30,6,15,88,201,289
2011,10,30,6,16,107,213,320
2011,10,30,6,17,54,189,243
2011,10,30,6,18,51,162,213
2011,10,30,6,19,28,125,153
2011,10,30,6,20,18,74,92
2011,10,30,6,21,4,75,79
2011,10,30,6,22,13,58,71
2011,10,30,6,23,7,30,37
2011,10,31,0,0,3,20,23
2011,10,31,0,1,5,8,13
2011,10,31,0,2,0,3,3
2011,10,31,0,3,0,3,3
2011,10,31,0,4,1,5,6
2011,10,31,0,5,0,18,18
2011,10,31,0,6,4,82,86
2011,10,31,0,7,11,215,226
2011,10,31,0,8,17,354,371
2011,10,31,0,9,14,197,211
2011,10,31,0,10,18,87,105
2011,10,31,0,11,31,96,127
2011,10,31,0,12,30,140,170
2011,10,31,0,13,24,128,152
2011,10,31,0,14,22,119,141
2011,10,31,0,15,27,141,168
2011,10,31,0,16,30,242,272
2011,10,31,0,17,44,442,486
2011,10,31,0,18,30,390,420
2011,10,31,0,19,12,224,236
2011,10,31,0,20,18,154,172
2011,10,31,0,21,7,108,115
2011,10,31,0,22,8,77,85
2011,10,31,0,23,6,46,52
2011,11,1,1,0,3,18,21
2011,11,1,1,1,3,8,11
2011,11,1,1,2,1,3,4
2011,11,1,1,3,1,5,6
2011,11,1,1,4,1,7,8
2011,11,1,1,5,0,18,18
2011,11,1,1,6,3,89,92
2011,11,1,1,7,8,245,253
2011,11,1,1,8,17,400,417
2011,11,1,1,9,16,206,222
2011,11,1,1,10,21,114,135
2011,11,1,1,11,16,101,117
2011,11,1,1,12,23,153,176
2011,11,1,1,13,20,147,167
2011,11,1,1,14,32,118,150
2011,11,1,1,15,38,148,186
2011,11,1,1,16,46,251,297
2011,11,1,1,17,36,470,506
2011,11,1,1,18,39,419,458
2011,11,1,1,19,39,274,313
2011,11,1,1,20,18,191,209
2011,11,1,1,21,13,114,127
2011,11,1,1,22,5,91,96
2011,11,1,1,23,11,61,72
2011,11,2,2,0,0,19,19
2011,11,2,2,1,2,8,10
2011,11,2,2,2,0,2,2
2011,11,2,2,3,0,2,2
2011,11,2,2,4,0,3,3
2011,11,2,2,5,0,27,27
2011,11,2,2,6,1,90,91
2011,11,2,2,7,11,239,250
2011,11,2,2,8,20,451,471
2011,11,2,2,9,14,213,227
2011,11,2,2,10,25,108,133
2011,11,2,2,11,27,117,144
2011,11,2,2,12,32,157,189
2011,11,2,2,13,22,138,160
2011,11,2,2,14,40,132,172
2011,11,2,2,15,26,161,187
2011,11,2,2,16,35,231,266
2011,11,2,2,17,29,523,552
2011,11,2,2,18,31,447,478
2011,11,2,2,19,25,257,282
2011,11,2,2,20,5,177,182
2011,11,2,2,21,13,154,167
2011,11,2,2,22,7,98,105
2011,11,2,2,23,3,54,57
2011,11,3,3,0,3,28,31
2011,11,3,3,1,3,12,15
2011,11,3,3,2,2,5,7
2011,11,3,3,3,1,4,5
2011,11,3,3,4,1,2,3
2011,11,3,3,5,1,27,28
2011,11,3,3,6,3,95,98
2011,11,3,3,7,12,279,291
2011,11,3,3,8,8,392,400
2011,11,3,3,9,9,155,164
2011,11,3,3,10,12,97,109
2011,11,3,3,11,12,108,120
2011,11,3,3,12,17,160,177
2011,11,3,3,13,19,150,169
2011,11,3,3,14,32,120,152
2011,11,3,3,15,24,136,160
2011,11,3,3,16,33,234,267
2011,11,3,3,17,33,464,497
2011,11,3,3,18,24,408,432
2011,11,3,3,19,18,234,252
2011,11,3,3,20,11,197,208
2011,11,3,3,21,4,140,144
2011,11,3,3,22,21,116,137
2011,11,3,3,23,15,80,95
2011,11,4,4,0,11,32,43
2011,11,4,4,1,1,16,17
2011,11,4,4,2,2,8,10
2011,11,4,4,3,1,7,8
2011,11,4,4,4,1,6,7
2011,11,4,4,5,0,23,23
2011,11,4,4,6,2,63,65
2011,11,4,4,7,10,235,245
2011,11,4,4,8,8,386,394
2011,11,4,4,9,15,238,253
2011,11,4,4,10,19,114,133
2011,11,4,4,11,34,128,162
2011,11,4,4,12,44,152,196
2011,11,4,4,13,33,161,194
2011,11,4,4,14,54,147,201
2011,11,4,4,15,45,192,237
2011,11,4,4,16,53,237,290
2011,11,4,4,17,42,437,479
2011,11,4,4,18,35,339,374
2011,11,4,4,19,14,181,195
2011,11,4,4,20,15,171,186
2011,11,4,4,21,8,115,123
2011,11,4,4,22,6,109,115
2011,11,4,4,23,17,72,89
2011,11,5,5,0,4,48,52
2011,11,5,5,1,5,57,62
2011,11,5,5,2,7,24,31
2011,11,5,5,3,0,8,8
2011,11,5,5,4,3,5,8
2011,11,5,5,5,0,2,2
2011,11,5,5,6,3,20,23
2011,11,5,5,7,3,31,34
2011,11,5,5,8,4,80,84
2011,11,5,5,9,30,111,141
2011,11,5,5,10,56,170,226
2011,11,5,5,11,69,169,238
2011,11,5,5,12,136,234,370
2011,11,5,5,13,148,206,354
2011,11,5,5,14,159,227,386
2011,11,5,5,15,141,202,343
2011,11,5,5,16,128,207,335
2011,11,5,5,17,100,234,334
2011,11,5,5,18,52,185,237
2011,11,5,5,19,45,159,204
2011,11,5,5,20,29,134,163
2011,11,5,5,21,19,99,118
2011,11,5,5,22,10,72,82
2011,11,5,5,23,4,81,85
2011,11,6,6,0,10,65,75
2011,11,6,6,1,11,104,115
2011,11,6,6,2,6,23,29
2011,11,6,6,3,5,4,9
2011,11,6,6,4,0,6,6
2011,11,6,6,5,0,5,5
2011,11,6,6,6,5,11,16
2011,11,6,6,7,4,24,28
2011,11,6,6,8,19,71,90
2011,11,6,6,9,36,134,170
2011,11,6,6,10,76,186,262
2011,11,6,6,11,104,216,320
2011,11,6,6,12,120,226,346
2011,11,6,6,13,105,209,314
2011,11,6,6,14,101,219,320
2011,11,6,6,15,96,210,306
2011,11,6,6,16,84,263,347
2011,11,6,6,17,71,185,256
2011,11,6,6,18,39,145,184
2011,11,6,6,19,21,130,151
2011,11,6,6,20,16,100,116
2011,11,6,6,21,11,77,88
2011,11,6,6,22,5,40,45
2011,11,6,6,23,7,43,50
2011,11,7,0,0,1,14,15
2011,11,7,0,1,2,6,8
2011,11,7,0,2,0,2,2
2011,11,7,0,3,0,3,3
2011,11,7,0,4,2,4,6
2011,11,7,0,5,1,25,26
2011,11,7,0,6,2,97,99
2011,11,7,0,7,6,304,310
2011,11,7,0,8,13,397,410
2011,11,7,0,9,18,155,173
2011,11,7,0,10,28,93,121
2011,11,7,0,11,28,100,128
2011,11,7,0,12,21,158,179
2011,11,7,0,13,32,157,189
2011,11,7,0,14,30,115,145
2011,11,7,0,15,37,132,169
2011,11,7,0,16,40,254,294
2011,11,7,0,17,39,488,527
2011,11,7,0,18,18,407,425
2011,11,7,0,19,20,277,297
2011,11,7,0,20,17,187,204
2011,11,7,0,21,10,129,139
2011,11,7,0,22,6,101,107
2011,11,7,0,23,1,47,48
2011,11,8,1,0,0,18,18
2011,11,8,1,1,3,8,11
2011,11,8,1,2,0,1,1
2011,11,8,1,3,0,3,3
2011,11,8,1,4,0,4,4
2011,11,8,1,5,1,17,18
2011,11,8,1,6,3,96,99
2011,11,8,1,7,7,316,323
2011,11,8,1,8,11,452,463
2011,11,8,1,9,14,177,191
2011,11,8,1,10,25,103,128
2011,11,8,1,11,21,125,146
2011,11,8,1,12,28,175,203
2011,11,8,1,13,31,164,195
2011,11,8,1,14,32,129,161
2011,11,8,1,15,33,155,188
2011,11,8,1,16,39,249,288
2011,11,8,1,17,40,459,499
2011,11,8,1,18,30,432,462
2011,11,8,1,19,14,264,278
2011,11,8,1,20,12,168,180
2011,11,8,1,21,16,166,182
2011,11,8,1,22,13,95,108
2011,11,8,1,23,3,45,48
2011,11,9,2,0,0,13,13
2011,11,9,2,1,0,10,10
2011,11,9,2,2,0,5,5
2011,11,9,2,3,0,4,4
2011,11,9,2,4,0,4,4
2011,11,9,2,5,0,28,28
2011,11,9,2,6,0,98,98
2011,11,9,2,7,0,300,300
2011,11,9,2,8,19,436,455
2011,11,9,2,9,22,197,219
2011,11,9,2,10,16,89,105
2011,11,9,2,11,21,131,152
2011,11,9,2,12,24,156,180
2011,11,9,2,13,31,136,167
2011,11,9,2,14,26,153,179
2011,11,9,2,15,21,130,151
2011,11,9,2,16,24,257,281
2011,11,9,2,17,27,457,484
2011,11,9,2,18,21,387,408
2011,11,9,2,19,12,292,304
2011,11,9,2,20,18,201,219
2011,11,9,2,21,9,152,161
2011,11,9,2,22,9,105,114
2011,11,9,2,23,5,61,66
2011,11,10,3,0,0,24,24
2011,11,10,3,1,1,10,11
2011,11,10,3,2,0,5,5
2011,11,10,3,3,0,11,11
2011,11,10,3,4,1,2,3
2011,11,10,3,5,1,22,23
2011,11,10,3,6,4,109,113
2011,11,10,3,7,6,265,271
2011,11,10,3,8,18,416,434
2011,11,10,3,9,23,187,210
2011,11,10,3,10,17,100,117
2011,11,10,3,11,9,99,108
2011,11,10,3,12,18,149,167
2011,11,10,3,13,9,87,96
2011,11,10,3,14,6,58,64
2011,11,10,3,15,5,57,62
2011,11,10,3,16,6,67,73
2011,11,10,3,17,9,167,176
2011,11,10,3,18,10,263,273
2011,11,10,3,19,19,192,211
2011,11,10,3,20,8,159,167
2011,11,10,3,21,6,130,136
2011,11,10,3,22,5,84,89
2011,11,10,3,23,9,73,82
2011,11,11,4,0,10,56,66
2011,11,11,4,1,3,16,19
2011,11,11,4,2,1,10,11
2011,11,11,4,3,0,6,6
2011,11,11,4,4,0,8,8
2011,11,11,4,5,0,13,13
2011,11,11,4,6,0,46,46
2011,11,11,4,7,5,115,120
2011,11,11,4,8,9,248,257
2011,11,11,4,9,15,186,201
2011,11,11,4,10,38,159,197
2011,11,11,4,11,20,150,170
2011,11,11,4,12,41,197,238
2011,11,11,4,13,57,179,236
2011,11,11,4,14,64,182,246
2011,11,11,4,15,29,186,215
2011,11,11,4,16,49,189,238
2011,11,11,4,17,24,286,310
2011,11,11,4,18,23,185,208
2011,11,11,4,19,17,182,199
2011,11,11,4,20,12,97,109
2011,11,11,4,21,4,79,83
2011,11,11,4,22,13,78,91
2011,11,11,4,23,6,67,73
2011,11,12,5,0,12,52,64
2011,11,12,5,1,9,45,54
2011,11,12,5,2,7,39,46
2011,11,12,5,3,4,13,17
2011,11,12,5,4,0,7,7
2011,11,12,5,5,1,3,4
2011,11,12,5,6,0,7,7
2011,11,12,5,7,3,24,27
2011,11,12,5,8,14,87,101
2011,11,12,5,9,18,141,159
2011,11,12,5,10,62,170,232
2011,11,12,5,11,102,213,315
2011,11,12,5,12,142,224,366
2011,11,12,5,13,128,224,352
2011,11,12,5,14,191,244,435
2011,11,12,5,15,165,221,386
2011,11,12,5,16,137,224,361
2011,11,12,5,17,92,193,285
2011,11,12,5,18,53,150,203
2011,11,12,5,19,32,139,171
2011,11,12,5,20,31,101,132
2011,11,12,5,21,19,103,122
2011,11,12,5,22,30,88,118
2011,11,12,5,23,23,78,101
2011,11,13,6,0,12,61,73
2011,11,13,6,1,13,58,71
2011,11,13,6,2,9,48,57
2011,11,13,6,3,8,20,28
2011,11,13,6,4,1,5,6
2011,11,13,6,5,2,3,5
2011,11,13,6,6,5,18,23
2011,11,13,6,7,13,30,43
2011,11,13,6,8,24,55,79
2011,11,13,6,9,38,97,135
2011,11,13,6,10,63,178,241
2011,11,13,6,11,108,187,295
2011,11,13,6,12,112,240,352
2011,11,13,6,13,105,234,339
2011,11,13,6,14,108,263,371
2011,11,13,6,15,89,220,309
2011,11,13,6,16,93,226,319
2011,11,13,6,17,44,186,230
2011,11,13,6,18,35,155,190
2011,11,13,6,19,36,121,157
2011,11,13,6,20,24,115,139
2011,11,13,6,21,19,76,95
2011,11,13,6,22,25,64,89
2011,11,13,6,23,18,49,67
2011,11,14,0,0,8,22,30
2011,11,14,0,1,5,6,11
2011,11,14,0,2,7,10,17
2011,11,14,0,3,4,3,7
2011,11,14,0,4,0,5,5
2011,11,14,0,5,0,19,19
2011,11,14,0,6,10,104,114
2011,11,14,0,7,11,309,320
2011,11,14,0,8,27,421,448
2011,11,14,0,9,29,204,233
2011,11,14,0,10,26,83,109
2011,11,14,0,11,22,106,128
2011,11,14,0,12,36,166,202
2011,11,14,0,13,50,152,202
2011,11,14,0,14,47,138,185
2011,11,14,0,15,53,142,195
2011,11,14,0,16,51,264,315
2011,11,14,0,17,55,463,518
2011,11,14,0,18,29,458,487
2011,11,14,0,19,28,271,299
2011,11,14,0,20,30,209,239
2011,11,14,0,21,37,176,213
2011,11,14,0,22,17,95,112
2011,11,14,0,23,13,48,61
2011,11,15,1,0,7,15,22
2011,11,15,1,1,5,5,10
2011,11,15,1,2,7,8,15
2011,11,15,1,3,0,4,4
2011,11,15,1,4,1,6,7
2011,11,15,1,5,2,25,27
2011,11,15,1,6,4,103,107
2011,11,15,1,7,21,296,317
2011,11,15,1,8,27,450,477
2011,11,15,1,9,26,173,199
2011,11,15,1,10,23,115,138
2011,11,15,1,11,18,116,134
2011,11,15,1,12,28,148,176
2011,11,15,1,13,21,132,153
2011,11,15,1,14,27,120,147
2011,11,15,1,15,36,155,191
2011,11,15,1,16,31,240,271
2011,11,15,1,17,29,422,451
2011,11,15,1,18,27,412,439
2011,11,15,1,19,27,259,286
2011,11,15,1,20,26,211,237
2011,11,15,1,21,23,145,168
2011,11,15,1,22,19,109,128
2011,11,15,1,23,14,66,80
2011,11,16,2,0,5,26,31
2011,11,16,2,1,0,5,5
2011,11,16,2,2,4,6,10
2011,11,16,2,3,2,3,5
2011,11,16,2,4,1,3,4
2011,11,16,2,5,0,13,13
2011,11,16,2,6,4,50,54
2011,11,16,2,7,7,129,136
2011,11,16,2,8,9,222,231
2011,11,16,2,9,5,77,82
2011,11,16,2,10,4,32,36
2011,11,16,2,11,7,53,60
2011,11,16,2,12,5,49,54
2011,11,16,2,13,6,52,58
2011,11,16,2,14,12,49,61
2011,11,16,2,15,16,50,66
2011,11,16,2,16,13,110,123
2011,11,16,2,17,17,216,233
2011,11,16,2,18,13,176,189
2011,11,16,2,19,3,108,111
2011,11,16,2,20,5,94,99
2011,11,16,2,21,3,72,75
2011,11,16,2,22,1,45,46
2011,11,16,2,23,3,28,31
2011,11,17,3,0,2,22,24
2011,11,17,3,1,0,5,5
2011,11,17,3,2,0,5,5
2011,11,17,3,3,0,3,3
2011,11,17,3,4,1,3,4
2011,11,17,3,5,1,21,22
2011,11,17,3,6,3,70,73
2011,11,17,3,7,4,164,168
2011,11,17,3,8,12,343,355
2011,11,17,3,9,14,184,198
2011,11,17,3,10,7,73,80
2011,11,17,3,11,4,93,97
2011,11,17,3,12,6,115,121
2011,11,17,3,13,15,109,124
2011,11,17,3,14,5,104,109
2011,11,17,3,15,10,106,116
2011,11,17,3,16,8,187,195
2011,11,17,3,17,20,379,399
2011,11,17,3,18,9,298,307
2011,11,17,3,19,7,209,216
2011,11,17,3,20,7,159,166
2011,11,17,3,21,3,112,115
2011,11,17,3,22,1,83,84
2011,11,17,3,23,0,58,58
2011,11,18,4,0,2,28,30
2011,11,18,4,1,0,10,10
2011,11,18,4,2,2,8,10
2011,11,18,4,3,0,2,2
2011,11,18,4,4,0,5,5
2011,11,18,4,5,0,22,22
2011,11,18,4,6,1,68,69
2011,11,18,4,7,5,211,216
2011,11,18,4,8,6,368,374
2011,11,18,4,9,6,207,213
2011,11,18,4,10,10,105,115
2011,11,18,4,11,18,122,140
2011,11,18,4,12,21,143,164
2011,11,18,4,13,31,146,177
2011,11,18,4,14,30,123,153
2011,11,18,4,15,27,151,178
2011,11,18,4,16,19,190,209
2011,11,18,4,17,17,361,378
2011,11,18,4,18,16,312,328
2011,11,18,4,19,7,182,189
2011,11,18,4,20,8,129,137
2011,11,18,4,21,3,108,111
2011,11,18,4,22,9,88,97
2011,11,18,4,23,5,54,59
2011,11,19,5,0,4,49,53
2011,11,19,5,1,1,34,35
2011,11,19,5,2,12,34,46
2011,11,19,5,3,4,11,15
2011,11,19,5,4,4,4,8
2011,11,19,5,5,0,2,2
2011,11,19,5,6,2,10,12
2011,11,19,5,7,3,38,41
2011,11,19,5,8,12,79,91
2011,11,19,5,9,12,130,142
2011,11,19,5,10,35,164,199
2011,11,19,5,11,50,183,233
2011,11,19,5,12,93,218,311
2011,11,19,5,13,118,245,363
2011,11,19,5,14,121,227,348
2011,11,19,5,15,118,262,380
2011,11,19,5,16,99,186,285
2011,11,19,5,17,61,171,232
2011,11,19,5,18,36,172,208
2011,11,19,5,19,33,149,182
2011,11,19,5,20,48,115,163
2011,11,19,5,21,29,79,108
2011,11,19,5,22,26,80,106
2011,11,19,5,23,20,73,93
2011,11,20,6,0,14,79,93
2011,11,20,6,1,11,73,84
2011,11,20,6,2,12,44,56
2011,11,20,6,3,6,31,37
2011,11,20,6,4,2,10,12
2011,11,20,6,5,0,3,3
2011,11,20,6,6,3,6,9
2011,11,20,6,7,4,18,22
2011,11,20,6,8,13,51,64
2011,11,20,6,9,29,109,138
2011,11,20,6,10,46,183,229
2011,11,20,6,11,74,211,285
2011,11,20,6,12,70,234,304
2011,11,20,6,13,84,285,369
2011,11,20,6,14,113,250,363
2011,11,20,6,15,109,240,349
2011,11,20,6,16,81,225,306
2011,11,20,6,17,35,168,203
2011,11,20,6,18,22,123,145
2011,11,20,6,19,17,140,157
2011,11,20,6,20,23,90,113
2011,11,20,6,21,11,94,105
2011,11,20,6,22,5,35,40
2011,11,20,6,23,3,25,28
2011,11,21,0,0,4,13,17
2011,11,21,0,1,4,8,12
2011,11,21,0,2,1,2,3
2011,11,21,0,3,0,4,4
2011,11,21,0,4,0,5,5
2011,11,21,0,5,0,20,20
2011,11,21,0,6,0,75,75
2011,11,21,0,7,17,229,246
2011,11,21,0,8,13,378,391
2011,11,21,0,9,15,222,237
2011,11,21,0,10,25,109,134
2011,11,21,0,11,16,111,127
2011,11,21,0,12,24,138,162
2011,11,21,0,13,13,121,134
2011,11,21,0,14,14,121,135
2011,11,21,0,15,15,93,108
2011,11,21,0,16,13,95,108
2011,11,21,0,17,10,200,210
2011,11,21,0,18,8,184,192
2011,11,21,0,19,2,135,137
2011,11,21,0,20,5,75,80
2011,11,21,0,21,11,103,114
2011,11,21,0,22,6,72,78
2011,11,21,0,23,4,29,33
2011,11,22,1,0,0,14,14
2011,11,22,1,1,1,5,6
2011,11,22,1,2,2,4,6
2011,11,22,1,3,1,2,3
2011,11,22,1,4,0,7,7
2011,11,22,1,5,1,17,18
2011,11,22,1,6,1,63,64
2011,11,22,1,7,2,119,121
2011,11,22,1,8,5,182,187
2011,11,22,1,9,2,147,149
2011,11,22,1,10,6,45,51
2011,11,22,1,11,4,28,32
2011,11,22,1,12,3,17,20
2011,11,22,1,13,4,22,26
2011,11,22,1,14,4,31,35
2011,11,22,1,15,2,32,34
2011,11,22,1,16,3,59,62
2011,11,22,1,17,4,161,165
2011,11,22,1,18,0,147,147
2011,11,22,1,19,5,106,111
2011,11,22,1,20,6,121,127
2011,11,22,1,21,4,86,90
2011,11,22,1,22,6,81,87
2011,11,22,1,23,3,36,39
2011,11,23,2,0,2,14,16
2011,11,23,2,1,0,8,8
2011,11,23,2,2,1,5,6
2011,11,23,2,3,1,2,3
2011,11,23,2,4,0,5,5
2011,11,23,2,5,1,16,17
2011,11,23,2,6,1,68,69
2011,11,23,2,7,2,154,156
2011,11,23,2,8,7,315,322
2011,11,23,2,9,3,164,167
2011,11,23,2,10,6,70,76
2011,11,23,2,11,9,106,115
2011,11,23,2,12,9,151,160
2011,11,23,2,13,12,162,174
2011,11,23,2,14,13,199,212
2011,11,23,2,15,13,194,207
2011,11,23,2,16,4,169,173
2011,11,23,2,17,7,156,163
2011,11,23,2,18,7,138,145
2011,11,23,2,19,6,116,122
2011,11,23,2,20,1,67,68
2011,11,23,2,21,0,66,66
2011,11,23,2,22,3,59,62
2011,11,23,2,23,4,47,51
2011,11,24,3,0,1,22,23
2011,11,24,3,1,1,23,24
2011,11,24,3,2,3,19,22
2011,11,24,3,3,1,4,5
2011,11,24,3,4,1,1,2
2011,11,24,3,5,1,9,10
2011,11,24,3,6,1,5,6
2011,11,24,3,7,9,31,40
2011,11,24,3,8,4,42,46
2011,11,24,3,9,13,68,81
2011,11,24,3,10,34,64,98
2011,11,24,3,11,52,90,142
2011,11,24,3,12,62,88,150
2011,11,24,3,13,84,91,175
2011,11,24,3,14,74,94,168
2011,11,24,3,15,78,71,149
2011,11,24,3,16,48,66,114
2011,11,24,3,17,34,40,74
2011,11,24,3,18,13,24,37
2011,11,24,3,19,15,13,28
2011,11,24,3,20,14,17,31
2011,11,24,3,21,7,19,26
2011,11,24,3,22,8,14,22
2011,11,24,3,23,2,19,21
2011,11,25,4,0,7,22,29
2011,11,25,4,1,2,12,14
2011,11,25,4,2,4,6,10
2011,11,25,4,3,0,2,2
2011,11,25,4,4,4,3,7
2011,11,25,4,5,2,3,5
2011,11,25,4,6,4,9,13
2011,11,25,4,7,4,31,35
2011,11,25,4,8,6,68,74
2011,11,25,4,9,25,69,94
2011,11,25,4,10,60,80,140
2011,11,25,4,11,99,127,226
2011,11,25,4,12,126,146,272
2011,11,25,4,13,143,140,283
2011,11,25,4,14,122,150,272
2011,11,25,4,15,165,145,310
2011,11,25,4,16,122,139,261
2011,11,25,4,17,57,127,184
2011,11,25,4,18,45,108,153
2011,11,25,4,19,38,95,133
2011,11,25,4,20,19,76,95
2011,11,25,4,21,24,61,85
2011,11,25,4,22,12,46,58
2011,11,25,4,23,5,28,33
2011,11,26,5,0,9,38,47
2011,11,26,5,1,5,24,29
2011,11,26,5,2,3,20,23
2011,11,26,5,3,8,9,17
2011,11,26,5,4,0,4,4
2011,11,26,5,5,0,3,3
2011,11,26,5,6,2,8,10
2011,11,26,5,7,4,13,17
2011,11,26,5,8,10,50,60
2011,11,26,5,9,16,67,83
2011,11,26,5,10,57,84,141
2011,11,26,5,11,107,123,230
2011,11,26,5,12,137,172,309
2011,11,26,5,13,177,148,325
2011,11,26,5,14,141,158,299
2011,11,26,5,15,154,160,314
2011,11,26,5,16,137,137,274
2011,11,26,5,17,62,122,184
2011,11,26,5,18,67,118,185
2011,11,26,5,19,46,100,146
2011,11,26,5,20,55,86,141
2011,11,26,5,21,20,72,92
2011,11,26,5,22,14,50,64
2011,11,26,5,23,18,51,69
2011,11,27,6,0,7,39,46
2011,11,27,6,1,9,35,44
2011,11,27,6,2,9,22,31
2011,11,27,6,3,9,8,17
2011,11,27,6,4,0,4,4
2011,11,27,6,5,0,5,5
2011,11,27,6,6,0,9,9
2011,11,27,6,7,12,11,23
2011,11,27,6,8,6,36,42
2011,11,27,6,9,21,90,111
2011,11,27,6,10,58,131,189
2011,11,27,6,11,83,157,240
2011,11,27,6,12,63,193,256
2011,11,27,6,13,97,216,313
2011,11,27,6,14,113,199,312
2011,11,27,6,15,96,221,317
2011,11,27,6,16,94,229,323
2011,11,27,6,17,37,166,203
2011,11,27,6,18,25,130,155
2011,11,27,6,19,28,108,136
2011,11,27,6,20,10,94,104
2011,11,27,6,21,13,75,88
2011,11,27,6,22,13,53,66
2011,11,27,6,23,5,26,31
2011,11,28,0,0,6,10,16
2011,11,28,0,1,1,12,13
2011,11,28,0,3,1,4,5
2011,11,28,0,4,0,3,3
2011,11,28,0,5,0,34,34
2011,11,28,0,6,6,97,103
2011,11,28,0,7,7,268,275
2011,11,28,0,8,13,393,406
2011,11,28,0,9,17,191,208
2011,11,28,0,10,21,86,107
2011,11,28,0,11,11,107,118
2011,11,28,0,12,13,165,178
2011,11,28,0,13,25,135,160
2011,11,28,0,14,14,129,143
2011,11,28,0,15,18,132,150
2011,11,28,0,16,24,239,263
2011,11,28,0,17,24,444,468
2011,11,28,0,18,20,393,413
2011,11,28,0,19,4,260,264
2011,11,28,0,20,12,205,217
2011,11,28,0,21,4,152,156
2011,11,28,0,22,7,102,109
2011,11,28,0,23,5,40,45
2011,11,29,1,0,4,18,22
2011,11,29,1,1,1,16,17
2011,11,29,1,2,0,5,5
2011,11,29,1,3,0,2,2
2011,11,29,1,4,1,4,5
2011,11,29,1,5,1,21,22
2011,11,29,1,6,1,87,88
2011,11,29,1,7,12,330,342
2011,11,29,1,8,9,438,447
2011,11,29,1,9,5,196,201
2011,11,29,1,10,2,34,36
2011,11,29,1,11,1,10,11
2011,11,29,1,12,1,17,18
2011,11,29,1,13,0,22,22
2011,11,29,1,14,1,35,36
2011,11,29,1,15,5,60,65
2011,11,29,1,16,5,146,151
2011,11,29,1,17,8,346,354
2011,11,29,1,18,11,345,356
2011,11,29,1,19,6,243,249
2011,11,29,1,20,8,176,184
2011,11,29,1,21,9,116,125
2011,11,29,1,22,5,90,95
2011,11,29,1,23,0,52,52
2011,11,30,2,0,1,23,24
2011,11,30,2,1,0,8,8
2011,11,30,2,2,0,5,5
2011,11,30,2,3,0,1,1
2011,11,30,2,4,0,5,5
2011,11,30,2,5,1,21,22
2011,11,30,2,6,3,98,101
2011,11,30,2,7,9,276,285
2011,11,30,2,8,13,464,477
2011,11,30,2,9,7,186,193
2011,11,30,2,10,15,95,110
2011,11,30,2,11,10,111,121
2011,11,30,2,12,12,148,160
2011,11,30,2,13,16,131,147
2011,11,30,2,14,13,99,112
2011,11,30,2,15,11,104,115
2011,11,30,2,16,27,197,224
2011,11,30,2,17,15,364,379
2011,11,30,2,18,7,368,375
2011,11,30,2,19,6,273,279
2011,11,30,2,20,6,184,190
2011,11,30,2,21,7,128,135
2011,11,30,2,22,5,82,87
2011,11,30,2,23,4,46,50
2011,12,1,3,0,1,19,20
2011,12,1,3,1,1,8,9
2011,12,1,3,2,1,7,8
2011,12,1,3,3,1,6,7
2011,12,1,3,4,0,1,1
2011,12,1,3,5,1,21,22
2011,12,1,3,6,5,91,96
2011,12,1,3,7,11,262,273
2011,12,1,3,8,15,461,476
2011,12,1,3,9,9,214,223
2011,12,1,3,10,7,86,93
2011,12,1,3,11,7,95,102
2011,12,1,3,12,9,139,148
2011,12,1,3,13,17,137,154
2011,12,1,3,14,20,130,150
2011,12,1,3,15,10,142,152
2011,12,1,3,16,9,192,201
2011,12,1,3,17,9,409,418
2011,12,1,3,18,12,391,403
2011,12,1,3,19,9,219,228
2011,12,1,3,20,12,178,190
2011,12,1,3,21,8,153,161
2011,12,1,3,22,5,99,104
2011,12,1,3,23,3,70,73
2011,12,2,4,0,6,31,37
2011,12,2,4,1,1,14,15
2011,12,2,4,2,0,10,10
2011,12,2,4,3,0,1,1
2011,12,2,4,4,0,2,2
2011,12,2,4,5,0,22,22
2011,12,2,4,6,3,83,86
2011,12,2,4,7,6,198,204
2011,12,2,4,8,13,430,443
2011,12,2,4,9,12,234,246
2011,12,2,4,10,16,89,105
2011,12,2,4,11,18,141,159
2011,12,2,4,12,18,185,203
2011,12,2,4,13,19,188,207
2011,12,2,4,14,25,145,170
2011,12,2,4,15,24,175,199
2011,12,2,4,16,22,254,276
2011,12,2,4,17,20,390,410
2011,12,2,4,18,10,362,372
2011,12,2,4,19,13,251,264
2011,12,2,4,20,12,178,190
2011,12,2,4,21,9,102,111
2011,12,2,4,22,7,95,102
2011,12,2,4,23,14,81,95
2011,12,3,5,0,10,65,75
2011,12,3,5,1,9,62,71
2011,12,3,5,2,9,41,50
2011,12,3,5,3,4,5,9
2011,12,3,5,4,1,6,7
2011,12,3,5,5,0,6,6
2011,12,3,5,6,1,10,11
2011,12,3,5,7,2,24,26
2011,12,3,5,8,1,62,63
2011,12,3,5,9,25,99,124
2011,12,3,5,10,22,173,195
2011,12,3,5,11,48,227,275
2011,12,3,5,12,78,280,358
2011,12,3,5,13,70,222,292
2011,12,3,5,14,92,251,343
2011,12,3,5,15,100,236,336
2011,12,3,5,16,75,230,305
2011,12,3,5,17,46,186,232
2011,12,3,5,18,31,192,223
2011,12,3,5,19,31,144,175
2011,12,3,5,20,17,110,127
2011,12,3,5,21,5,104,109
2011,12,3,5,22,17,97,114
2011,12,3,5,23,12,73,85
2011,12,4,6,0,19,64,83
2011,12,4,6,1,20,54,74
2011,12,4,6,2,11,51,62
2011,12,4,6,3,7,34,41
2011,12,4,6,4,2,9,11
2011,12,4,6,5,2,2,4
2011,12,4,6,6,1,3,4
2011,12,4,6,7,3,23,26
2011,12,4,6,8,7,48,55
2011,12,4,6,9,12,114,126
2011,12,4,6,10,36,180,216
2011,12,4,6,11,48,206,254
2011,12,4,6,12,82,245,327
2011,12,4,6,13,88,269,357
2011,12,4,6,14,77,246,323
2011,12,4,6,15,69,227,296
2011,12,4,6,16,64,266,330
2011,12,4,6,17,38,207,245
2011,12,4,6,18,10,161,171
2011,12,4,6,19,15,158,173
2011,12,4,6,20,8,116,124
2011,12,4,6,21,7,65,72
2011,12,4,6,22,5,59,64
2011,12,4,6,23,3,42,45
2011,12,5,0,0,3,21,24
2011,12,5,0,1,2,10,12
2011,12,5,0,2,0,8,8
2011,12,5,0,3,0,2,2
2011,12,5,0,4,0,7,7
2011,12,5,0,5,1,24,25
2011,12,5,0,6,1,88,89
2011,12,5,0,7,9,274,283
2011,12,5,0,8,12,390,402
2011,12,5,0,9,12,178,190
2011,12,5,0,10,9,78,87
2011,12,5,0,11,17,105,122
2011,12,5,0,12,29,125,154
2011,12,5,0,13,18,153,171
2011,12,5,0,14,7,126,133
2011,12,5,0,15,16,131,147
2011,12,5,0,16,10,237,247
2011,12,5,0,17,16,430,446
2011,12,5,0,18,13,385,398
2011,12,5,0,19,13,291,304
2011,12,5,0,20,15,190,205
2011,12,5,0,21,10,166,176
2011,12,5,0,22,12,94,106
2011,12,5,0,23,8,54,62
2011,12,6,1,0,3,25,28
2011,12,6,1,1,2,14,16
2011,12,6,1,2,0,3,3
2011,12,6,1,3,0,3,3
2011,12,6,1,4,0,7,7
2011,12,6,1,5,0,20,20
2011,12,6,1,6,5,80,85
2011,12,6,1,7,7,227,234
2011,12,6,1,8,13,399,412
2011,12,6,1,9,4,200,204
2011,12,6,1,10,6,43,49
2011,12,6,1,11,4,28,32
2011,12,6,1,12,5,50,55
2011,12,6,1,13,6,65,71
2011,12,6,1,14,6,69,75
2011,12,6,1,15,2,43,45
2011,12,6,1,16,4,84,88
2011,12,6,1,17,13,248,261
2011,12,6,1,18,17,286,303
2011,12,6,1,19,10,221,231
2011,12,6,1,20,3,107,110
2011,12,6,1,21,6,108,114
2011,12,6,1,22,5,82,87
2011,12,6,1,23,5,48,53
2011,12,7,2,0,3,29,32
2011,12,7,2,1,4,9,13
2011,12,7,2,2,2,4,6
2011,12,7,2,3,0,3,3
2011,12,7,2,4,0,1,1
2011,12,7,2,5,0,3,3
2011,12,7,2,6,0,18,18
2011,12,7,2,7,3,43,46
2011,12,7,2,8,6,79,85
2011,12,7,2,9,0,64,64
2011,12,7,2,10,1,32,33
2011,12,7,2,11,3,47,50
2011,12,7,2,12,4,29,33
2011,12,7,2,13,5,28,33
2011,12,7,2,14,1,24,25
2011,12,7,2,15,5,24,29
2011,12,7,2,16,3,28,31
2011,12,7,2,17,4,48,52
2011,12,7,2,18,3,48,51
2011,12,7,2,19,2,31,33
2011,12,7,2,20,1,25,26
2011,12,7,2,21,0,6,6
2011,12,7,2,22,0,13,13
2011,12,7,2,23,0,16,16
2011,12,8,3,0,0,21,21
2011,12,8,3,1,1,6,7
2011,12,8,3,2,0,4,4
2011,12,8,3,3,0,1,1
2011,12,8,3,4,0,1,1
2011,12,8,3,5,0,12,12
2011,12,8,3,6,0,71,71
2011,12,8,3,7,11,233,244
2011,12,8,3,8,11,415,426
2011,12,8,3,9,7,217,224
2011,12,8,3,10,1,109,110
2011,12,8,3,11,6,100,106
2011,12,8,3,12,8,148,156
2011,12,8,3,13,9,115,124
2011,12,8,3,14,16,121,137
2011,12,8,3,15,19,98,117
2011,12,8,3,16,7,199,206
2011,12,8,3,17,10,321,331
2011,12,8,3,18,12,306,318
2011,12,8,3,19,12,220,232
2011,12,8,3,20,5,169,174
2011,12,8,3,21,4,135,139
2011,12,8,3,22,8,83,91
2011,12,8,3,23,3,58,61
2011,12,9,4,0,8,26,34
2011,12,9,4,1,2,12,14
2011,12,9,4,2,2,10,12
2011,12,9,4,3,1,5,6
2011,12,9,4,4,1,1,2
2011,12,9,4,5,0,20,20
2011,12,9,4,6,1,62,63
2011,12,9,4,7,4,195,199
2011,12,9,4,8,7,375,382
2011,12,9,4,9,8,256,264
2011,12,9,4,10,11,113,124
2011,12,9,4,11,15,121,136
2011,12,9,4,12,27,146,173
2011,12,9,4,13,27,140,167
2011,12,9,4,14,24,162,186
2011,12,9,4,15,29,160,189
2011,12,9,4,16,24,224,248
2011,12,9,4,17,10,352,362
2011,12,9,4,18,10,308,318
2011,12,9,4,19,10,189,199
2011,12,9,4,20,10,140,150
2011,12,9,4,21,9,131,140
2011,12,9,4,22,15,113,128
2011,12,9,4,23,6,88,94
2011,12,10,5,0,11,66,77
2011,12,10,5,1,11,55,66
2011,12,10,5,2,12,48,60
2011,12,10,5,3,5,20,25
2011,12,10,5,4,0,3,3
2011,12,10,5,5,0,6,6
2011,12,10,5,6,1,10,11
2011,12,10,5,7,0,11,11
2011,12,10,5,8,5,67,72
2011,12,10,5,9,15,133,148
2011,12,10,5,10,31,160,191
2011,12,10,5,11,44,192,236
2011,12,10,5,12,48,235,283
2011,12,10,5,13,47,238,285
2011,12,10,5,14,51,242,293
2011,12,10,5,15,60,238,298
2011,12,10,5,16,58,183,241
2011,12,10,5,17,34,150,184
2011,12,10,5,18,28,144,172
2011,12,10,5,19,15,139,154
2011,12,10,5,20,10,114,124
2011,12,10,5,21,4,79,83
2011,12,10,5,22,7,88,95
2011,12,10,5,23,5,61,66
2011,12,11,6,0,5,69,74
2011,12,11,6,1,8,54,62
2011,12,11,6,2,5,47,52
2011,12,11,6,3,2,17,19
2011,12,11,6,4,0,5,5
2011,12,11,6,5,0,6,6
2011,12,11,6,6,0,10,10
2011,12,11,6,7,1,30,31
2011,12,11,6,8,4,68,72
2011,12,11,6,9,19,88,107
2011,12,11,6,10,30,164,194
2011,12,11,6,11,31,165,196
2011,12,11,6,12,42,246,288
2011,12,11,6,13,44,224,268
2011,12,11,6,14,44,198,242
2011,12,11,6,15,47,219,266
2011,12,11,6,16,31,173,204
2011,12,11,6,17,13,150,163
2011,12,11,6,18,12,151,163
2011,12,11,6,19,7,98,105
2011,12,11,6,20,10,62,72
2011,12,11,6,21,10,53,63
2011,12,11,6,22,7,36,43
2011,12,11,6,23,4,31,35
2011,12,12,0,0,4,16,20
2011,12,12,0,1,0,9,9
2011,12,12,0,2,0,4,4
2011,12,12,0,3,0,2,2
2011,12,12,0,4,0,3,3
2011,12,12,0,5,0,20,20
2011,12,12,0,6,1,62,63
2011,12,12,0,7,4,230,234
2011,12,12,0,8,7,375,382
2011,12,12,0,9,12,206,218
2011,12,12,0,10,14,89,103
2011,12,12,0,11,15,99,114
2011,12,12,0,12,7,138,145
2011,12,12,0,13,13,153,166
2011,12,12,0,14,16,94,110
2011,12,12,0,15,8,123,131
2011,12,12,0,16,5,209,214
2011,12,12,0,17,7,351,358
2011,12,12,0,18,8,349,357
2011,12,12,0,19,9,229,238
2011,12,12,0,20,8,156,164
2011,12,12,0,21,2,119,121
2011,12,12,0,22,0,71,71
2011,12,12,0,23,3,42,45
2011,12,13,1,0,1,16,17
2011,12,13,1,1,0,4,4
2011,12,13,1,2,1,1,2
2011,12,13,1,3,0,3,3
2011,12,13,1,4,0,4,4
2011,12,13,1,5,0,20,20
2011,12,13,1,6,0,91,91
2011,12,13,1,7,2,221,223
2011,12,13,1,8,9,388,397
2011,12,13,1,9,10,223,233
2011,12,13,1,10,3,98,101
2011,12,13,1,11,9,115,124
2011,12,13,1,12,20,147,167
2011,12,13,1,13,7,120,127
2011,12,13,1,14,18,115,133
2011,12,13,1,15,7,143,150
2011,12,13,1,16,12,194,206
2011,12,13,1,17,17,379,396
2011,12,13,1,18,12,368,380
2011,12,13,1,19,5,262,267
2011,12,13,1,20,7,154,161
2011,12,13,1,21,5,134,139
2011,12,13,1,22,5,102,107
2011,12,13,1,23,4,54,58
2011,12,14,2,0,0,22,22
2011,12,14,2,1,0,8,8
2011,12,14,2,2,0,2,2
2011,12,14,2,3,0,3,3
2011,12,14,2,4,0,4,4
2011,12,14,2,5,0,26,26
2011,12,14,2,6,0,87,87
2011,12,14,2,7,4,243,247
2011,12,14,2,8,9,454,463
2011,12,14,2,9,9,230,239
2011,12,14,2,10,9,130,139
2011,12,14,2,11,12,102,114
2011,12,14,2,12,6,138,144
2011,12,14,2,13,14,117,131
2011,12,14,2,14,17,134,151
2011,12,14,2,15,24,142,166
2011,12,14,2,16,12,232,244
2011,12,14,2,17,19,377,396
2011,12,14,2,18,11,379,390
2011,12,14,2,19,9,258,267
2011,12,14,2,20,6,167,173
2011,12,14,2,21,9,145,154
2011,12,14,2,22,5,99,104
2011,12,14,2,23,3,48,51
2011,12,15,3,0,5,45,50
2011,12,15,3,1,5,15,20
2011,12,15,3,2,2,5,7
2011,12,15,3,3,1,2,3
2011,12,15,3,4,0,6,6
2011,12,15,3,5,0,24,24
2011,12,15,3,6,2,89,91
2011,12,15,3,7,6,251,257
2011,12,15,3,8,8,447,455
2011,12,15,3,9,6,274,280
2011,12,15,3,10,4,105,109
2011,12,15,3,11,9,125,134
2011,12,15,3,12,17,139,156
2011,12,15,3,13,14,150,164
2011,12,15,3,14,8,123,131
2011,12,15,3,15,6,76,82
2011,12,15,3,16,7,124,131
2011,12,15,3,17,14,309,323
2011,12,15,3,18,14,362,376
2011,12,15,3,19,13,273,286
2011,12,15,3,20,12,208,220
2011,12,15,3,21,10,145,155
2011,12,15,3,22,8,116,124
2011,12,15,3,23,10,104,114
2011,12,16,4,0,12,60,72
2011,12,16,4,1,3,28,31
2011,12,16,4,2,0,23,23
2011,12,16,4,3,2,3,5
2011,12,16,4,4,1,4,5
2011,12,16,4,5,0,25,25
2011,12,16,4,6,2,79,81
2011,12,16,4,7,5,225,230
2011,12,16,4,8,10,442,452
2011,12,16,4,9,8,235,243
2011,12,16,4,10,10,122,132
2011,12,16,4,11,9,134,143
2011,12,16,4,12,10,162,172
2011,12,16,4,13,12,125,137
2011,12,16,4,14,13,114,127
2011,12,16,4,15,12,139,151
2011,12,16,4,16,12,211,223
2011,12,16,4,17,13,350,363
2011,12,16,4,18,10,284,294
2011,12,16,4,19,11,202,213
2011,12,16,4,20,6,145,151
2011,12,16,4,21,7,95,102
2011,12,16,4,22,6,100,106
2011,12,16,4,23,4,71,75
2011,12,17,5,0,3,59,62
2011,12,17,5,1,4,39,43
2011,12,17,5,2,11,47,58
2011,12,17,5,3,4,22,26
2011,12,17,5,4,0,9,9
2011,12,17,5,5,2,7,9
2011,12,17,5,6,0,17,17
2011,12,17,5,7,0,20,20
2011,12,17,5,8,4,54,58
2011,12,17,5,9,5,94,99
2011,12,17,5,10,10,171,181
2011,12,17,5,11,21,188,209
2011,12,17,5,12,28,216,244
2011,12,17,5,13,32,204,236
2011,12,17,5,14,30,207,237
2011,12,17,5,15,33,193,226
2011,12,17,5,16,30,191,221
2011,12,17,5,17,12,153,165
2011,12,17,5,18,7,150,157
2011,12,17,5,19,11,95,106
2011,12,17,5,20,7,99,106
2011,12,17,5,21,8,88,96
2011,12,17,5,22,7,73,80
2011,12,17,5,23,6,63,69
2011,12,18,6,0,7,63,70
2011,12,18,6,1,3,43,46
2011,12,18,6,2,2,39,41
2011,12,18,6,3,2,16,18
2011,12,18,6,4,0,1,1
2011,12,18,6,5,1,4,5
2011,12,18,6,6,0,3,3
2011,12,18,6,7,1,11,12
2011,12,18,6,8,1,31,32
2011,12,18,6,9,6,75,81
2011,12,18,6,10,7,121,128
2011,12,18,6,11,20,168,188
2011,12,18,6,12,26,202,228
2011,12,18,6,13,18,208,226
2011,12,18,6,14,19,200,219
2011,12,18,6,15,23,184,207
2011,12,18,6,16,27,205,232
2011,12,18,6,17,10,126,136
2011,12,18,6,18,15,123,138
2011,12,18,6,19,5,130,135
2011,12,18,6,20,10,94,104
2011,12,18,6,21,9,80,89
2011,12,18,6,22,2,47,49
2011,12,18,6,23,6,31,37
2011,12,19,0,0,3,14,17
2011,12,19,0,1,3,8,11
2011,12,19,0,2,0,3,3
2011,12,19,0,3,0,3,3
2011,12,19,0,4,0,4,4
2011,12,19,0,5,0,21,21
2011,12,19,0,6,0,66,66
2011,12,19,0,7,4,186,190
2011,12,19,0,8,8,387,395
2011,12,19,0,9,17,166,183
2011,12,19,0,10,12,96,108
2011,12,19,0,11,22,105,127
2011,12,19,0,12,13,128,141
2011,12,19,0,13,15,127,142
2011,12,19,0,14,30,107,137
2011,12,19,0,15,24,134,158
2011,12,19,0,16,19,189,208
2011,12,19,0,17,16,362,378
2011,12,19,0,18,11,343,354
2011,12,19,0,19,17,233,250
2011,12,19,0,20,9,196,205
2011,12,19,0,21,15,112,127
2011,12,19,0,22,12,95,107
2011,12,19,0,23,10,50,60
2011,12,20,1,0,0,21,21
2011,12,20,1,1,0,6,6
2011,12,20,1,2,1,10,11
2011,12,20,1,3,1,1,2
2011,12,20,1,4,0,4,4
2011,12,20,1,5,0,15,15
2011,12,20,1,6,1,70,71
2011,12,20,1,7,7,259,266
2011,12,20,1,8,10,421,431
2011,12,20,1,9,14,244,258
2011,12,20,1,10,20,109,129
2011,12,20,1,11,13,116,129
2011,12,20,1,12,16,159,175
2011,12,20,1,13,18,163,181
2011,12,20,1,14,11,126,137
2011,12,20,1,15,15,139,154
2011,12,20,1,16,20,218,238
2011,12,20,1,17,14,416,430
2011,12,20,1,18,26,385,411
2011,12,20,1,19,6,217,223
2011,12,20,1,20,3,144,147
2011,12,20,1,21,4,139,143
2011,12,20,1,22,3,104,107
2011,12,20,1,23,13,39,52
2011,12,21,2,0,7,18,25
2011,12,21,2,1,1,10,11
2011,12,21,2,2,0,4,4
2011,12,21,2,3,0,2,2
2011,12,21,2,4,0,2,2
2011,12,21,2,5,0,28,28
2011,12,21,2,6,1,74,75
2011,12,21,2,7,5,224,229
2011,12,21,2,8,12,391,403
2011,12,21,2,9,14,219,233
2011,12,21,2,10,6,83,89
2011,12,21,2,11,3,53,56
2011,12,21,2,12,3,58,61
2011,12,21,2,13,3,55,58
2011,12,21,2,14,11,40,51
2011,12,21,2,15,4,57,61
2011,12,21,2,16,6,94,100
2011,12,21,2,17,3,226,229
2011,12,21,2,18,2,278,280
2011,12,21,2,19,9,200,209
2011,12,21,2,20,5,161,166
2011,12,21,2,21,9,114,123
2011,12,21,2,22,3,102,105
2011,12,21,2,23,0,54,54
2011,12,22,3,0,3,24,27
2011,12,22,3,1,0,15,15
2011,12,22,3,2,1,10,11
2011,12,22,3,3,0,6,6
2011,12,22,3,4,0,3,3
2011,12,22,3,5,1,15,16
2011,12,22,3,6,1,61,62
2011,12,22,3,7,4,182,186
2011,12,22,3,8,10,331,341
2011,12,22,3,9,10,218,228
2011,12,22,3,10,13,127,140
2011,12,22,3,11,10,135,145
2011,12,22,3,12,22,180,202
2011,12,22,3,13,21,166,187
2011,12,22,3,14,23,135,158
2011,12,22,3,15,28,186,214
2011,12,22,3,16,30,226,256
2011,12,22,3,17,24,332,356
2011,12,22,3,18,11,276,287
2011,12,22,3,19,12,130,142
2011,12,22,3,20,0,33,33
2011,12,22,3,21,2,15,17
2011,12,22,3,22,0,17,17
2011,12,22,3,23,1,10,11
2011,12,23,4,0,2,7,9
2011,12,23,4,1,1,11,12
2011,12,23,4,2,1,12,13
2011,12,23,4,3,0,4,4
2011,12,23,4,4,0,2,2
2011,12,23,4,5,0,8,8
2011,12,23,4,6,0,40,40
2011,12,23,4,7,4,86,90
2011,12,23,4,8,9,173,182
2011,12,23,4,9,4,151,155
2011,12,23,4,10,8,95,103
2011,12,23,4,11,26,148,174
2011,12,23,4,12,14,155,169
2011,12,23,4,13,17,177,194
2011,12,23,4,14,23,177,200
2011,12,23,4,15,12,190,202
2011,12,23,4,16,15,166,181
2011,12,23,4,17,11,129,140
2011,12,23,4,18,4,91,95
2011,12,23,4,19,1,74,75
2011,12,23,4,20,3,47,50
2011,12,23,4,21,0,32,32
2011,12,23,4,22,4,43,47
2011,12,23,4,23,4,21,25
2011,12,24,5,0,3,20,23
2011,12,24,5,1,1,15,16
2011,12,24,5,2,4,22,26
2011,12,24,5,3,0,5,5
2011,12,24,5,4,0,3,3
2011,12,24,5,5,1,3,4
2011,12,24,5,6,0,10,10
2011,12,24,5,7,0,10,10
2011,12,24,5,8,0,27,27
2011,12,24,5,9,3,53,56
2011,12,24,5,10,4,52,56
2011,12,24,5,11,9,62,71
2011,12,24,5,12,15,79,94
2011,12,24,5,13,24,97,121
2011,12,24,5,14,15,70,85
2011,12,24,5,15,15,82,97
2011,12,24,5,16,25,73,98
2011,12,24,5,17,15,53,68
2011,12,24,5,18,2,33,35
2011,12,24,5,19,1,24,25
2011,12,24,5,20,5,19,24
2011,12,24,5,21,4,15,19
2011,12,24,5,22,8,12,20
2011,12,24,5,23,1,16,17
2011,12,25,6,0,2,4,6
2011,12,25,6,1,2,2,4
2011,12,25,6,2,0,2,2
2011,12,25,6,3,1,3,4
2011,12,25,6,5,0,1,1
2011,12,25,6,6,0,1,1
2011,12,25,6,7,0,4,4
2011,12,25,6,8,1,4,5
2011,12,25,6,9,3,20,23
2011,12,25,6,10,31,12,43
2011,12,25,6,11,43,42,85
2011,12,25,6,12,25,41,66
2011,12,25,6,13,40,39,79
2011,12,25,6,14,41,45,86
2011,12,25,6,15,43,48,91
2011,12,25,6,16,35,51,86
2011,12,25,6,17,11,33,44
2011,12,25,6,18,7,23,30
2011,12,25,6,19,2,14,16
2011,12,25,6,20,8,18,26
2011,12,25,6,21,4,15,19
2011,12,25,6,22,2,15,17
2011,12,25,6,23,2,14,16
2011,12,26,0,0,5,6,11
2011,12,26,0,1,3,7,10
2011,12,26,0,2,2,5,7
2011,12,26,0,4,0,2,2
2011,12,26,0,5,0,3,3
2011,12,26,0,6,0,4,4
2011,12,26,0,7,2,17,19
2011,12,26,0,8,5,13,18
2011,12,26,0,9,24,38,62
2011,12,26,0,10,31,39,70
2011,12,26,0,11,40,51,91
2011,12,26,0,12,34,66,100
2011,12,26,0,13,57,83,140
2011,12,26,0,14,73,80,153
2011,12,26,0,15,26,105,131
2011,12,26,0,16,28,69,97
2011,12,26,0,17,30,67,97
2011,12,26,0,18,21,54,75
2011,12,26,0,19,16,49,65
2011,12,26,0,20,14,42,56
2011,12,26,0,21,10,39,49
2011,12,26,0,22,5,22,27
2011,12,26,0,23,4,25,29
2011,12,27,1,0,3,9,12
2011,12,27,1,1,0,6,6
2011,12,27,1,2,2,2,4
2011,12,27,1,3,0,3,3
2011,12,27,1,4,0,3,3
2011,12,27,1,5,0,8,8
2011,12,27,1,6,0,35,35
2011,12,27,1,7,1,78,79
2011,12,27,1,8,9,154,163
2011,12,27,1,9,19,85,104
2011,12,27,1,10,13,46,59
2011,12,27,1,11,6,24,30
2011,12,27,1,12,8,16,24
2011,12,27,1,13,1,17,18
2011,12,27,1,14,0,14,14
2011,12,27,1,15,2,17,19
2011,12,27,1,16,2,44,46
2011,12,27,1,17,6,109,115
2011,12,27,1,18,9,126,135
2011,12,27,1,19,3,87,90
2011,12,27,1,20,3,66,69
2011,12,27,1,21,11,52,63
2011,12,27,1,22,3,29,32
2011,12,27,1,23,2,24,26
2011,12,28,2,0,0,10,10
2011,12,28,2,1,0,12,12
2011,12,28,2,2,0,7,7
2011,12,28,2,3,0,4,4
2011,12,28,2,5,0,9,9
2011,12,28,2,6,1,42,43
2011,12,28,2,7,4,106,110
2011,12,28,2,8,11,205,216
2011,12,28,2,9,18,169,187
2011,12,28,2,10,12,83,95
2011,12,28,2,11,18,93,111
2011,12,28,2,12,32,108,140
2011,12,28,2,13,24,135,159
2011,12,28,2,14,24,95,119
2011,12,28,2,15,16,101,117
2011,12,28,2,16,23,144,167
2011,12,28,2,17,25,225,250
2011,12,28,2,18,10,159,169
2011,12,28,2,19,16,135,151
2011,12,28,2,20,9,70,79
2011,12,28,2,21,7,63,70
2011,12,28,2,22,2,31,33
2011,12,28,2,23,3,36,39
2011,12,29,3,0,4,24,28
2011,12,29,3,1,0,15,15
2011,12,29,3,2,0,3,3
2011,12,29,3,3,0,2,2
2011,12,29,3,4,1,2,3
2011,12,29,3,5,0,9,9
2011,12,29,3,6,2,39,41
2011,12,29,3,7,2,104,106
2011,12,29,3,8,3,205,208
2011,12,29,3,9,15,154,169
2011,12,29,3,10,13,97,110
2011,12,29,3,11,23,98,121
2011,12,29,3,12,12,117,129
2011,12,29,3,13,36,95,131
2011,12,29,3,14,30,112,142
2011,12,29,3,15,27,150,177
2011,12,29,3,16,22,155,177
2011,12,29,3,17,14,226,240
2011,12,29,3,18,15,192,207
2011,12,29,3,19,11,123,134
2011,12,29,3,20,8,88,96
2011,12,29,3,21,8,60,68
2011,12,29,3,22,7,48,55
2011,12,29,3,23,1,44,45
2011,12,30,4,0,4,26,30
2011,12,30,4,1,9,11,20
2011,12,30,4,2,2,10,12
2011,12,30,4,3,0,6,6
2011,12,30,4,4,0,2,2
2011,12,30,4,5,0,9,9
2011,12,30,4,6,1,31,32
2011,12,30,4,7,3,92,95
2011,12,30,4,8,12,191,203
2011,12,30,4,9,19,175,194
2011,12,30,4,10,10,107,117
2011,12,30,4,11,45,126,171
2011,12,30,4,12,38,159,197
2011,12,30,4,13,53,152,205
2011,12,30,4,14,67,177,244
2011,12,30,4,15,56,236,292
2011,12,30,4,16,36,246,282
2011,12,30,4,17,54,188,242
2011,12,30,4,18,19,163,182
2011,12,30,4,19,16,96,112
2011,12,30,4,20,16,75,91
2011,12,30,4,21,11,84,95
2011,12,30,4,22,7,78,85
2011,12,30,4,23,13,60,73
2011,12,31,5,0,7,37,44
2011,12,31,5,1,4,31,35
2011,12,31,5,2,1,27,28
2011,12,31,5,3,1,17,18
2011,12,31,5,4,1,9,10
2011,12,31,5,5,1,0,1
2011,12,31,5,6,1,5,6
2011,12,31,5,7,6,13,19
2011,12,31,5,8,7,42,49
2011,12,31,5,9,18,72,90
2011,12,31,5,10,20,108,128
2011,12,31,5,11,65,152,217
2011,12,31,5,12,93,180,273
2011,12,31,5,13,108,205,313
2011,12,31,5,14,115,185,300
2011,12,31,5,15,89,163,252
2011,12,31,5,16,52,143,195
2011,12,31,5,17,28,101,129
2011,12,31,5,18,13,80,93
2011,12,31,5,19,19,73,92
2011,12,31,5,20,8,63,71
2011,12,31,5,21,2,50,52
2011,12,31,5,22,2,36,38
2011,12,31,5,23,4,27,31
2012,1,1,6,0,5,43,48
2012,1,1,6,1,15,78,93
2012,1,1,6,2,16,59,75
2012,1,1,6,3,11,41,52
2012,1,1,6,4,0,8,8
2012,1,1,6,5,0,5,5
2012,1,1,6,6,1,1,2
2012,1,1,6,7,1,6,7
2012,1,1,6,8,4,10,14
2012,1,1,6,9,13,27,40
2012,1,1,6,10,18,52,70
2012,1,1,6,11,40,98,138
2012,1,1,6,12,58,143,201
2012,1,1,6,13,82,141,223
2012,1,1,6,14,120,147,267
2012,1,1,6,15,101,164,265
2012,1,1,6,16,68,147,215
2012,1,1,6,17,36,75,111
2012,1,1,6,18,25,81,106
2012,1,1,6,19,20,85,105
2012,1,1,6,20,25,58,83
2012,1,1,6,21,10,61,71
2012,1,1,6,22,13,53,66
2012,1,1,6,23,4,25,29
2012,1,2,0,0,8,31,39
2012,1,2,0,1,1,11,12
2012,1,2,0,2,1,6,7
2012,1,2,0,4,0,3,3
2012,1,2,0,5,1,3,4
2012,1,2,0,6,0,14,14
2012,1,2,0,7,0,16,16
2012,1,2,0,8,2,51,53
2012,1,2,0,9,15,53,68
2012,1,2,0,10,20,89,109
2012,1,2,0,11,33,142,175
2012,1,2,0,12,41,161,202
2012,1,2,0,13,26,150,176
2012,1,2,0,14,10,141,151
2012,1,2,0,15,29,139,168
2012,1,2,0,16,10,144,154
2012,1,2,0,17,17,136,153
2012,1,2,0,18,13,113,126
2012,1,2,0,19,4,89,93
2012,1,2,0,20,5,83,88
2012,1,2,0,21,3,63,66
2012,1,2,0,22,3,36,39
2012,1,2,0,23,2,32,34
2012,1,3,1,0,0,13,13
2012,1,3,1,1,1,5,6
2012,1,3,1,2,0,3,3
2012,1,3,1,3,0,2,2
2012,1,3,1,4,0,4,4
2012,1,3,1,5,0,12,12
2012,1,3,1,6,4,80,84
2012,1,3,1,7,2,168,170
2012,1,3,1,8,5,349,354
2012,1,3,1,9,8,145,153
2012,1,3,1,10,5,55,60
2012,1,3,1,11,12,63,75
2012,1,3,1,12,4,70,74
2012,1,3,1,13,5,68,73
2012,1,3,1,14,7,72,79
2012,1,3,1,15,9,68,77
2012,1,3,1,16,7,129,136
2012,1,3,1,17,4,241,245
2012,1,3,1,18,10,213,223
2012,1,3,1,19,4,152,156
2012,1,3,1,20,0,115,115
2012,1,3,1,21,2,66,68
2012,1,3,1,22,0,33,33
2012,1,3,1,23,0,18,18
2012,1,4,2,0,0,9,9
2012,1,4,2,1,0,3,3
2012,1,4,2,2,0,1,1
2012,1,4,2,3,0,1,1
2012,1,4,2,4,0,2,2
2012,1,4,2,5,0,14,14
2012,1,4,2,6,0,58,58
2012,1,4,2,7,1,151,152
2012,1,4,2,8,5,310,315
2012,1,4,2,9,7,173,180
2012,1,4,2,10,7,57,64
2012,1,4,2,11,6,40,46
2012,1,4,2,12,9,75,84
2012,1,4,2,13,9,82,91
2012,1,4,2,14,6,69,75
2012,1,4,2,15,9,81,90
2012,1,4,2,16,8,123,131
2012,1,4,2,17,9,272,281
2012,1,4,2,18,9,280,289
2012,1,4,2,19,2,182,184
2012,1,4,2,20,2,121,123
2012,1,4,2,21,2,88,90
2012,1,4,2,22,4,48,52
2012,1,4,2,23,0,32,32
2012,1,5,3,0,1,13,14
2012,1,5,3,1,0,5,5
2012,1,5,3,2,0,4,4
2012,1,5,3,3,0,4,4
2012,1,5,3,4,0,5,5
2012,1,5,3,5,0,26,26
2012,1,5,3,6,0,78,78
2012,1,5,3,7,3,212,215
2012,1,5,3,8,11,377,388
2012,1,5,3,9,7,220,227
2012,1,5,3,10,5,81,86
2012,1,5,3,11,6,78,84
2012,1,5,3,12,6,114,120
2012,1,5,3,13,6,112,118
2012,1,5,3,14,13,104,117
2012,1,5,3,15,6,113,119
2012,1,5,3,16,19,177,196
2012,1,5,3,17,19,393,412
2012,1,5,3,18,9,373,382
2012,1,5,3,19,10,255,265
2012,1,5,3,20,5,171,176
2012,1,5,3,21,9,88,97
2012,1,5,3,22,1,70,71
2012,1,5,3,23,4,56,60
2012,1,6,4,0,1,24,25
2012,1,6,4,1,2,6,8
2012,1,6,4,2,2,3,5
2012,1,6,4,3,1,3,4
2012,1,6,4,4,0,3,3
2012,1,6,4,5,0,13,13
2012,1,6,4,6,1,68,69
2012,1,6,4,7,4,201,205
2012,1,6,4,8,11,436,447
2012,1,6,4,9,4,237,241
2012,1,6,4,10,14,102,116
2012,1,6,4,11,8,130,138
2012,1,6,4,12,23,168,191
2012,1,6,4,13,16,188,204
2012,1,6,4,14,23,151,174
2012,1,6,4,15,44,177,221
2012,1,6,4,16,35,259,294
2012,1,6,4,17,20,456,476
2012,1,6,4,18,28,391,419
2012,1,6,4,19,11,260,271
2012,1,6,4,20,14,163,177
2012,1,6,4,21,17,137,154
2012,1,6,4,22,12,123,135
2012,1,6,4,23,13,88,101
2012,1,7,5,0,2,77,79
2012,1,7,5,1,6,56,62
2012,1,7,5,2,2,36,38
2012,1,7,5,3,1,19,20
2012,1,7,5,4,1,9,10
2012,1,7,5,5,2,7,9
2012,1,7,5,6,0,7,7
2012,1,7,5,7,0,20,20
2012,1,7,5,8,0,64,64
2012,1,7,5,9,14,116,130
2012,1,7,5,10,43,160,203
2012,1,7,5,11,74,250,324
2012,1,7,5,12,100,276,376
2012,1,7,5,13,149,296,445
2012,1,7,5,14,156,356,512
2012,1,7,5,15,132,317,449
2012,1,7,5,16,133,268,401
2012,1,7,5,17,86,235,321
2012,1,7,5,18,49,248,297
2012,1,7,5,19,44,171,215
2012,1,7,5,20,21,149,170
2012,1,7,5,21,22,118,140
2012,1,7,5,22,16,93,109
2012,1,7,5,23,16,103,119
2012,1,8,6,0,14,77,91
2012,1,8,6,1,10,62,72
2012,1,8,6,2,10,57,67
2012,1,8,6,3,6,26,32
2012,1,8,6,4,2,4,6
2012,1,8,6,5,0,2,2
2012,1,8,6,6,0,2,2
2012,1,8,6,7,1,23,24
2012,1,8,6,8,4,53,57
2012,1,8,6,9,23,102,125
2012,1,8,6,10,27,181,208
2012,1,8,6,11,55,201,256
2012,1,8,6,12,78,273,351
2012,1,8,6,13,77,266,343
2012,1,8,6,14,75,253,328
2012,1,8,6,15,89,241,330
2012,1,8,6,16,58,256,314
2012,1,8,6,17,22,197,219
2012,1,8,6,18,19,162,181
2012,1,8,6,19,8,104,112
2012,1,8,6,20,7,119,126
2012,1,8,6,21,10,81,91
2012,1,8,6,22,4,53,57
2012,1,8,6,23,0,30,30
2012,1,9,0,0,3,12,15
2012,1,9,0,1,1,4,5
2012,1,9,0,2,2,3,5
2012,1,9,0,3,0,3,3
2012,1,9,0,4,0,4,4
2012,1,9,0,5,0,21,21
2012,1,9,0,6,3,84,87
2012,1,9,0,7,1,239,240
2012,1,9,0,8,13,406,419
2012,1,9,0,9,9,188,197
2012,1,9,0,10,13,95,108
2012,1,9,0,11,6,82,88
2012,1,9,0,12,10,93,103
2012,1,9,0,13,3,77,80
2012,1,9,0,14,5,45,50
2012,1,9,0,15,5,63,68
2012,1,9,0,16,3,46,49
2012,1,9,0,17,5,147,152
2012,1,9,0,18,6,158,164
2012,1,9,0,19,3,185,188
2012,1,9,0,20,5,126,131
2012,1,9,0,21,1,78,79
2012,1,9,0,22,8,54,62
2012,1,9,0,23,1,51,52
2012,1,10,1,0,0,14,14
2012,1,10,1,1,2,3,5
2012,1,10,1,2,2,2,4
2012,1,10,1,4,0,4,4
2012,1,10,1,5,0,23,23
2012,1,10,1,6,0,79,79
2012,1,10,1,7,3,219,222
2012,1,10,1,8,6,464,470
2012,1,10,1,9,11,183,194
2012,1,10,1,10,3,79,82
2012,1,10,1,11,8,93,101
2012,1,10,1,12,13,127,140
2012,1,10,1,13,15,163,178
2012,1,10,1,14,10,96,106
2012,1,10,1,15,17,119,136
2012,1,10,1,16,15,225,240
2012,1,10,1,17,14,445,459
2012,1,10,1,18,13,372,385
2012,1,10,1,19,11,269,280
2012,1,10,1,20,10,190,200
2012,1,10,1,21,7,109,116
2012,1,10,1,22,10,104,114
2012,1,10,1,23,3,37,40
2012,1,11,2,0,2,26,28
2012,1,11,2,1,1,6,7
2012,1,11,2,2,0,5,5
2012,1,11,2,3,0,4,4
2012,1,11,2,4,0,1,1
2012,1,11,2,5,0,22,22
2012,1,11,2,6,2,71,73
2012,1,11,2,7,9,247,256
2012,1,11,2,8,11,488,499
2012,1,11,2,9,7,218,225
2012,1,11,2,10,13,84,97
2012,1,11,2,11,9,90,99
2012,1,11,2,12,4,51,55
2012,1,11,2,13,8,56,64
2012,1,11,2,14,3,70,73
2012,1,11,2,15,6,73,79
2012,1,11,2,16,6,112,118
2012,1,11,2,17,6,128,134
2012,1,11,2,18,2,96,98
2012,1,11,2,19,1,92,93
2012,1,11,2,20,2,55,57
2012,1,11,2,21,0,29,29
2012,1,11,2,22,0,49,49
2012,1,11,2,23,0,9,9
2012,1,12,3,0,0,3,3
2012,1,12,3,1,0,3,3
2012,1,12,3,2,1,1,2
2012,1,12,3,3,0,3,3
2012,1,12,3,4,0,1,1
2012,1,12,3,5,0,16,16
2012,1,12,3,6,1,87,88
2012,1,12,3,7,2,218,220
2012,1,12,3,8,11,497,508
2012,1,12,3,9,10,219,229
2012,1,12,3,10,6,84,90
2012,1,12,3,11,18,101,119
2012,1,12,3,12,14,130,144
2012,1,12,3,13,13,170,183
2012,1,12,3,14,24,132,156
2012,1,12,3,15,32,156,188
2012,1,12,3,16,33,248,281
2012,1,12,3,17,23,472,495
2012,1,12,3,18,22,399,421
2012,1,12,3,19,17,311,328
2012,1,12,3,20,11,229,240
2012,1,12,3,21,12,161,173
2012,1,12,3,22,12,121,133
2012,1,12,3,23,7,60,67
2012,1,13,4,0,4,38,42
2012,1,13,4,1,0,12,12
2012,1,13,4,2,1,13,14
2012,1,13,4,3,3,4,7
2012,1,13,4,4,1,2,3
2012,1,13,4,5,0,21,21
2012,1,13,4,6,2,70,72
2012,1,13,4,7,3,174,177
2012,1,13,4,8,11,407,418
2012,1,13,4,9,10,204,214
2012,1,13,4,10,2,100,102
2012,1,13,4,11,12,102,114
2012,1,13,4,12,14,140,154
2012,1,13,4,13,14,140,154
2012,1,13,4,14,10,119,129
2012,1,13,4,15,15,123,138
2012,1,13,4,16,18,214,232
2012,1,13,4,17,15,316,331
2012,1,13,4,18,6,294,300
2012,1,13,4,19,7,199,206
2012,1,13,4,20,6,129,135
2012,1,13,4,21,7,95,102
2012,1,13,4,22,7,58,65
2012,1,13,4,23,5,60,65
2012,1,14,5,0,2,42,44
2012,1,14,5,1,6,44,50
2012,1,14,5,2,6,32,38
2012,1,14,5,3,6,14,20
2012,1,14,5,4,0,3,3
2012,1,14,5,5,0,4,4
2012,1,14,5,6,0,5,5
2012,1,14,5,7,0,24,24
2012,1,14,5,8,3,89,92
2012,1,14,5,9,3,78,81
2012,1,14,5,10,14,135,149
2012,1,14,5,11,28,150,178
2012,1,14,5,12,30,189,219
2012,1,14,5,13,38,182,220
2012,1,14,5,14,52,179,231
2012,1,14,5,15,49,177,226
2012,1,14,5,16,28,178,206
2012,1,14,5,17,15,127,142
2012,1,14,5,18,21,122,143
2012,1,14,5,19,12,90,102
2012,1,14,5,20,8,95,103
2012,1,14,5,21,3,66,69
2012,1,14,5,22,4,62,66
2012,1,14,5,23,5,71,76
2012,1,15,6,0,9,50,59
2012,1,15,6,1,2,40,42
2012,1,15,6,2,5,38,43
2012,1,15,6,3,1,24,25
2012,1,15,6,4,1,5,6
2012,1,15,6,5,0,5,5
2012,1,15,6,6,1,7,8
2012,1,15,6,7,3,14,17
2012,1,15,6,8,2,34,36
2012,1,15,6,9,10,80,90
2012,1,15,6,10,11,115,126
2012,1,15,6,11,21,143,164
2012,1,15,6,12,41,191,232
2012,1,15,6,13,40,182,222
2012,1,15,6,14,25,163,188
2012,1,15,6,15,33,173,206
2012,1,15,6,16,31,174,205
2012,1,15,6,17,15,131,146
2012,1,15,6,18,7,113,120
2012,1,15,6,19,9,101,110
2012,1,15,6,20,10,85,95
2012,1,15,6,21,1,71,72
2012,1,15,6,22,2,58,60
2012,1,15,6,23,3,26,29
2012,1,16,0,0,2,23,25
2012,1,16,0,1,2,18,20
2012,1,16,0,2,3,14,17
2012,1,16,0,3,0,3,3
2012,1,16,0,4,2,6,8
2012,1,16,0,5,1,5,6
2012,1,16,0,6,0,13,13
2012,1,16,0,7,5,28,33
2012,1,16,0,8,3,75,78
2012,1,16,0,9,7,89,96
2012,1,16,0,10,19,107,126
2012,1,16,0,11,21,158,179
2012,1,16,0,12,20,165,185
2012,1,16,0,13,26,202,228
2012,1,16,0,14,23,157,180
2012,1,16,0,15,17,175,192
2012,1,16,0,16,22,158,180
2012,1,16,0,17,19,173,192
2012,1,16,0,18,6,174,180
2012,1,16,0,19,10,134,144
2012,1,16,0,20,2,88,90
2012,1,16,0,21,3,46,49
2012,1,16,0,22,4,39,43
2012,1,16,0,23,0,28,28
2012,1,17,1,0,0,12,12
2012,1,17,1,1,0,2,2
2012,1,17,1,2,0,12,12
2012,1,17,1,4,0,2,2
2012,1,17,1,5,0,13,13
2012,1,17,1,6,0,57,57
2012,1,17,1,7,5,120,125
2012,1,17,1,8,2,90,92
2012,1,17,1,9,7,61,68
2012,1,17,1,10,1,61,62
2012,1,17,1,11,2,73,75
2012,1,17,1,12,3,83,86
2012,1,17,1,13,8,95,103
2012,1,17,1,14,12,120,132
2012,1,17,1,15,6,123,129
2012,1,17,1,16,14,205,219
2012,1,17,1,17,20,442,462
2012,1,17,1,18,12,450,462
2012,1,17,1,19,11,297,308
2012,1,17,1,20,11,169,180
2012,1,17,1,21,6,174,180
2012,1,17,1,22,5,85,90
2012,1,17,1,23,1,59,60
2012,1,18,2,0,3,14,17
2012,1,18,2,1,0,10,10
2012,1,18,2,2,1,1,2
2012,1,18,2,3,1,3,4
2012,1,18,2,4,0,1,1
2012,1,18,2,5,0,29,29
2012,1,18,2,6,0,87,87
2012,1,18,2,7,1,261,262
2012,1,18,2,8,15,473,488
2012,1,18,2,9,6,196,202
2012,1,18,2,10,5,88,93
2012,1,18,2,11,4,110,114
2012,1,18,2,12,6,155,161
2012,1,18,2,13,6,124,130
2012,1,18,2,14,7,98,105
2012,1,18,2,15,8,122,130
2012,1,18,2,16,13,163,176
2012,1,18,2,17,8,338,346
2012,1,18,2,18,8,347,355
2012,1,18,2,19,5,251,256
2012,1,18,2,20,1,162,163
2012,1,18,2,21,5,118,123
2012,1,18,2,22,4,74,78
2012,1,18,2,23,2,36,38
2012,1,19,3,0,0,15,15
2012,1,19,3,1,0,5,5
2012,1,19,3,2,0,3,3
2012,1,19,3,3,0,4,4
2012,1,19,3,4,0,1,1
2012,1,19,3,5,0,19,19
2012,1,19,3,6,0,85,85
2012,1,19,3,7,2,202,204
2012,1,19,3,8,9,414,423
2012,1,19,3,9,6,202,208
2012,1,19,3,10,10,98,108
2012,1,19,3,11,6,93,99
2012,1,19,3,12,5,106,111
2012,1,19,3,13,6,118,124
2012,1,19,3,14,15,104,119
2012,1,19,3,15,9,118,127
2012,1,19,3,16,8,185,193
2012,1,19,3,17,21,364,385
2012,1,19,3,18,16,345,361
2012,1,19,3,19,5,229,234
2012,1,19,3,20,7,184,191
2012,1,19,3,21,4,116,120
2012,1,19,3,22,0,90,90
2012,1,19,3,23,1,55,56
2012,1,20,4,0,3,24,27
2012,1,20,4,1,0,15,15
2012,1,20,4,2,0,11,11
2012,1,20,4,3,0,4,4
2012,1,20,4,4,0,3,3
2012,1,20,4,5,0,19,19
2012,1,20,4,6,0,68,68
2012,1,20,4,7,2,183,185
2012,1,20,4,8,4,420,424
2012,1,20,4,9,20,242,262
2012,1,20,4,10,1,96,97
2012,1,20,4,11,6,117,123
2012,1,20,4,12,5,119,124
2012,1,20,4,13,12,144,156
2012,1,20,4,14,8,106,114
2012,1,20,4,15,12,144,156
2012,1,20,4,16,11,162,173
2012,1,20,4,17,9,340,349
2012,1,20,4,18,5,296,301
2012,1,20,4,19,6,184,190
2012,1,20,4,20,1,140,141
2012,1,20,4,21,5,99,104
2012,1,20,4,22,1,71,72
2012,1,20,4,23,3,35,38
2012,1,21,5,0,0,24,24
2012,1,21,5,1,1,22,23
2012,1,21,5,2,1,25,26
2012,1,21,5,3,0,13,13
2012,1,21,5,4,0,1,1
2012,1,21,5,5,0,2,2
2012,1,21,5,6,0,1,1
2012,1,21,5,7,3,10,13
2012,1,21,5,8,3,22,25
2012,1,21,5,9,2,40,42
2012,1,21,5,10,0,45,45
2012,1,21,5,11,1,62,63
2012,1,21,5,12,5,62,67
2012,1,21,5,13,10,66,76
2012,1,21,5,14,6,89,95
2012,1,21,5,15,6,113,119
2012,1,21,5,16,5,113,118
2012,1,21,5,17,7,99,106
2012,1,21,5,18,3,106,109
2012,1,21,5,19,0,85,85
2012,1,21,5,20,5,62,67
2012,1,21,5,21,5,64,69
2012,1,21,5,22,3,56,59
2012,1,21,5,23,1,51,52
2012,1,22,6,0,1,51,52
2012,1,22,6,1,1,49,50
2012,1,22,6,2,1,46,47
2012,1,22,6,3,1,20,21
2012,1,22,6,4,1,1,2
2012,1,22,6,5,1,2,3
2012,1,22,6,6,0,4,4
2012,1,22,6,7,2,11,13
2012,1,22,6,8,3,29,32
2012,1,22,6,9,9,54,63
2012,1,22,6,10,9,120,129
2012,1,22,6,11,18,114,132
2012,1,22,6,12,24,161,185
2012,1,22,6,13,24,175,199
2012,1,22,6,14,19,162,181
2012,1,22,6,15,27,149,176
2012,1,22,6,16,12,143,155
2012,1,22,6,17,8,100,108
2012,1,22,6,18,11,110,121
2012,1,22,6,19,9,80,89
2012,1,22,6,20,5,69,74
2012,1,22,6,21,8,36,44
2012,1,22,6,22,0,58,58
2012,1,22,6,23,2,35,37
2012,1,23,0,0,2,17,19
2012,1,23,0,1,0,4,4
2012,1,23,0,2,0,2,2
2012,1,23,0,3,0,1,1
2012,1,23,0,4,0,1,1
2012,1,23,0,5,0,19,19
2012,1,23,0,6,6,36,42
2012,1,23,0,7,8,114,122
2012,1,23,0,8,5,265,270
2012,1,23,0,9,13,198,211
2012,1,23,0,10,10,139,149
2012,1,23,0,11,5,57,62
2012,1,23,0,12,10,52,62
2012,1,23,0,13,5,32,37
2012,1,23,0,14,13,48,61
2012,1,23,0,15,10,64,74
2012,1,23,0,16,14,108,122
2012,1,23,0,17,6,270,276
2012,1,23,0,18,7,275,282
2012,1,23,0,19,9,211,220
2012,1,23,0,20,8,160,168
2012,1,23,0,21,8,112,120
2012,1,23,0,22,4,64,68
2012,1,23,0,23,2,35,37
2012,1,24,1,0,6,18,24
2012,1,24,1,1,2,7,9
2012,1,24,1,2,2,6,8
2012,1,24,1,3,0,3,3
2012,1,24,1,4,0,2,2
2012,1,24,1,5,0,25,25
2012,1,24,1,6,1,87,88
2012,1,24,1,7,11,220,231
2012,1,24,1,8,11,476,487
2012,1,24,1,9,11,243,254
2012,1,24,1,10,23,93,116
2012,1,24,1,11,30,122,152
2012,1,24,1,12,25,150,175
2012,1,24,1,13,33,169,202
2012,1,24,1,14,35,138,173
2012,1,24,1,15,52,156,208
2012,1,24,1,16,35,243,278
2012,1,24,1,17,41,473,514
2012,1,24,1,18,32,391,423
2012,1,24,1,19,20,311,331
2012,1,24,1,20,18,211,229
2012,1,24,1,21,18,154,172
2012,1,24,1,22,14,110,124
2012,1,24,1,23,19,80,99
2012,1,25,2,0,6,25,31
2012,1,25,2,1,4,7,11
2012,1,25,2,2,3,3,6
2012,1,25,2,3,0,1,1
2012,1,25,2,4,0,4,4
2012,1,25,2,5,0,32,32
2012,1,25,2,6,1,86,87
2012,1,25,2,7,14,242,256
2012,1,25,2,8,18,495,513
2012,1,25,2,9,18,218,236
2012,1,25,2,10,30,110,140
2012,1,25,2,11,52,104,156
2012,1,25,2,12,46,147,193
2012,1,25,2,13,63,146,209
2012,1,25,2,14,53,107,160
2012,1,25,2,15,30,125,155
2012,1,25,2,16,29,217,246
2012,1,25,2,17,27,443,470
2012,1,25,2,18,24,415,439
2012,1,25,2,19,5,311,316
2012,1,25,2,20,10,225,235
2012,1,25,2,21,19,165,184
2012,1,25,2,22,12,101,113
2012,1,25,2,23,3,63,66
2012,1,26,3,0,3,22,25
2012,1,26,3,1,5,16,21
2012,1,26,3,2,1,6,7
2012,1,26,3,3,1,5,6
2012,1,26,3,4,0,3,3
2012,1,26,3,5,0,28,28
2012,1,26,3,6,0,86,86
2012,1,26,3,7,11,227,238
2012,1,26,3,8,16,514,530
2012,1,26,3,9,18,255,273
2012,1,26,3,10,16,92,108
2012,1,26,3,11,11,99,110
2012,1,26,3,12,29,136,165
2012,1,26,3,13,17,156,173
2012,1,26,3,14,16,111,127
2012,1,26,3,15,22,142,164
2012,1,26,3,16,15,208,223
2012,1,26,3,17,15,391,406
2012,1,26,3,18,12,393,405
2012,1,26,3,19,11,302,313
2012,1,26,3,20,8,216,224
2012,1,26,3,21,8,184,192
2012,1,26,3,22,3,139,142
2012,1,26,3,23,5,86,91
2012,1,27,4,0,6,32,38
2012,1,27,4,1,6,23,29
2012,1,27,4,2,2,11,13
2012,1,27,4,3,3,5,8
2012,1,27,4,4,1,3,4
2012,1,27,4,5,0,24,24
2012,1,27,4,6,0,72,72
2012,1,27,4,7,6,128,134
2012,1,27,4,8,14,206,220
2012,1,27,4,9,6,101,107
2012,1,27,4,10,9,117,126
2012,1,27,4,11,10,95,105
2012,1,27,4,12,25,154,179
2012,1,27,4,13,26,175,201
2012,1,27,4,14,23,153,176
2012,1,27,4,15,27,169,196
2012,1,27,4,16,26,240,266
2012,1,27,4,17,16,405,421
2012,1,27,4,18,20,360,380
2012,1,27,4,19,10,241,251
2012,1,27,4,20,6,153,159
2012,1,27,4,21,8,127,135
2012,1,27,4,22,11,108,119
2012,1,27,4,23,8,78,86
2012,1,28,5,0,1,68,69
2012,1,28,5,1,1,57,58
2012,1,28,5,2,3,38,41
2012,1,28,5,3,1,16,17
2012,1,28,5,4,0,8,8
2012,1,28,5,5,0,9,9
2012,1,28,5,6,3,12,15
2012,1,28,5,7,3,28,31
2012,1,28,5,8,9,81,90
2012,1,28,5,9,13,145,158
2012,1,28,5,10,27,164,191
2012,1,28,5,11,55,241,296
2012,1,28,5,12,70,243,313
2012,1,28,5,13,80,293,373
2012,1,28,5,14,123,239,362
2012,1,28,5,15,90,320,410
2012,1,28,5,16,131,275,406
2012,1,28,5,17,57,233,290
2012,1,28,5,18,40,201,241
2012,1,28,5,19,33,173,206
2012,1,28,5,20,5,115,120
2012,1,28,5,21,18,109,127
2012,1,28,5,22,6,97,103
2012,1,28,5,23,6,79,85
2012,1,29,6,0,15,81,96
2012,1,29,6,1,5,68,73
2012,1,29,6,2,3,48,51
2012,1,29,6,3,4,17,21
2012,1,29,6,4,0,5,5
2012,1,29,6,5,1,6,7
2012,1,29,6,6,1,4,5
2012,1,29,6,7,0,12,12
2012,1,29,6,8,9,61,70
2012,1,29,6,9,13,98,111
2012,1,29,6,10,38,152,190
2012,1,29,6,11,57,198,255
2012,1,29,6,12,73,215,288
2012,1,29,6,13,78,238,316
2012,1,29,6,14,49,229,278
2012,1,29,6,15,68,242,310
2012,1,29,6,16,54,268,322
2012,1,29,6,17,33,201,234
2012,1,29,6,18,17,151,168
2012,1,29,6,19,14,145,159
2012,1,29,6,20,13,98,111
2012,1,29,6,21,0,69,69
2012,1,29,6,22,7,57,64
2012,1,29,6,23,4,21,25
2012,1,30,0,0,0,10,10
2012,1,30,0,1,0,9,9
2012,1,30,0,2,1,6,7
2012,1,30,0,3,0,4,4
2012,1,30,0,4,0,5,5
2012,1,30,0,5,0,25,25
2012,1,30,0,6,0,80,80
2012,1,30,0,7,4,219,223
2012,1,30,0,8,12,480,492
2012,1,30,0,9,5,193,198
2012,1,30,0,10,3,81,84
2012,1,30,0,11,6,93,99
2012,1,30,0,12,5,129,134
2012,1,30,0,13,15,117,132
2012,1,30,0,14,15,99,114
2012,1,30,0,15,7,131,138
2012,1,30,0,16,11,209,220
2012,1,30,0,17,16,422,438
2012,1,30,0,18,11,399,410
2012,1,30,0,19,8,297,305
2012,1,30,0,20,2,179,181
2012,1,30,0,21,3,159,162
2012,1,30,0,22,2,91,93
2012,1,30,0,23,0,52,52
2012,1,31,1,0,0,15,15
2012,1,31,1,1,1,7,8
2012,1,31,1,2,0,2,2
2012,1,31,1,3,0,2,2
2012,1,31,1,4,0,1,1
2012,1,31,1,5,0,22,22
2012,1,31,1,6,0,103,103
2012,1,31,1,7,6,271,277
2012,1,31,1,8,14,497,511
2012,1,31,1,9,30,231,261
2012,1,31,1,10,34,110,144
2012,1,31,1,11,14,125,139
2012,1,31,1,12,13,181,194
2012,1,31,1,13,27,171,198
2012,1,31,1,14,18,142,160
2012,1,31,1,15,27,150,177
2012,1,31,1,16,30,276,306
2012,1,31,1,17,41,516,557
2012,1,31,1,18,16,486,502
2012,1,31,1,19,22,306,328
2012,1,31,1,20,15,223,238
2012,1,31,1,21,3,162,165
2012,1,31,1,22,11,117,128
2012,1,31,1,23,2,61,63
2012,2,1,2,0,0,31,31
2012,2,1,2,1,0,4,4
2012,2,1,2,2,1,6,7
2012,2,1,2,3,0,3,3
2012,2,1,2,4,0,1,1
2012,2,1,2,5,0,18,18
2012,2,1,2,6,0,66,66
2012,2,1,2,7,7,200,207
2012,2,1,2,8,15,505,520
2012,2,1,2,9,9,267,276
2012,2,1,2,10,9,123,132
2012,2,1,2,11,27,116,143
2012,2,1,2,12,26,153,179
2012,2,1,2,13,12,174,186
2012,2,1,2,14,33,159,192
2012,2,1,2,15,25,169,194
2012,2,1,2,16,22,261,283
2012,2,1,2,17,31,508,539
2012,2,1,2,18,12,514,526
2012,2,1,2,19,20,314,334
2012,2,1,2,20,10,253,263
2012,2,1,2,21,16,217,233
2012,2,1,2,22,7,133,140
2012,2,1,2,23,22,75,97
2012,2,2,3,0,7,24,31
2012,2,2,3,1,3,14,17
2012,2,2,3,2,2,7,9
2012,2,2,3,3,0,2,2
2012,2,2,3,4,0,1,1
2012,2,2,3,5,0,19,19
2012,2,2,3,6,1,72,73
2012,2,2,3,7,4,200,204
2012,2,2,3,8,9,434,443
2012,2,2,3,9,15,213,228
2012,2,2,3,10,6,72,78
2012,2,2,3,11,6,99,105
2012,2,2,3,12,8,140,148
2012,2,2,3,13,13,124,137
2012,2,2,3,14,12,129,141
2012,2,2,3,15,24,149,173
2012,2,2,3,16,18,211,229
2012,2,2,3,17,13,437,450
2012,2,2,3,18,17,393,410
2012,2,2,3,19,16,311,327
2012,2,2,3,20,9,204,213
2012,2,2,3,21,4,143,147
2012,2,2,3,22,3,105,108
2012,2,2,3,23,0,61,61
2012,2,3,4,0,1,37,38
2012,2,3,4,1,3,19,22
2012,2,3,4,2,0,6,6
2012,2,3,4,3,0,4,4
2012,2,3,4,4,0,2,2
2012,2,3,4,5,0,17,17
2012,2,3,4,6,0,88,88
2012,2,3,4,7,10,216,226
2012,2,3,4,8,12,428,440
2012,2,3,4,9,18,252,270
2012,2,3,4,10,15,114,129
2012,2,3,4,11,15,149,164
2012,2,3,4,12,25,191,216
2012,2,3,4,13,25,172,197
2012,2,3,4,14,22,148,170
2012,2,3,4,15,48,168,216
2012,2,3,4,16,36,273,309
2012,2,3,4,17,30,458,488
2012,2,3,4,18,17,368,385
2012,2,3,4,19,11,255,266
2012,2,3,4,20,8,155,163
2012,2,3,4,21,8,126,134
2012,2,3,4,22,3,116,119
2012,2,3,4,23,3,74,77
2012,2,4,5,0,10,76,86
2012,2,4,5,1,0,43,43
2012,2,4,5,2,6,38,44
2012,2,4,5,3,1,17,18
2012,2,4,5,4,1,5,6
2012,2,4,5,5,1,3,4
2012,2,4,5,6,1,4,5
2012,2,4,5,7,1,27,28
2012,2,4,5,8,4,86,90
2012,2,4,5,9,16,141,157
2012,2,4,5,10,31,193,224
2012,2,4,5,11,46,224,270
2012,2,4,5,12,40,260,300
2012,2,4,5,13,58,244,302
2012,2,4,5,14,47,229,276
2012,2,4,5,15,61,243,304
2012,2,4,5,16,20,123,143
2012,2,4,5,17,13,54,67
2012,2,4,5,18,6,58,64
2012,2,4,5,19,5,75,80
2012,2,4,5,20,4,73,77
2012,2,4,5,21,4,74,78
2012,2,4,5,22,4,91,95
2012,2,4,5,23,4,66,70
2012,2,5,6,0,3,58,61
2012,2,5,6,1,5,46,51
2012,2,5,6,2,4,59,63
2012,2,5,6,3,4,13,17
2012,2,5,6,4,0,9,9
2012,2,5,6,5,0,4,4
2012,2,5,6,6,0,4,4
2012,2,5,6,7,0,16,16
2012,2,5,6,8,4,58,62
2012,2,5,6,9,9,83,92
2012,2,5,6,10,10,138,148
2012,2,5,6,11,22,160,182
2012,2,5,6,12,25,222,247
2012,2,5,6,13,32,241,273
2012,2,5,6,14,40,202,242
2012,2,5,6,15,55,217,272
2012,2,5,6,16,35,261,296
2012,2,5,6,17,31,275,306
2012,2,5,6,18,10,171,181
2012,2,5,6,19,6,63,69
2012,2,5,6,20,3,47,50
2012,2,5,6,21,6,60,66
2012,2,5,6,22,9,182,191
2012,2,5,6,23,4,38,42
2012,2,6,0,0,7,14,21
2012,2,6,0,1,0,6,6
2012,2,6,0,2,0,3,3
2012,2,6,0,4,0,2,2
2012,2,6,0,5,0,17,17
2012,2,6,0,6,0,72,72
2012,2,6,0,7,5,227,232
2012,2,6,0,8,10,434,444
2012,2,6,0,9,8,269,277
2012,2,6,0,10,20,96,116
2012,2,6,0,11,12,104,116
2012,2,6,0,12,19,131,150
2012,2,6,0,13,17,124,141
2012,2,6,0,14,14,126,140
2012,2,6,0,15,25,146,171
2012,2,6,0,16,13,214,227
2012,2,6,0,17,13,417,430
2012,2,6,0,18,11,425,436
2012,2,6,0,19,7,284,291
2012,2,6,0,20,7,193,200
2012,2,6,0,21,11,143,154
2012,2,6,0,22,4,83,87
2012,2,6,0,23,3,43,46
2012,2,7,1,0,1,21,22
2012,2,7,1,1,8,6,14
2012,2,7,1,2,0,4,4
2012,2,7,1,3,1,1,2
2012,2,7,1,4,0,2,2
2012,2,7,1,5,0,15,15
2012,2,7,1,6,2,98,100
2012,2,7,1,7,6,291,297
2012,2,7,1,8,7,520,527
2012,2,7,1,9,11,277,288
2012,2,7,1,10,12,104,116
2012,2,7,1,11,9,120,129
2012,2,7,1,12,9,161,170
2012,2,7,1,13,15,169,184
2012,2,7,1,14,11,127,138
2012,2,7,1,15,13,133,146
2012,2,7,1,16,19,257,276
2012,2,7,1,17,15,494,509
2012,2,7,1,18,10,507,517
2012,2,7,1,19,11,327,338
2012,2,7,1,20,6,205,211
2012,2,7,1,21,20,169,189
2012,2,7,1,22,11,107,118
2012,2,7,1,23,2,49,51
2012,2,8,2,0,2,21,23
2012,2,8,2,1,1,9,10
2012,2,8,2,2,0,1,1
2012,2,8,2,3,0,1,1
2012,2,8,2,4,0,1,1
2012,2,8,2,5,0,20,20
2012,2,8,2,6,3,94,97
2012,2,8,2,7,5,276,281
2012,2,8,2,8,12,494,506
2012,2,8,2,9,8,245,253
2012,2,8,2,10,1,107,108
2012,2,8,2,11,5,96,101
2012,2,8,2,12,14,124,138
2012,2,8,2,13,15,111,126
2012,2,8,2,14,8,100,108
2012,2,8,2,15,5,48,53
2012,2,8,2,16,2,72,74
2012,2,8,2,17,8,147,155
2012,2,8,2,18,4,163,167
2012,2,8,2,19,3,157,160
2012,2,8,2,20,2,122,124
2012,2,8,2,21,3,126,129
2012,2,8,2,22,3,95,98
2012,2,8,2,23,3,57,60
2012,2,9,3,0,3,23,26
2012,2,9,3,1,2,10,12
2012,2,9,3,2,0,2,2
2012,2,9,3,3,0,4,4
2012,2,9,3,4,0,1,1
2012,2,9,3,5,0,18,18
2012,2,9,3,6,1,74,75
2012,2,9,3,7,3,263,266
2012,2,9,3,8,11,473,484
2012,2,9,3,9,9,229,238
2012,2,9,3,10,7,90,97
2012,2,9,3,11,4,95,99
2012,2,9,3,12,10,147,157
2012,2,9,3,13,10,144,154
2012,2,9,3,14,18,125,143
2012,2,9,3,15,14,120,134
2012,2,9,3,16,15,223,238
2012,2,9,3,17,12,386,398
2012,2,9,3,18,13,404,417
2012,2,9,3,19,8,287,295
2012,2,9,3,20,2,197,199
2012,2,9,3,21,8,169,177
2012,2,9,3,22,2,104,106
2012,2,9,3,23,9,75,84
2012,2,10,4,0,4,39,43
2012,2,10,4,1,2,11,13
2012,2,10,4,2,7,9,16
2012,2,10,4,3,0,5,5
2012,2,10,4,4,0,2,2
2012,2,10,4,5,0,17,17
2012,2,10,4,6,3,61,64
2012,2,10,4,7,5,225,230
2012,2,10,4,8,1,446,447
2012,2,10,4,9,9,264,273
2012,2,10,4,10,5,119,124
2012,2,10,4,11,19,133,152
2012,2,10,4,12,8,168,176
2012,2,10,4,13,22,170,192
2012,2,10,4,14,8,138,146
2012,2,10,4,15,27,163,190
2012,2,10,4,16,27,239,266
2012,2,10,4,17,15,381,396
2012,2,10,4,18,14,343,357
2012,2,10,4,19,16,246,262
2012,2,10,4,20,7,144,151
2012,2,10,4,21,14,108,122
2012,2,10,4,22,11,102,113
2012,2,10,4,23,1,64,65
2012,2,11,5,0,3,50,53
2012,2,11,5,1,2,43,45
2012,2,11,5,2,2,24,26
2012,2,11,5,3,0,9,9
2012,2,11,5,4,0,4,4
2012,2,11,5,5,0,2,2
2012,2,11,5,6,1,8,9
2012,2,11,5,7,0,19,19
2012,2,11,5,8,1,77,78
2012,2,11,5,9,5,85,90
2012,2,11,5,10,23,143,166
2012,2,11,5,11,26,157,183
2012,2,11,5,12,25,196,221
2012,2,11,5,13,18,216,234
2012,2,11,5,14,38,205,243
2012,2,11,5,15,12,112,124
2012,2,11,5,16,12,134,146
2012,2,11,5,17,13,131,144
2012,2,11,5,18,3,105,108
2012,2,11,5,19,2,85,87
2012,2,11,5,20,1,62,63
2012,2,11,5,21,5,43,48
2012,2,11,5,22,0,46,46
2012,2,11,5,23,0,20,20
2012,2,12,6,0,0,21,21
2012,2,12,6,1,0,24,24
2012,2,12,6,2,1,26,27
2012,2,12,6,3,0,14,14
2012,2,12,6,4,0,1,1
2012,2,12,6,5,0,3,3
2012,2,12,6,6,0,2,2
2012,2,12,6,7,0,18,18
2012,2,12,6,8,0,26,26
2012,2,12,6,9,3,60,63
2012,2,12,6,10,8,83,91
2012,2,12,6,11,3,121,124
2012,2,12,6,12,7,133,140
2012,2,12,6,13,10,128,138
2012,2,12,6,14,9,102,111
2012,2,12,6,15,5,150,155
2012,2,12,6,16,16,148,164
2012,2,12,6,17,4,83,87
2012,2,12,6,18,4,92,96
2012,2,12,6,19,2,78,80
2012,2,12,6,20,1,56,57
2012,2,12,6,21,0,36,36
2012,2,12,6,22,0,28,28
2012,2,12,6,23,0,23,23
2012,2,13,0,0,0,9,9
2012,2,13,0,1,0,6,6
2012,2,13,0,2,0,4,4
2012,2,13,0,3,0,1,1
2012,2,13,0,4,0,2,2
2012,2,13,0,5,0,17,17
2012,2,13,0,6,1,71,72
2012,2,13,0,7,1,194,195
2012,2,13,0,8,4,413,417
2012,2,13,0,9,7,198,205
2012,2,13,0,10,1,70,71
2012,2,13,0,11,5,85,90
2012,2,13,0,12,7,111,118
2012,2,13,0,13,11,129,140
2012,2,13,0,14,10,125,135
2012,2,13,0,15,10,145,155
2012,2,13,0,16,5,206,211
2012,2,13,0,17,8,399,407
2012,2,13,0,18,6,399,405
2012,2,13,0,19,7,256,263
2012,2,13,0,20,4,208,212
2012,2,13,0,21,2,144,146
2012,2,13,0,22,3,99,102
2012,2,13,0,23,2,34,36
2012,2,14,1,0,0,14,14
2012,2,14,1,1,0,6,6
2012,2,14,1,2,0,3,3
2012,2,14,1,3,0,3,3
2012,2,14,1,4,0,2,2
2012,2,14,1,5,2,19,21
2012,2,14,1,6,1,88,89
2012,2,14,1,7,4,276,280
2012,2,14,1,8,3,508,511
2012,2,14,1,9,6,255,261
2012,2,14,1,10,8,90,98
2012,2,14,1,11,3,107,110
2012,2,14,1,12,10,162,172
2012,2,14,1,13,6,166,172
2012,2,14,1,14,11,111,122
2012,2,14,1,15,7,138,145
2012,2,14,1,16,15,250,265
2012,2,14,1,17,19,504,523
2012,2,14,1,18,8,397,405
2012,2,14,1,19,11,269,280
2012,2,14,1,20,6,178,184
2012,2,14,1,21,4,105,109
2012,2,14,1,22,5,72,77
2012,2,14,1,23,2,55,57
2012,2,15,2,0,0,22,22
2012,2,15,2,1,0,5,5
2012,2,15,2,2,0,4,4
2012,2,15,2,3,0,3,3
2012,2,15,2,4,0,1,1
2012,2,15,2,5,0,25,25
2012,2,15,2,6,3,91,94
2012,2,15,2,7,3,317,320
2012,2,15,2,8,7,507,514
2012,2,15,2,9,5,226,231
2012,2,15,2,10,12,108,120
2012,2,15,2,11,13,125,138
2012,2,15,2,12,11,150,161
2012,2,15,2,13,11,159,170
2012,2,15,2,14,6,128,134
2012,2,15,2,15,7,163,170
2012,2,15,2,16,9,222,231
2012,2,15,2,17,17,469,486
2012,2,15,2,18,9,459,468
2012,2,15,2,19,9,301,310
2012,2,15,2,20,4,207,211
2012,2,15,2,21,8,169,177
2012,2,15,2,22,3,104,107
2012,2,15,2,23,4,54,58
2012,2,16,3,0,1,22,23
2012,2,16,3,1,0,5,5
2012,2,16,3,2,1,6,7
2012,2,16,3,3,0,1,1
2012,2,16,3,4,0,2,2
2012,2,16,3,5,0,20,20
2012,2,16,3,6,4,81,85
2012,2,16,3,7,3,285,288
2012,2,16,3,8,9,487,496
2012,2,16,3,9,3,199,202
2012,2,16,3,10,2,42,44
2012,2,16,3,11,2,69,71
2012,2,16,3,12,1,44,45
2012,2,16,3,13,2,62,64
2012,2,16,3,14,1,30,31
2012,2,16,3,15,3,50,53
2012,2,16,3,16,8,110,118
2012,2,16,3,17,8,281,289
2012,2,16,3,18,8,345,353
2012,2,16,3,19,4,254,258
2012,2,16,3,20,5,211,216
2012,2,16,3,21,3,142,145
2012,2,16,3,22,3,108,111
2012,2,16,3,23,3,70,73
2012,2,17,4,0,2,32,34
2012,2,17,4,1,2,16,18
2012,2,17,4,2,1,11,12
2012,2,17,4,3,0,1,1
2012,2,17,4,4,0,1,1
2012,2,17,4,5,0,16,16
2012,2,17,4,6,1,69,70
2012,2,17,4,7,4,222,226
2012,2,17,4,8,4,515,519
2012,2,17,4,9,8,274,282
2012,2,17,4,10,13,103,116
2012,2,17,4,11,9,132,141
2012,2,17,4,12,21,177,198
2012,2,17,4,13,34,170,204
2012,2,17,4,14,33,137,170
2012,2,17,4,15,41,180,221
2012,2,17,4,16,56,250,306
2012,2,17,4,17,36,429,465
2012,2,17,4,18,15,362,377
2012,2,17,4,19,16,264,280
2012,2,17,4,20,13,158,171
2012,2,17,4,21,15,113,128
2012,2,17,4,22,15,92,107
2012,2,17,4,23,10,72,82
2012,2,18,5,0,5,81,86
2012,2,18,5,1,7,38,45
2012,2,18,5,2,6,39,45
2012,2,18,5,3,3,15,18
2012,2,18,5,4,3,4,7
2012,2,18,5,5,0,1,1
2012,2,18,5,6,1,8,9
2012,2,18,5,7,8,33,41
2012,2,18,5,8,10,92,102
2012,2,18,5,9,22,116,138
2012,2,18,5,10,48,157,205
2012,2,18,5,11,102,184,286
2012,2,18,5,12,128,241,369
2012,2,18,5,13,165,219,384
2012,2,18,5,14,183,243,426
2012,2,18,5,15,229,270,499
2012,2,18,5,16,186,217,403
2012,2,18,5,17,142,222,364
2012,2,18,5,18,70,176,246
2012,2,18,5,19,38,150,188
2012,2,18,5,20,25,123,148
2012,2,18,5,21,25,89,114
2012,2,18,5,22,17,101,118
2012,2,18,5,23,12,62,74
2012,2,19,6,0,9,65,74
2012,2,19,6,1,10,62,72
2012,2,19,6,2,3,45,48
2012,2,19,6,3,3,12,15
2012,2,19,6,4,0,3,3
2012,2,19,6,5,1,1,2
2012,2,19,6,6,0,5,5
2012,2,19,6,7,2,12,14
2012,2,19,6,8,8,48,56
2012,2,19,6,9,20,73,93
2012,2,19,6,10,49,142,191
2012,2,19,6,11,82,144,226
2012,2,19,6,12,71,184,255
2012,2,19,6,13,64,197,261
2012,2,19,6,14,48,189,237
2012,2,19,6,15,85,168,253
2012,2,19,6,16,62,150,212
2012,2,19,6,17,22,135,157
2012,2,19,6,18,23,144,167
2012,2,19,6,19,18,101,119
2012,2,19,6,20,22,81,103
2012,2,19,6,21,3,33,36
2012,2,19,6,22,8,47,55
2012,2,19,6,23,5,30,35
2012,2,20,0,0,5,36,41
2012,2,20,0,1,3,12,15
2012,2,20,0,2,1,19,20
2012,2,20,0,3,0,8,8
2012,2,20,0,5,0,6,6
2012,2,20,0,6,1,9,10
2012,2,20,0,7,2,42,44
2012,2,20,0,8,9,111,120
2012,2,20,0,9,12,98,110
2012,2,20,0,10,30,112,142
2012,2,20,0,11,45,163,208
2012,2,20,0,12,65,216,281
2012,2,20,0,13,66,246,312
2012,2,20,0,14,57,206,263
2012,2,20,0,15,54,234,288
2012,2,20,0,16,64,216,280
2012,2,20,0,17,27,226,253
2012,2,20,0,18,27,215,242
2012,2,20,0,19,8,164,172
2012,2,20,0,20,9,117,126
2012,2,20,0,21,8,90,98
2012,2,20,0,22,9,53,62
2012,2,20,0,23,0,26,26
2012,2,21,1,0,1,11,12
2012,2,21,1,1,0,7,7
2012,2,21,1,2,0,3,3
2012,2,21,1,4,0,2,2
2012,2,21,1,5,0,15,15
2012,2,21,1,6,3,82,85
2012,2,21,1,7,6,271,277
2012,2,21,1,8,5,459,464
2012,2,21,1,9,6,211,217
2012,2,21,1,10,8,76,84
2012,2,21,1,11,5,81,86
2012,2,21,1,12,16,147,163
2012,2,21,1,13,8,123,131
2012,2,21,1,14,16,108,124
2012,2,21,1,15,23,137,160
2012,2,21,1,16,14,240,254
2012,2,21,1,17,21,411,432
2012,2,21,1,18,11,414,425
2012,2,21,1,19,5,299,304
2012,2,21,1,20,4,221,225
2012,2,21,1,21,7,147,154
2012,2,21,1,22,3,97,100
2012,2,21,1,23,1,46,47
2012,2,22,2,0,5,19,24
2012,2,22,2,1,3,4,7
2012,2,22,2,2,1,5,6
2012,2,22,2,3,1,3,4
2012,2,22,2,4,0,2,2
2012,2,22,2,5,1,29,30
2012,2,22,2,6,5,84,89
2012,2,22,2,7,10,292,302
2012,2,22,2,8,9,565,574
2012,2,22,2,9,11,241,252
2012,2,22,2,10,17,122,139
2012,2,22,2,11,22,147,169
2012,2,22,2,12,21,186,207
2012,2,22,2,13,15,175,190
2012,2,22,2,14,35,142,177
2012,2,22,2,15,34,161,195
2012,2,22,2,16,30,268,298
2012,2,22,2,17,43,486,529
2012,2,22,2,18,42,483,525
2012,2,22,2,19,22,305,327
2012,2,22,2,20,25,248,273
2012,2,22,2,21,19,220,239
2012,2,22,2,22,18,129,147
2012,2,22,2,23,5,57,62
2012,2,23,3,0,12,29,41
2012,2,23,3,1,3,12,15
2012,2,23,3,2,5,4,9
2012,2,23,3,3,2,4,6
2012,2,23,3,4,0,1,1
2012,2,23,3,5,2,30,32
2012,2,23,3,6,3,87,90
2012,2,23,3,7,9,316,325
2012,2,23,3,8,11,547,558
2012,2,23,3,9,14,226,240
2012,2,23,3,10,41,107,148
2012,2,23,3,11,54,128,182
2012,2,23,3,12,25,199,224
2012,2,23,3,13,30,188,218
2012,2,23,3,14,36,156,192
2012,2,23,3,15,46,170,216
2012,2,23,3,16,45,298,343
2012,2,23,3,17,49,561,610
2012,2,23,3,18,36,486,522
2012,2,23,3,19,20,347,367
2012,2,23,3,20,22,244,266
2012,2,23,3,21,17,204,221
2012,2,23,3,22,19,118,137
2012,2,23,3,23,14,71,85
2012,2,24,4,0,12,34,46
2012,2,24,4,1,3,15,18
2012,2,24,4,2,1,4,5
2012,2,24,4,3,0,5,5
2012,2,24,4,4,0,2,2
2012,2,24,4,5,1,25,26
2012,2,24,4,6,2,79,81
2012,2,24,4,7,7,263,270
2012,2,24,4,8,17,452,469
2012,2,24,4,9,15,229,244
2012,2,24,4,10,22,119,141
2012,2,24,4,11,27,136,163
2012,2,24,4,12,27,200,227
2012,2,24,4,13,30,152,182
2012,2,24,4,14,5,26,31
2012,2,24,4,15,11,83,94
2012,2,24,4,16,12,166,178
2012,2,24,4,17,14,242,256
2012,2,24,4,18,11,289,300
2012,2,24,4,19,6,227,233
2012,2,24,4,20,8,158,166
2012,2,24,4,21,1,150,151
2012,2,24,4,22,4,102,106
2012,2,24,4,23,10,76,86
2012,2,25,5,0,5,56,61
2012,2,25,5,1,4,42,46
2012,2,25,5,2,1,37,38
2012,2,25,5,3,0,7,7
2012,2,25,5,4,0,2,2
2012,2,25,5,5,0,3,3
2012,2,25,5,6,1,12,13
2012,2,25,5,7,3,20,23
2012,2,25,5,8,3,90,93
2012,2,25,5,9,15,107,122
2012,2,25,5,10,24,159,183
2012,2,25,5,11,23,187,210
2012,2,25,5,12,41,217,258
2012,2,25,5,13,48,178,226
2012,2,25,5,14,35,181,216
2012,2,25,5,15,21,211,232
2012,2,25,5,16,32,163,195
2012,2,25,5,17,16,143,159
2012,2,25,5,18,7,126,133
2012,2,25,5,19,12,137,149
2012,2,25,5,20,10,95,105
2012,2,25,5,21,5,80,85
2012,2,25,5,22,4,78,82
2012,2,25,5,23,7,84,91
2012,2,26,6,0,7,63,70
2012,2,26,6,1,5,50,55
2012,2,26,6,2,5,37,42
2012,2,26,6,3,0,21,21
2012,2,26,6,4,1,5,6
2012,2,26,6,5,0,5,5
2012,2,26,6,6,0,2,2
2012,2,26,6,7,2,20,22
2012,2,26,6,8,2,57,59
2012,2,26,6,9,11,76,87
2012,2,26,6,10,27,161,188
2012,2,26,6,11,43,184,227
2012,2,26,6,12,49,256,305
2012,2,26,6,13,58,267,325
2012,2,26,6,14,68,263,331
2012,2,26,6,15,72,281,353
2012,2,26,6,16,64,275,339
2012,2,26,6,17,46,241,287
2012,2,26,6,18,17,199,216
2012,2,26,6,19,13,130,143
2012,2,26,6,20,9,79,88
2012,2,26,6,21,8,75,83
2012,2,26,6,22,3,68,71
2012,2,26,6,23,5,59,64
2012,2,27,0,0,2,27,29
2012,2,27,0,1,0,6,6
2012,2,27,0,2,0,4,4
2012,2,27,0,3,0,2,2
2012,2,27,0,4,0,1,1
2012,2,27,0,5,0,16,16
2012,2,27,0,6,1,88,89
2012,2,27,0,7,2,278,280
2012,2,27,0,8,14,514,528
2012,2,27,0,9,11,218,229
2012,2,27,0,10,16,88,104
2012,2,27,0,11,11,92,103
2012,2,27,0,12,13,164,177
2012,2,27,0,13,23,159,182
2012,2,27,0,14,24,133,157
2012,2,27,0,15,24,150,174
2012,2,27,0,16,20,266,286
2012,2,27,0,17,26,502,528
2012,2,27,0,18,10,517,527
2012,2,27,0,19,16,317,333
2012,2,27,0,20,11,208,219
2012,2,27,0,21,14,181,195
2012,2,27,0,22,9,83,92
2012,2,27,0,23,6,50,56
2012,2,28,1,0,0,10,10
2012,2,28,1,1,0,6,6
2012,2,28,1,2,1,2,3
2012,2,28,1,3,0,6,6
2012,2,28,1,4,0,2,2
2012,2,28,1,5,1,19,20
2012,2,28,1,6,1,99,100
2012,2,28,1,7,12,313,325
2012,2,28,1,8,16,542,558
2012,2,28,1,9,7,225,232
2012,2,28,1,10,14,118,132
2012,2,28,1,11,8,155,163
2012,2,28,1,12,19,163,182
2012,2,28,1,13,16,174,190
2012,2,28,1,14,13,121,134
2012,2,28,1,15,17,148,165
2012,2,28,1,16,17,270,287
2012,2,28,1,17,33,496,529
2012,2,28,1,18,17,430,447
2012,2,28,1,19,15,291,306
2012,2,28,1,20,2,201,203
2012,2,28,1,21,10,177,187
2012,2,28,1,22,6,95,101
2012,2,28,1,23,4,61,65
2012,2,29,2,0,2,30,32
2012,2,29,2,1,0,6,6
2012,2,29,2,2,0,4,4
2012,2,29,2,3,0,2,2
2012,2,29,2,5,0,28,28
2012,2,29,2,6,4,99,103
2012,2,29,2,7,11,241,252
2012,2,29,2,8,2,113,115
2012,2,29,2,9,5,33,38
2012,2,29,2,10,0,10,10
2012,2,29,2,11,1,9,10
2012,2,29,2,12,1,69,70
2012,2,29,2,13,4,72,76
2012,2,29,2,14,2,54,56
2012,2,29,2,15,3,87,90
2012,2,29,2,16,5,161,166
2012,2,29,2,17,7,246,253
2012,2,29,2,18,11,181,192
2012,2,29,2,19,0,102,102
2012,2,29,2,20,2,95,97
2012,2,29,2,21,0,39,39
2012,2,29,2,22,2,53,55
2012,2,29,2,23,3,30,33
2012,3,1,3,0,1,10,11
2012,3,1,3,1,0,12,12
2012,3,1,3,2,0,6,6
2012,3,1,3,3,0,3,3
2012,3,1,3,4,0,5,5
2012,3,1,3,5,0,18,18
2012,3,1,3,6,2,106,108
2012,3,1,3,7,8,295,303
2012,3,1,3,8,15,577,592
2012,3,1,3,9,5,280,285
2012,3,1,3,10,11,122,133
2012,3,1,3,11,19,149,168
2012,3,1,3,12,16,203,219
2012,3,1,3,13,24,186,210
2012,3,1,3,14,37,173,210
2012,3,1,3,15,31,192,223
2012,3,1,3,16,38,323,361
2012,3,1,3,17,49,550,599
2012,3,1,3,18,27,498,525
2012,3,1,3,19,11,316,327
2012,3,1,3,20,12,241,253
2012,3,1,3,21,7,189,196
2012,3,1,3,22,3,123,126
2012,3,1,3,23,9,76,85
2012,3,2,4,0,1,44,45
2012,3,2,4,1,2,18,20
2012,3,2,4,2,2,4,6
2012,3,2,4,3,0,3,3
2012,3,2,4,4,0,2,2
2012,3,2,4,5,0,24,24
2012,3,2,4,6,4,88,92
2012,3,2,4,7,4,258,262
2012,3,2,4,8,16,532,548
2012,3,2,4,9,15,299,314
2012,3,2,4,10,13,117,130
2012,3,2,4,11,40,154,194
2012,3,2,4,12,40,194,234
2012,3,2,4,13,31,191,222
2012,3,2,4,14,29,176,205
2012,3,2,4,15,5,73,78
2012,3,2,4,16,1,49,50
2012,3,2,4,17,5,123,128
2012,3,2,4,18,6,154,160
2012,3,2,4,19,12,162,174
2012,3,2,4,20,7,93,100
2012,3,2,4,21,2,99,101
2012,3,2,4,22,6,69,75
2012,3,2,4,23,4,19,23
2012,3,3,5,0,1,21,22
2012,3,3,5,1,0,44,44
2012,3,3,5,2,4,34,38
2012,3,3,5,3,1,20,21
2012,3,3,5,4,0,2,2
2012,3,3,5,5,1,0,1
2012,3,3,5,6,1,6,7
2012,3,3,5,7,2,14,16
2012,3,3,5,8,2,46,48
2012,3,3,5,9,7,87,94
2012,3,3,5,10,31,136,167
2012,3,3,5,11,33,180,213
2012,3,3,5,12,47,251,298
2012,3,3,5,13,87,252,339
2012,3,3,5,14,151,279,430
2012,3,3,5,15,145,253,398
2012,3,3,5,16,167,300,467
2012,3,3,5,17,106,279,385
2012,3,3,5,18,53,250,303
2012,3,3,5,19,34,191,225
2012,3,3,5,20,28,121,149
2012,3,3,5,21,24,130,154
2012,3,3,5,22,19,115,134
2012,3,3,5,23,12,94,106
2012,3,4,6,0,5,67,72
2012,3,4,6,1,16,60,76
2012,3,4,6,2,14,66,80
2012,3,4,6,3,5,21,26
2012,3,4,6,4,3,11,14
2012,3,4,6,5,0,5,5
2012,3,4,6,6,0,5,5
2012,3,4,6,7,2,21,23
2012,3,4,6,8,12,54,66
2012,3,4,6,9,14,103,117
2012,3,4,6,10,31,161,192
2012,3,4,6,11,64,192,256
2012,3,4,6,12,71,256,327
2012,3,4,6,13,108,256,364
2012,3,4,6,14,106,226,332
2012,3,4,6,15,82,251,333
2012,3,4,6,16,68,231,299
2012,3,4,6,17,49,212,261
2012,3,4,6,18,20,164,184
2012,3,4,6,19,12,119,131
2012,3,4,6,20,8,80,88
2012,3,4,6,21,9,70,79
2012,3,4,6,22,9,53,62
2012,3,4,6,23,2,24,26
2012,3,5,0,0,2,15,17
2012,3,5,0,1,3,3,6
2012,3,5,0,2,1,3,4
2012,3,5,0,3,0,1,1
2012,3,5,0,4,0,1,1
2012,3,5,0,5,1,17,18
2012,3,5,0,6,2,89,91
2012,3,5,0,7,7,252,259
2012,3,5,0,8,13,415,428
2012,3,5,0,9,11,185,196
2012,3,5,0,10,12,74,86
2012,3,5,0,11,17,86,103
2012,3,5,0,12,15,122,137
2012,3,5,0,13,11,109,120
2012,3,5,0,14,13,115,128
2012,3,5,0,15,20,110,130
2012,3,5,0,16,30,180,210
2012,3,5,0,17,11,376,387
2012,3,5,0,18,12,363,375
2012,3,5,0,19,6,220,226
2012,3,5,0,20,8,171,179
2012,3,5,0,21,4,116,120
2012,3,5,0,22,2,76,78
2012,3,5,0,23,2,29,31
2012,3,6,1,0,0,6,6
2012,3,6,1,1,0,6,6
2012,3,6,1,2,0,4,4
2012,3,6,1,3,0,1,1
2012,3,6,1,4,0,3,3
2012,3,6,1,5,0,25,25
2012,3,6,1,6,3,99,102
2012,3,6,1,7,5,269,274
2012,3,6,1,8,14,486,500
2012,3,6,1,9,11,222,233
2012,3,6,1,10,16,113,129
2012,3,6,1,11,20,110,130
2012,3,6,1,12,9,129,138
2012,3,6,1,13,16,148,164
2012,3,6,1,14,20,116,136
2012,3,6,1,15,24,142,166
2012,3,6,1,16,22,226,248
2012,3,6,1,17,21,425,446
2012,3,6,1,18,14,440,454
2012,3,6,1,19,9,278,287
2012,3,6,1,20,3,183,186
2012,3,6,1,21,5,143,148
2012,3,6,1,22,5,101,106
2012,3,6,1,23,3,51,54
2012,3,7,2,0,3,12,15
2012,3,7,2,1,1,4,5
2012,3,7,2,2,0,4,4
2012,3,7,2,3,1,2,3
2012,3,7,2,4,0,3,3
2012,3,7,2,5,0,18,18
2012,3,7,2,6,4,103,107
2012,3,7,2,7,12,331,343
2012,3,7,2,8,12,553,565
2012,3,7,2,9,12,251,263
2012,3,7,2,10,20,126,146
2012,3,7,2,11,33,128,161
2012,3,7,2,12,40,175,215
2012,3,7,2,13,26,178,204
2012,3,7,2,14,38,137,175
2012,3,7,2,15,44,164,208
2012,3,7,2,16,34,254,288
2012,3,7,2,17,58,554,612
2012,3,7,2,18,35,509,544
2012,3,7,2,19,16,344,360
2012,3,7,2,20,18,242,260
2012,3,7,2,21,11,177,188
2012,3,7,2,22,10,148,158
2012,3,7,2,23,4,58,62
2012,3,8,3,0,11,35,46
2012,3,8,3,1,4,17,21
2012,3,8,3,2,6,5,11
2012,3,8,3,3,0,3,3
2012,3,8,3,4,0,2,2
2012,3,8,3,5,1,27,28
2012,3,8,3,6,4,105,109
2012,3,8,3,7,8,325,333
2012,3,8,3,8,12,572,584
2012,3,8,3,9,19,280,299
2012,3,8,3,10,19,119,138
2012,3,8,3,11,48,156,204
2012,3,8,3,12,27,224,251
2012,3,8,3,13,35,198,233
2012,3,8,3,14,48,155,203
2012,3,8,3,15,24,161,185
2012,3,8,3,16,37,305,342
2012,3,8,3,17,52,545,597
2012,3,8,3,18,45,545,590
2012,3,8,3,19,21,395,416
2012,3,8,3,20,20,279,299
2012,3,8,3,21,27,206,233
2012,3,8,3,22,12,141,153
2012,3,8,3,23,6,88,94
2012,3,9,4,0,3,51,54
2012,3,9,4,1,4,22,26
2012,3,9,4,2,2,9,11
2012,3,9,4,3,0,7,7
2012,3,9,4,4,0,1,1
2012,3,9,4,5,2,26,28
2012,3,9,4,6,2,83,85
2012,3,9,4,7,6,261,267
2012,3,9,4,8,17,483,500
2012,3,9,4,9,17,267,284
2012,3,9,4,10,14,144,158
2012,3,9,4,11,17,170,187
2012,3,9,4,12,27,174,201
2012,3,9,4,13,49,175,224
2012,3,9,4,14,49,129,178
2012,3,9,4,15,50,188,238
2012,3,9,4,16,51,291,342
2012,3,9,4,17,68,497,565
2012,3,9,4,18,30,440,470
2012,3,9,4,19,12,231,243
2012,3,9,4,20,3,156,159
2012,3,9,4,21,8,132,140
2012,3,9,4,22,7,100,107
2012,3,9,4,23,9,77,86
2012,3,10,5,0,9,68,77
2012,3,10,5,1,1,50,51
2012,3,10,5,2,12,30,42
2012,3,10,5,3,0,16,16
2012,3,10,5,4,1,3,4
2012,3,10,5,5,3,7,10
2012,3,10,5,6,1,11,12
2012,3,10,5,7,4,36,40
2012,3,10,5,8,15,96,111
2012,3,10,5,9,21,127,148
2012,3,10,5,10,47,176,223
2012,3,10,5,11,56,218,274
2012,3,10,5,12,88,241,329
2012,3,10,5,13,89,267,356
2012,3,10,5,14,117,262,379
2012,3,10,5,15,132,274,406
2012,3,10,5,16,115,274,389
2012,3,10,5,17,104,250,354
2012,3,10,5,18,67,230,297
2012,3,10,5,19,25,159,184
2012,3,10,5,20,20,101,121
2012,3,10,5,21,16,94,110
2012,3,10,5,22,19,81,100
2012,3,10,5,23,6,77,83
2012,3,11,6,0,7,62,69
2012,3,11,6,1,4,57,61
2012,3,11,6,3,15,51,66
2012,3,11,6,4,7,15,22
2012,3,11,6,5,2,4,6
2012,3,11,6,6,2,8,10
2012,3,11,6,7,2,15,17
2012,3,11,6,8,4,68,72
2012,3,11,6,9,20,70,90
2012,3,11,6,10,71,147,218
2012,3,11,6,11,90,209,299
2012,3,11,6,12,146,264,410
2012,3,11,6,13,176,288,464
2012,3,11,6,14,212,289,501
2012,3,11,6,15,201,285,486
2012,3,11,6,16,208,300,508
2012,3,11,6,17,199,297,496
2012,3,11,6,18,133,256,389
2012,3,11,6,19,55,203,258
2012,3,11,6,20,42,129,171
2012,3,11,6,21,37,110,147
2012,3,11,6,22,13,81,94
2012,3,11,6,23,12,40,52
2012,3,12,0,0,4,20,24
2012,3,12,0,1,1,9,10
2012,3,12,0,2,4,5,9
2012,3,12,0,3,0,2,2
2012,3,12,0,4,0,2,2
2012,3,12,0,5,1,15,16
2012,3,12,0,6,2,85,87
2012,3,12,0,7,9,258,267
2012,3,12,0,8,17,547,564
2012,3,12,0,9,21,260,281
2012,3,12,0,10,39,96,135
2012,3,12,0,11,39,111,150
2012,3,12,0,12,59,162,221
2012,3,12,0,13,74,176,250
2012,3,12,0,14,76,145,221
2012,3,12,0,15,74,158,232
2012,3,12,0,16,77,255,332
2012,3,12,0,17,87,557,644
2012,3,12,0,18,89,622,711
2012,3,12,0,19,67,379,446
2012,3,12,0,20,49,236,285
2012,3,12,0,21,22,183,205
2012,3,12,0,22,17,116,133
2012,3,12,0,23,10,53,63
2012,3,13,1,0,5,21,26
2012,3,13,1,1,2,14,16
2012,3,13,1,2,0,1,1
2012,3,13,1,3,0,2,2
2012,3,13,1,5,0,24,24
2012,3,13,1,6,5,106,111
2012,3,13,1,7,16,292,308
2012,3,13,1,8,22,570,592
2012,3,13,1,9,18,323,341
2012,3,13,1,10,28,115,143
2012,3,13,1,11,64,155,219
2012,3,13,1,12,47,197,244
2012,3,13,1,13,53,180,233
2012,3,13,1,14,52,159,211
2012,3,13,1,15,68,196,264
2012,3,13,1,16,53,311,364
2012,3,13,1,17,62,612,674
2012,3,13,1,18,95,638,733
2012,3,13,1,19,50,427,477
2012,3,13,1,20,45,306,351
2012,3,13,1,21,44,200,244
2012,3,13,1,22,24,145,169
2012,3,13,1,23,8,78,86
2012,3,14,2,0,5,34,39
2012,3,14,2,1,2,25,27
2012,3,14,2,2,0,2,2
2012,3,14,2,3,1,3,4
2012,3,14,2,4,1,4,5
2012,3,14,2,5,2,25,27
2012,3,14,2,6,1,119,120
2012,3,14,2,7,20,348,368
2012,3,14,2,8,34,627,661
2012,3,14,2,9,26,325,351
2012,3,14,2,10,38,150,188
2012,3,14,2,11,65,155,220
2012,3,14,2,12,55,212,267
2012,3,14,2,13,57,197,254
2012,3,14,2,14,61,163,224
2012,3,14,2,15,86,195,281
2012,3,14,2,16,78,277,355
2012,3,14,2,17,140,642,782
2012,3,14,2,18,102,645,747
2012,3,14,2,19,70,402,472
2012,3,14,2,20,44,286,330
2012,3,14,2,21,47,241,288
2012,3,14,2,22,43,159,202
2012,3,14,2,23,19,72,91
2012,3,15,3,0,14,46,60
2012,3,15,3,1,15,8,23
2012,3,15,3,2,14,5,19
2012,3,15,3,3,0,7,7
2012,3,15,3,4,11,3,14
2012,3,15,3,5,2,24,26
2012,3,15,3,6,4,112,116
2012,3,15,3,7,14,365,379
2012,3,15,3,8,21,601,622
2012,3,15,3,9,30,284,314
2012,3,15,3,10,34,130,164
2012,3,15,3,11,60,151,211
2012,3,15,3,12,59,205,264
2012,3,15,3,13,62,211,273
2012,3,15,3,14,81,177,258
2012,3,15,3,15,100,187,287
2012,3,15,3,16,95,331,426
2012,3,15,3,17,79,634,713
2012,3,15,3,18,98,647,745
2012,3,15,3,19,72,352,424
2012,3,15,3,20,60,270,330
2012,3,15,3,21,36,206,242
2012,3,15,3,22,32,137,169
2012,3,15,3,23,12,85,97
2012,3,16,4,0,8,49,57
2012,3,16,4,1,4,22,26
2012,3,16,4,2,0,4,4
2012,3,16,4,3,0,3,3
2012,3,16,4,4,0,2,2
2012,3,16,4,5,2,30,32
2012,3,16,4,6,3,96,99
2012,3,16,4,7,13,264,277
2012,3,16,4,8,28,533,561
2012,3,16,4,9,35,277,312
2012,3,16,4,10,44,135,179
2012,3,16,4,11,40,166,206
2012,3,16,4,12,72,222,294
2012,3,16,4,13,52,207,259
2012,3,16,4,14,56,145,201
2012,3,16,4,15,19,87,106
2012,3,16,4,16,18,111,129
2012,3,16,4,17,23,235,258
2012,3,16,4,18,31,376,407
2012,3,16,4,19,23,272,295
2012,3,16,4,20,31,204,235
2012,3,16,4,21,8,144,152
2012,3,16,4,22,16,132,148
2012,3,16,4,23,22,104,126
2012,3,17,5,0,13,87,100
2012,3,17,5,1,12,57,69
2012,3,17,5,2,10,32,42
2012,3,17,5,3,2,24,26
2012,3,17,5,4,0,1,1
2012,3,17,5,5,5,3,8
2012,3,17,5,6,1,29,30
2012,3,17,5,7,29,57,86
2012,3,17,5,8,63,154,217
2012,3,17,5,9,104,217,321
2012,3,17,5,10,140,303,443
2012,3,17,5,11,226,359,585
2012,3,17,5,12,286,365,651
2012,3,17,5,13,286,400,686
2012,3,17,5,14,352,338,690
2012,3,17,5,15,357,322,679
2012,3,17,5,16,367,318,685
2012,3,17,5,17,291,356,647
2012,3,17,5,18,221,339,560
2012,3,17,5,19,155,262,417
2012,3,17,5,20,89,181,270
2012,3,17,5,21,54,169,223
2012,3,17,5,22,58,153,211
2012,3,17,5,23,34,151,185
2012,3,18,6,0,27,80,107
2012,3,18,6,1,25,88,113
2012,3,18,6,2,15,41,56
2012,3,18,6,3,3,15,18
2012,3,18,6,4,6,8,14
2012,3,18,6,5,0,5,5
2012,3,18,6,6,2,9,11
2012,3,18,6,7,17,25,42
2012,3,18,6,8,25,71,96
2012,3,18,6,9,65,113,178
2012,3,18,6,10,139,212,351
2012,3,18,6,11,129,238,367
2012,3,18,6,12,222,281,503
2012,3,18,6,13,198,346,544
2012,3,18,6,14,218,303,521
2012,3,18,6,15,240,314,554
2012,3,18,6,16,229,312,541
2012,3,18,6,17,233,308,541
2012,3,18,6,18,165,294,459
2012,3,18,6,19,118,234,352
2012,3,18,6,20,59,139,198
2012,3,18,6,21,44,129,173
2012,3,18,6,22,21,79,100
2012,3,18,6,23,7,39,46
2012,3,19,0,0,4,19,23
2012,3,19,0,1,0,15,15
2012,3,19,0,2,1,7,8
2012,3,19,0,3,0,2,2
2012,3,19,0,4,0,3,3
2012,3,19,0,5,0,31,31
2012,3,19,0,6,2,118,120
2012,3,19,0,7,25,329,354
2012,3,19,0,8,16,562,578
2012,3,19,0,9,55,276,331
2012,3,19,0,10,56,127,183
2012,3,19,0,11,56,144,200
2012,3,19,0,12,71,210,281
2012,3,19,0,13,69,194,263
2012,3,19,0,14,60,200,260
2012,3,19,0,15,97,189,286
2012,3,19,0,16,65,319,384
2012,3,19,0,17,106,615,721
2012,3,19,0,18,120,681,801
2012,3,19,0,19,86,463,549
2012,3,19,0,20,34,295,329
2012,3,19,0,21,33,189,222
2012,3,19,0,22,17,131,148
2012,3,19,0,23,9,45,54
2012,3,20,1,0,5,24,29
2012,3,20,1,1,6,9,15
2012,3,20,1,2,2,8,10
2012,3,20,1,3,0,3,3
2012,3,20,1,4,0,6,6
2012,3,20,1,5,0,20,20
2012,3,20,1,6,6,94,100
2012,3,20,1,7,3,167,170
2012,3,20,1,8,28,488,516
2012,3,20,1,9,41,283,324
2012,3,20,1,10,44,119,163
2012,3,20,1,11,74,156,230
2012,3,20,1,12,56,205,261
2012,3,20,1,13,77,207,284
2012,3,20,1,14,66,182,248
2012,3,20,1,15,67,177,244
2012,3,20,1,16,99,332,431
2012,3,20,1,17,108,641,749
2012,3,20,1,18,136,664,800
2012,3,20,1,19,75,479,554
2012,3,20,1,20,78,298,376
2012,3,20,1,21,38,239,277
2012,3,20,1,22,32,156,188
2012,3,20,1,23,10,80,90
2012,3,21,2,0,4,28,32
2012,3,21,2,1,4,22,26
2012,3,21,2,2,2,8,10
2012,3,21,2,3,1,7,8
2012,3,21,2,4,0,3,3
2012,3,21,2,5,4,35,39
2012,3,21,2,6,10,139,149
2012,3,21,2,7,34,337,371
2012,3,21,2,8,33,502,535
2012,3,21,2,9,38,254,292
2012,3,21,2,10,30,124,154
2012,3,21,2,11,38,154,192
2012,3,21,2,12,58,171,229
2012,3,21,2,13,81,222,303
2012,3,21,2,14,74,151,225
2012,3,21,2,15,67,175,242
2012,3,21,2,16,91,287,378
2012,3,21,2,17,113,616,729
2012,3,21,2,18,152,625,777
2012,3,21,2,19,86,496,582
2012,3,21,2,20,76,296,372
2012,3,21,2,21,47,204,251
2012,3,21,2,22,41,156,197
2012,3,21,2,23,37,88,125
2012,3,22,3,0,9,32,41
2012,3,22,3,1,14,16,30
2012,3,22,3,2,1,5,6
2012,3,22,3,3,0,7,7
2012,3,22,3,4,0,5,5
2012,3,22,3,5,2,32,34
2012,3,22,3,6,10,126,136
2012,3,22,3,7,29,332,361
2012,3,22,3,8,51,597,648
2012,3,22,3,9,41,275,316
2012,3,22,3,10,32,110,142
2012,3,22,3,11,53,165,218
2012,3,22,3,12,48,224,272
2012,3,22,3,13,83,213,296
2012,3,22,3,14,96,161,257
2012,3,22,3,15,102,201,303
2012,3,22,3,16,125,300,425
2012,3,22,3,17,154,656,810
2012,3,22,3,18,147,652,799
2012,3,22,3,19,117,467,584
2012,3,22,3,20,64,360,424
2012,3,22,3,21,66,308,374
2012,3,22,3,22,56,164,220
2012,3,22,3,23,34,117,151
2012,3,23,4,0,30,65,95
2012,3,23,4,1,18,32,50
2012,3,23,4,2,12,20,32
2012,3,23,4,3,4,6,10
2012,3,23,4,4,0,3,3
2012,3,23,4,5,5,29,34
2012,3,23,4,6,6,110,116
2012,3,23,4,7,27,318,345
2012,3,23,4,8,47,614,661
2012,3,23,4,9,75,302,377
2012,3,23,4,10,125,150,275
2012,3,23,4,11,131,186,317
2012,3,23,4,12,199,271,470
2012,3,23,4,13,172,256,428
2012,3,23,4,14,208,222,430
2012,3,23,4,15,191,281,472
2012,3,23,4,16,219,370,589
2012,3,23,4,17,263,693,956
2012,3,23,4,18,237,593,830
2012,3,23,4,19,213,472,685
2012,3,23,4,20,117,328,445
2012,3,23,4,21,64,220,284
2012,3,23,4,22,53,218,271
2012,3,23,4,23,51,125,176
2012,3,24,5,0,45,111,156
2012,3,24,5,1,20,108,128
2012,3,24,5,2,14,55,69
2012,3,24,5,3,10,22,32
2012,3,24,5,4,1,6,7
2012,3,24,5,5,0,4,4
2012,3,24,5,6,4,23,27
2012,3,24,5,7,25,45,70
2012,3,24,5,8,41,113,154
2012,3,24,5,9,96,153,249
2012,3,24,5,10,148,196,344
2012,3,24,5,11,98,175,273
2012,3,24,5,12,61,122,183
2012,3,24,5,13,62,134,196
2012,3,24,5,14,63,158,221
2012,3,24,5,15,118,172,290
2012,3,24,5,16,49,128,177
2012,3,24,5,17,47,67,114
2012,3,24,5,18,27,110,137
2012,3,24,5,19,28,105,133
2012,3,24,5,20,31,80,111
2012,3,24,5,21,16,88,104
2012,3,24,5,22,12,71,83
2012,3,24,5,23,17,88,105
2012,3,25,6,0,18,62,80
2012,3,25,6,1,24,65,89
2012,3,25,6,2,6,29,35
2012,3,25,6,3,8,10,18
2012,3,25,6,4,1,7,8
2012,3,25,6,5,0,6,6
2012,3,25,6,6,5,13,18
2012,3,25,6,7,14,25,39
2012,3,25,6,8,21,68,89
2012,3,25,6,9,26,92,118
2012,3,25,6,10,78,172,250
2012,3,25,6,11,106,217,323
2012,3,25,6,12,122,238,360
2012,3,25,6,13,110,257,367
2012,3,25,6,14,123,291,414
2012,3,25,6,15,139,281,420
2012,3,25,6,16,153,339,492
2012,3,25,6,17,146,272,418
2012,3,25,6,18,202,288,490
2012,3,25,6,19,114,261,375
2012,3,25,6,20,63,196,259
2012,3,25,6,21,25,124,149
2012,3,25,6,22,19,92,111
2012,3,25,6,23,9,56,65
2012,3,26,0,0,10,23,33
2012,3,26,0,1,18,10,28
2012,3,26,0,2,14,6,20
2012,3,26,0,3,0,1,1
2012,3,26,0,4,0,4,4
2012,3,26,0,5,0,36,36
2012,3,26,0,6,7,110,117
2012,3,26,0,7,15,355,370
2012,3,26,0,8,32,624,656
2012,3,26,0,9,37,244,281
2012,3,26,0,10,55,96,151
2012,3,26,0,11,47,131,178
2012,3,26,0,12,63,216,279
2012,3,26,0,13,79,222,301
2012,3,26,0,14,58,159,217
2012,3,26,0,15,66,156,222
2012,3,26,0,16,60,243,303
2012,3,26,0,17,65,599,664
2012,3,26,0,18,90,592,682
2012,3,26,0,19,41,417,458
2012,3,26,0,20,12,209,221
2012,3,26,0,21,11,175,186
2012,3,26,0,22,13,80,93
2012,3,26,0,23,2,46,48
2012,3,27,1,0,1,9,10
2012,3,27,1,1,1,4,5
2012,3,27,1,2,1,6,7
2012,3,27,1,3,0,4,4
2012,3,27,1,4,0,3,3
2012,3,27,1,5,1,16,17
2012,3,27,1,6,5,96,101
2012,3,27,1,7,9,276,285
2012,3,27,1,8,14,567,581
2012,3,27,1,9,8,259,267
2012,3,27,1,10,20,118,138
2012,3,27,1,11,34,140,174
2012,3,27,1,12,34,186,220
2012,3,27,1,13,46,164,210
2012,3,27,1,14,37,147,184
2012,3,27,1,15,42,157,199
2012,3,27,1,16,38,266,304
2012,3,27,1,17,72,542,614
2012,3,27,1,18,67,576,643
2012,3,27,1,19,40,376,416
2012,3,27,1,20,28,265,293
2012,3,27,1,21,21,200,221
2012,3,27,1,22,7,127,134
2012,3,27,1,23,5,58,63
2012,3,28,2,0,1,29,30
2012,3,28,2,1,0,8,8
2012,3,28,2,2,0,3,3
2012,3,28,2,3,1,4,5
2012,3,28,2,4,1,0,1
2012,3,28,2,5,2,38,40
2012,3,28,2,6,4,111,115
2012,3,28,2,7,10,348,358
2012,3,28,2,8,19,636,655
2012,3,28,2,9,16,298,314
2012,3,28,2,10,33,140,173
2012,3,28,2,11,54,167,221
2012,3,28,2,12,50,218,268
2012,3,28,2,13,60,213,273
2012,3,28,2,14,52,169,221
2012,3,28,2,15,47,152,199
2012,3,28,2,16,51,170,221
2012,3,28,2,17,72,532,604
2012,3,28,2,18,61,580,641
2012,3,28,2,19,41,415,456
2012,3,28,2,20,38,322,360
2012,3,28,2,21,28,233,261
2012,3,28,2,22,21,151,172
2012,3,28,2,23,12,81,93
2012,3,29,3,0,10,38,48
2012,3,29,3,1,15,18,33
2012,3,29,3,2,0,6,6
2012,3,29,3,3,1,4,5
2012,3,29,3,4,1,8,9
2012,3,29,3,5,2,30,32
2012,3,29,3,6,3,114,117
2012,3,29,3,7,14,353,367
2012,3,29,3,8,26,627,653
2012,3,29,3,9,22,298,320
2012,3,29,3,10,42,124,166
2012,3,29,3,11,54,166,220
2012,3,29,3,12,64,228,292
2012,3,29,3,13,50,223,273
2012,3,29,3,14,63,175,238
2012,3,29,3,15,109,198,307
2012,3,29,3,16,67,321,388
2012,3,29,3,17,83,618,701
2012,3,29,3,18,83,597,680
2012,3,29,3,19,47,420,467
2012,3,29,3,20,34,300,334
2012,3,29,3,21,10,214,224
2012,3,29,3,22,17,135,152
2012,3,29,3,23,17,77,94
2012,3,30,4,0,10,48,58
2012,3,30,4,1,6,21,27
2012,3,30,4,2,1,6,7
2012,3,30,4,3,0,7,7
2012,3,30,4,4,1,1,2
2012,3,30,4,5,0,26,26
2012,3,30,4,6,5,81,86
2012,3,30,4,7,9,279,288
2012,3,30,4,8,38,552,590
2012,3,30,4,9,29,292,321
2012,3,30,4,10,50,137,187
2012,3,30,4,11,48,153,201
2012,3,30,4,12,59,208,267
2012,3,30,4,13,42,198,240
2012,3,30,4,14,56,173,229
2012,3,30,4,15,73,207,280
2012,3,30,4,16,75,292,367
2012,3,30,4,17,93,512,605
2012,3,30,4,18,68,492,560
2012,3,30,4,19,42,353,395
2012,3,30,4,20,17,192,209
2012,3,30,4,21,30,190,220
2012,3,30,4,22,23,129,152
2012,3,30,4,23,16,107,123
2012,3,31,5,0,12,80,92
2012,3,31,5,1,17,65,82
2012,3,31,5,2,14,55,69
2012,3,31,5,3,10,21,31
2012,3,31,5,4,4,4,8
2012,3,31,5,5,0,5,5
2012,3,31,5,6,7,16,23
2012,3,31,5,7,5,39,44
2012,3,31,5,8,19,126,145
2012,3,31,5,9,62,161,223
2012,3,31,5,10,108,205,313
2012,3,31,5,11,184,279,463
2012,3,31,5,12,263,358,621
2012,3,31,5,13,265,372,637
2012,3,31,5,14,240,311,551
2012,3,31,5,15,275,330,605
2012,3,31,5,16,243,292,535
2012,3,31,5,17,238,305,543
2012,3,31,5,18,102,238,340
2012,3,31,5,19,93,191,284
2012,3,31,5,20,52,156,208
2012,3,31,5,21,36,107,143
2012,3,31,5,22,40,116,156
2012,3,31,5,23,12,100,112
2012,4,1,6,0,8,59,67
2012,4,1,6,1,13,49,62
2012,4,1,6,2,20,61,81
2012,4,1,6,3,4,21,25
2012,4,1,6,4,3,9,12
2012,4,1,6,5,8,10,18
2012,4,1,6,6,9,87,96
2012,4,1,6,7,29,55,84
2012,4,1,6,8,37,88,125
2012,4,1,6,9,102,173,275
2012,4,1,6,10,132,228,360
2012,4,1,6,11,180,270,450
2012,4,1,6,12,187,258,445
2012,4,1,6,13,190,274,464
2012,4,1,6,14,283,278,561
2012,4,1,6,15,295,278,573
2012,4,1,6,16,236,275,511
2012,4,1,6,17,232,323,555
2012,4,1,6,18,153,278,431
2012,4,1,6,19,110,236,346
2012,4,1,6,20,66,166,232
2012,4,1,6,21,33,101,134
2012,4,1,6,22,7,61,68
2012,4,1,6,23,10,53,63
2012,4,2,0,0,6,11,17
2012,4,2,0,1,0,5,5
2012,4,2,0,2,2,3,5
2012,4,2,0,4,2,2,4
2012,4,2,0,5,2,22,24
2012,4,2,0,6,6,104,110
2012,4,2,0,7,12,292,304
2012,4,2,0,8,36,549,585
2012,4,2,0,9,52,265,317
2012,4,2,0,10,85,118,203
2012,4,2,0,11,81,128,209
2012,4,2,0,12,100,181,281
2012,4,2,0,13,97,184,281
2012,4,2,0,14,127,141,268
2012,4,2,0,15,132,191,323
2012,4,2,0,16,104,291,395
2012,4,2,0,17,128,601,729
2012,4,2,0,18,75,541,616
2012,4,2,0,19,66,427,493
2012,4,2,0,20,48,278,326
2012,4,2,0,21,24,212,236
2012,4,2,0,22,17,106,123
2012,4,2,0,23,6,60,66
2012,4,3,1,0,1,32,33
2012,4,3,1,1,0,11,11
2012,4,3,1,2,0,5,5
2012,4,3,1,3,0,3,3
2012,4,3,1,4,0,1,1
2012,4,3,1,5,2,25,27
2012,4,3,1,6,2,98,100
2012,4,3,1,7,14,323,337
2012,4,3,1,8,27,576,603
2012,4,3,1,9,54,354,408
2012,4,3,1,10,77,140,217
2012,4,3,1,11,91,167,258
2012,4,3,1,12,101,230,331
2012,4,3,1,13,120,225,345
2012,4,3,1,14,120,191,311
2012,4,3,1,15,109,206,315
2012,4,3,1,16,145,338,483
2012,4,3,1,17,123,634,757
2012,4,3,1,18,139,660,799
2012,4,3,1,19,98,460,558
2012,4,3,1,20,54,323,377
2012,4,3,1,21,33,210,243
2012,4,3,1,22,25,132,157
2012,4,3,1,23,13,65,78
2012,4,4,2,0,18,23,41
2012,4,4,2,1,0,11,11
2012,4,4,2,2,0,5,5
2012,4,4,2,3,0,3,3
2012,4,4,2,4,0,1,1
2012,4,4,2,5,0,27,27
2012,4,4,2,6,6,120,126
2012,4,4,2,7,12,350,362
2012,4,4,2,8,31,651,682
2012,4,4,2,9,47,316,363
2012,4,4,2,10,68,99,167
2012,4,4,2,11,61,150,211
2012,4,4,2,12,73,210,283
2012,4,4,2,13,70,181,251
2012,4,4,2,14,82,174,256
2012,4,4,2,15,86,182,268
2012,4,4,2,16,86,304,390
2012,4,4,2,17,99,644,743
2012,4,4,2,18,113,645,758
2012,4,4,2,19,75,419,494
2012,4,4,2,20,39,332,371
2012,4,4,2,21,43,253,296
2012,4,4,2,22,30,150,180
2012,4,4,2,23,19,111,130
2012,4,5,3,0,12,33,45
2012,4,5,3,1,4,9,13
2012,4,5,3,2,7,11,18
2012,4,5,3,3,0,5,5
2012,4,5,3,4,0,1,1
2012,4,5,3,5,1,28,29
2012,4,5,3,6,8,118,126
2012,4,5,3,7,15,339,354
2012,4,5,3,8,28,605,633
2012,4,5,3,9,61,289,350
2012,4,5,3,10,88,158,246
2012,4,5,3,11,109,159,268
2012,4,5,3,12,66,209,275
2012,4,5,3,13,89,201,290
2012,4,5,3,14,143,144,287
2012,4,5,3,15,98,171,269
2012,4,5,3,16,84,318,402
2012,4,5,3,17,145,676,821
2012,4,5,3,18,80,614,694
2012,4,5,3,19,64,423,487
2012,4,5,3,20,33,278,311
2012,4,5,3,21,25,207,232
2012,4,5,3,22,20,129,149
2012,4,5,3,23,12,124,136
2012,4,6,4,0,12,49,61
2012,4,6,4,1,10,28,38
2012,4,6,4,2,6,5,11
2012,4,6,4,3,3,5,8
2012,4,6,4,4,2,3,5
2012,4,6,4,5,0,23,23
2012,4,6,4,6,0,80,80
2012,4,6,4,7,15,230,245
2012,4,6,4,8,19,488,507
2012,4,6,4,9,58,318,376
2012,4,6,4,10,81,157,238
2012,4,6,4,11,112,179,291
2012,4,6,4,12,113,223,336
2012,4,6,4,13,173,237,410
2012,4,6,4,14,240,249,489
2012,4,6,4,15,218,319,537
2012,4,6,4,16,184,352,536
2012,4,6,4,17,172,482,654
2012,4,6,4,18,104,379,483
2012,4,6,4,19,115,297,412
2012,4,6,4,20,61,191,252
2012,4,6,4,21,54,136,190
2012,4,6,4,22,34,124,158
2012,4,6,4,23,21,92,113
2012,4,7,5,0,9,85,94
2012,4,7,5,1,9,60,69
2012,4,7,5,2,11,25,36
2012,4,7,5,3,7,21,28
2012,4,7,5,4,3,4,7
2012,4,7,5,5,0,2,2
2012,4,7,5,6,1,18,19
2012,4,7,5,7,14,40,54
2012,4,7,5,8,29,94,123
2012,4,7,5,9,103,173,276
2012,4,7,5,10,187,176,363
2012,4,7,5,11,251,244,495
2012,4,7,5,12,320,270,590
2012,4,7,5,13,355,287,642
2012,4,7,5,14,326,252,578
2012,4,7,5,15,321,305,626
2012,4,7,5,16,354,260,614
2012,4,7,5,17,299,268,567
2012,4,7,5,18,227,290,517
2012,4,7,5,19,170,243,413
2012,4,7,5,20,73,135,208
2012,4,7,5,21,75,159,234
2012,4,7,5,22,76,106,182
2012,4,7,5,23,32,86,118
2012,4,8,6,0,21,64,85
2012,4,8,6,1,14,50,64
2012,4,8,6,2,7,25,32
2012,4,8,6,3,8,18,26
2012,4,8,6,4,0,7,7
2012,4,8,6,5,4,8,12
2012,4,8,6,6,7,21,28
2012,4,8,6,7,12,25,37
2012,4,8,6,8,19,65,84
2012,4,8,6,9,71,108,179
2012,4,8,6,10,113,186,299
2012,4,8,6,11,195,209,404
2012,4,8,6,12,198,259,457
2012,4,8,6,13,229,254,483
2012,4,8,6,14,254,249,503
2012,4,8,6,15,260,226,486
2012,4,8,6,16,232,244,476
2012,4,8,6,17,185,226,411
2012,4,8,6,18,151,159,310
2012,4,8,6,19,89,187,276
2012,4,8,6,20,65,146,211
2012,4,8,6,21,53,77,130
2012,4,8,6,22,33,84,117
2012,4,8,6,23,10,41,51
2012,4,9,0,0,8,28,36
2012,4,9,0,1,4,12,16
2012,4,9,0,2,2,4,6
2012,4,9,0,3,0,3,3
2012,4,9,0,4,2,3,5
2012,4,9,0,5,2,30,32
2012,4,9,0,6,3,108,111
2012,4,9,0,7,11,319,330
2012,4,9,0,8,22,595,617
2012,4,9,0,9,50,234,284
2012,4,9,0,10,65,112,177
2012,4,9,0,11,96,127,223
2012,4,9,0,12,94,185,279
2012,4,9,0,13,108,173,281
2012,4,9,0,14,66,151,217
2012,4,9,0,15,82,173,255
2012,4,9,0,16,81,310,391
2012,4,9,0,17,67,564,631
2012,4,9,0,18,60,585,645
2012,4,9,0,19,35,386,421
2012,4,9,0,20,21,255,276
2012,4,9,0,21,14,151,165
2012,4,9,0,22,6,102,108
2012,4,9,0,23,6,61,67
2012,4,10,1,0,3,23,26
2012,4,10,1,1,0,9,9
2012,4,10,1,2,0,2,2
2012,4,10,1,3,0,2,2
2012,4,10,1,4,0,2,2
2012,4,10,1,5,0,24,24
2012,4,10,1,6,3,99,102
2012,4,10,1,7,16,367,383
2012,4,10,1,8,22,669,691
2012,4,10,1,9,16,303,319
2012,4,10,1,10,49,131,180
2012,4,10,1,11,78,161,239
2012,4,10,1,12,75,184,259
2012,4,10,1,13,81,202,283
2012,4,10,1,14,75,149,224
2012,4,10,1,15,46,155,201
2012,4,10,1,16,66,295,361
2012,4,10,1,17,88,656,744
2012,4,10,1,18,78,624,702
2012,4,10,1,19,51,428,479
2012,4,10,1,20,34,247,281
2012,4,10,1,21,15,191,206
2012,4,10,1,22,9,118,127
2012,4,10,1,23,14,47,61
2012,4,11,2,0,8,22,30
2012,4,11,2,1,3,9,12
2012,4,11,2,2,0,2,2
2012,4,11,2,3,0,2,2
2012,4,11,2,5,1,26,27
2012,4,11,2,6,3,102,105
2012,4,11,2,7,18,303,321
2012,4,11,2,8,14,577,591
2012,4,11,2,9,20,282,302
2012,4,11,2,10,26,127,153
2012,4,11,2,11,38,142,180
2012,4,11,2,12,35,147,182
2012,4,11,2,13,16,146,162
2012,4,11,2,14,34,101,135
2012,4,11,2,15,50,152,202
2012,4,11,2,16,51,256,307
2012,4,11,2,17,52,526,578
2012,4,11,2,18,39,543,582
2012,4,11,2,19,28,354,382
2012,4,11,2,20,22,213,235
2012,4,11,2,21,11,153,164
2012,4,11,2,22,4,130,134
2012,4,11,2,23,9,52,61
2012,4,12,3,0,1,22,23
2012,4,12,3,1,2,7,9
2012,4,12,3,2,0,4,4
2012,4,12,3,3,2,3,5
2012,4,12,3,4,0,1,1
2012,4,12,3,5,0,21,21
2012,4,12,3,6,2,94,96
2012,4,12,3,7,12,293,305
2012,4,12,3,8,20,602,622
2012,4,12,3,9,16,271,287
2012,4,12,3,10,38,103,141
2012,4,12,3,11,50,174,224
2012,4,12,3,12,60,199,259
2012,4,12,3,13,55,146,201
2012,4,12,3,14,74,149,223
2012,4,12,3,15,42,169,211
2012,4,12,3,16,54,298,352
2012,4,12,3,17,60,594,654
2012,4,12,3,18,63,546,609
2012,4,12,3,19,50,383,433
2012,4,12,3,20,26,254,280
2012,4,12,3,21,13,172,185
2012,4,12,3,22,15,142,157
2012,4,12,3,23,8,86,94
2012,4,13,4,0,14,41,55
2012,4,13,4,1,2,28,30
2012,4,13,4,2,6,5,11
2012,4,13,4,3,3,8,11
2012,4,13,4,4,1,4,5
2012,4,13,4,5,2,18,20
2012,4,13,4,6,0,84,84
2012,4,13,4,7,13,283,296
2012,4,13,4,8,24,538,562
2012,4,13,4,9,36,293,329
2012,4,13,4,10,59,133,192
2012,4,13,4,11,75,158,233
2012,4,13,4,12,104,217,321
2012,4,13,4,13,112,244,356
2012,4,13,4,14,125,223,348
2012,4,13,4,15,115,237,352
2012,4,13,4,16,113,349,462
2012,4,13,4,17,117,620,737
2012,4,13,4,18,107,564,671
2012,4,13,4,19,75,351,426
2012,4,13,4,20,44,242,286
2012,4,13,4,21,36,153,189
2012,4,13,4,22,34,181,215
2012,4,13,4,23,35,163,198
2012,4,14,5,0,11,85,96
2012,4,14,5,1,10,60,70
2012,4,14,5,2,3,53,56
2012,4,14,5,3,6,26,32
2012,4,14,5,4,5,9,14
2012,4,14,5,5,2,5,7
2012,4,14,5,6,2,19,21
2012,4,14,5,7,8,56,64
2012,4,14,5,8,24,136,160
2012,4,14,5,9,59,206,265
2012,4,14,5,10,139,267,406
2012,4,14,5,11,207,357,564
2012,4,14,5,12,274,403,677
2012,4,14,5,13,308,369,677
2012,4,14,5,14,288,372,660
2012,4,14,5,15,311,347,658
2012,4,14,5,16,253,329,582
2012,4,14,5,17,251,309,560
2012,4,14,5,18,197,284,481
2012,4,14,5,19,163,296,459
2012,4,14,5,20,112,209,321
2012,4,14,5,21,53,167,220
2012,4,14,5,22,64,148,212
2012,4,14,5,23,45,151,196
2012,4,15,6,0,30,94,124
2012,4,15,6,1,17,89,106
2012,4,15,6,2,20,54,74
2012,4,15,6,3,18,27,45
2012,4,15,6,4,2,10,12
2012,4,15,6,5,4,6,10
2012,4,15,6,6,5,11,16
2012,4,15,6,7,16,30,46
2012,4,15,6,8,33,64,97
2012,4,15,6,9,97,153,250
2012,4,15,6,10,186,235,421
2012,4,15,6,11,227,299,526
2012,4,15,6,12,275,360,635
2012,4,15,6,13,298,381,679
2012,4,15,6,14,282,346,628
2012,4,15,6,15,266,350,616
2012,4,15,6,16,286,330,616
2012,4,15,6,17,262,360,622
2012,4,15,6,18,184,294,478
2012,4,15,6,19,114,265,379
2012,4,15,6,20,86,205,291
2012,4,15,6,21,76,153,229
2012,4,15,6,22,37,97,134
2012,4,15,6,23,25,65,90
2012,4,16,0,0,15,26,41
2012,4,16,0,1,7,21,28
2012,4,16,0,2,5,9,14
2012,4,16,0,3,3,5,8
2012,4,16,0,4,0,5,5
2012,4,16,0,5,4,34,38
2012,4,16,0,6,9,123,132
2012,4,16,0,7,20,365,385
2012,4,16,0,8,48,548,596
2012,4,16,0,9,59,238,297
2012,4,16,0,10,75,149,224
2012,4,16,0,11,115,136,251
2012,4,16,0,12,75,196,271
2012,4,16,0,13,79,184,263
2012,4,16,0,14,105,183,288
2012,4,16,0,15,81,194,275
2012,4,16,0,16,92,266,358
2012,4,16,0,17,111,600,711
2012,4,16,0,18,87,588,675
2012,4,16,0,19,61,461,522
2012,4,16,0,20,48,326,374
2012,4,16,0,21,39,231,270
2012,4,16,0,22,35,179,214
2012,4,16,0,23,24,97,121
2012,4,17,1,0,10,33,43
2012,4,17,1,1,6,5,11
2012,4,17,1,2,1,3,4
2012,4,17,1,3,0,6,6
2012,4,17,1,4,3,5,8
2012,4,17,1,5,1,29,30
2012,4,17,1,6,8,136,144
2012,4,17,1,7,18,442,460
2012,4,17,1,8,42,626,668
2012,4,17,1,9,71,327,398
2012,4,17,1,10,52,165,217
2012,4,17,1,11,65,173,238
2012,4,17,1,12,65,179,244
2012,4,17,1,13,52,187,239
2012,4,17,1,14,59,198,257
2012,4,17,1,15,91,217,308
2012,4,17,1,16,50,320,370
2012,4,17,1,17,108,672,780
2012,4,17,1,18,104,667,771
2012,4,17,1,19,73,463,536
2012,4,17,1,20,44,358,402
2012,4,17,1,21,36,258,294
2012,4,17,1,22,18,143,161
2012,4,17,1,23,10,72,82
2012,4,18,2,0,3,35,38
2012,4,18,2,1,1,13,14
2012,4,18,2,2,1,8,9
2012,4,18,2,3,0,6,6
2012,4,18,2,4,0,7,7
2012,4,18,2,5,0,34,34
2012,4,18,2,6,6,128,134
2012,4,18,2,7,10,407,417
2012,4,18,2,8,25,550,575
2012,4,18,2,9,20,245,265
2012,4,18,2,10,31,116,147
2012,4,18,2,11,14,104,118
2012,4,18,2,12,15,95,110
2012,4,18,2,13,13,51,64
2012,4,18,2,14,8,43,51
2012,4,18,2,15,10,88,98
2012,4,18,2,16,36,199,235
2012,4,18,2,17,46,441,487
2012,4,18,2,18,27,478,505
2012,4,18,2,19,26,341,367
2012,4,18,2,20,8,250,258
2012,4,18,2,21,24,165,189
2012,4,18,2,22,9,153,162
2012,4,18,2,23,14,56,70
2012,4,19,3,0,5,20,25
2012,4,19,3,1,2,11,13
2012,4,19,3,2,2,4,6
2012,4,19,3,3,1,3,4
2012,4,19,3,4,0,4,4
2012,4,19,3,5,0,30,30
2012,4,19,3,6,4,116,120
2012,4,19,3,7,15,389,404
2012,4,19,3,8,26,648,674
2012,4,19,3,9,31,270,301
2012,4,19,3,10,46,143,189
2012,4,19,3,11,46,180,226
2012,4,19,3,12,50,212,262
2012,4,19,3,13,52,186,238
2012,4,19,3,14,54,182,236
2012,4,19,3,15,66,196,262
2012,4,19,3,16,63,324,387
2012,4,19,3,17,85,663,748
2012,4,19,3,18,99,676,775
2012,4,19,3,19,70,514,584
2012,4,19,3,20,52,351,403
2012,4,19,3,21,27,238,265
2012,4,19,3,22,29,218,247
2012,4,19,3,23,20,124,144
2012,4,20,4,0,5,59,64
2012,4,20,4,1,3,22,25
2012,4,20,4,2,3,18,21
2012,4,20,4,3,1,9,10
2012,4,20,4,4,0,2,2
2012,4,20,4,5,1,24,25
2012,4,20,4,6,8,105,113
2012,4,20,4,7,9,348,357
2012,4,20,4,8,32,665,697
2012,4,20,4,9,30,326,356
2012,4,20,4,10,67,169,236
2012,4,20,4,11,64,190,254
2012,4,20,4,12,102,260,362
2012,4,20,4,13,105,275,380
2012,4,20,4,14,156,238,394
2012,4,20,4,15,145,261,406
2012,4,20,4,16,151,429,580
2012,4,20,4,17,122,695,817
2012,4,20,4,18,109,557,666
2012,4,20,4,19,82,409,491
2012,4,20,4,20,52,289,341
2012,4,20,4,21,35,252,287
2012,4,20,4,22,26,176,202
2012,4,20,4,23,31,156,187
2012,4,21,5,0,31,111,142
2012,4,21,5,1,24,64,88
2012,4,21,5,2,12,69,81
2012,4,21,5,3,4,25,29
2012,4,21,5,4,0,8,8
2012,4,21,5,5,0,1,1
2012,4,21,5,6,10,21,31
2012,4,21,5,7,21,55,76
2012,4,21,5,8,52,149,201
2012,4,21,5,9,115,216,331
2012,4,21,5,10,183,299,482
2012,4,21,5,11,260,348,608
2012,4,21,5,12,262,378,640
2012,4,21,5,13,291,358,649
2012,4,21,5,14,278,330,608
2012,4,21,5,15,267,361,628
2012,4,21,5,16,267,372,639
2012,4,21,5,17,259,309,568
2012,4,21,5,18,133,283,416
2012,4,21,5,19,9,45,54
2012,4,21,5,20,5,34,39
2012,4,21,5,21,20,82,102
2012,4,21,5,22,20,89,109
2012,4,21,5,23,18,73,91
2012,4,22,6,0,32,85,117
2012,4,22,6,1,10,63,73
2012,4,22,6,2,7,49,56
2012,4,22,6,3,7,33,40
2012,4,22,6,4,0,7,7
2012,4,22,6,5,0,6,6
2012,4,22,6,6,6,6,12
2012,4,22,6,7,2,21,23
2012,4,22,6,8,8,43,51
2012,4,22,6,9,8,70,78
2012,4,22,6,10,11,56,67
2012,4,22,6,11,7,70,77
2012,4,22,6,12,5,56,61
2012,4,22,6,13,5,47,52
2012,4,22,6,14,3,50,53
2012,4,22,6,15,0,38,38
2012,4,22,6,16,4,31,35
2012,4,22,6,17,2,25,27
2012,4,22,6,18,1,38,39
2012,4,22,6,19,1,34,35
2012,4,22,6,20,1,34,35
2012,4,22,6,21,0,11,11
2012,4,22,6,22,0,13,13
2012,4,22,6,23,0,17,17
2012,4,23,0,0,0,6,6
2012,4,23,0,1,1,1,2
2012,4,23,0,2,1,3,4
2012,4,23,0,3,0,1,1
2012,4,23,0,4,0,3,3
2012,4,23,0,5,0,14,14
2012,4,23,0,6,1,43,44
2012,4,23,0,7,1,205,206
2012,4,23,0,8,11,470,481
2012,4,23,0,9,17,254,271
2012,4,23,0,10,12,88,100
2012,4,23,0,11,10,90,100
2012,4,23,0,12,12,116,128
2012,4,23,0,13,9,98,107
2012,4,23,0,14,12,101,113
2012,4,23,0,15,11,100,111
2012,4,23,0,16,10,93,103
2012,4,23,0,17,13,219,232
2012,4,23,0,18,10,369,379
2012,4,23,0,19,11,287,298
2012,4,23,0,20,17,185,202
2012,4,23,0,21,7,145,152
2012,4,23,0,22,18,70,88
2012,4,23,0,23,10,49,59
2012,4,24,1,0,0,13,13
2012,4,24,1,1,1,6,7
2012,4,24,1,2,0,3,3
2012,4,24,1,3,0,2,2
2012,4,24,1,4,0,3,3
2012,4,24,1,5,0,22,22
2012,4,24,1,6,3,117,120
2012,4,24,1,7,3,385,388
2012,4,24,1,8,12,597,609
2012,4,24,1,9,6,302,308
2012,4,24,1,10,33,129,162
2012,4,24,1,11,27,157,184
2012,4,24,1,12,34,188,222
2012,4,24,1,13,35,189,224
2012,4,24,1,14,50,166,216
2012,4,24,1,15,60,176,236
2012,4,24,1,16,54,308,362
2012,4,24,1,17,72,617,689
2012,4,24,1,18,52,579,631
2012,4,24,1,19,33,449,482
2012,4,24,1,20,16,268,284
2012,4,24,1,21,13,212,225
2012,4,24,1,22,8,148,156
2012,4,24,1,23,4,69,73
2012,4,25,2,0,13,23,36
2012,4,25,2,1,8,17,25
2012,4,25,2,2,1,6,7
2012,4,25,2,3,0,3,3
2012,4,25,2,4,0,5,5
2012,4,25,2,5,0,24,24
2012,4,25,2,6,3,103,106
2012,4,25,2,7,13,376,389
2012,4,25,2,8,20,634,654
2012,4,25,2,9,33,286,319
2012,4,25,2,10,44,138,182
2012,4,25,2,11,42,177,219
2012,4,25,2,12,49,220,269
2012,4,25,2,13,35,193,228
2012,4,25,2,14,47,176,223
2012,4,25,2,15,47,182,229
2012,4,25,2,16,49,327,376
2012,4,25,2,17,68,662,730
2012,4,25,2,18,60,647,707
2012,4,25,2,19,42,501,543
2012,4,25,2,20,22,356,378
2012,4,25,2,21,27,212,239
2012,4,25,2,22,22,170,192
2012,4,25,2,23,10,94,104
2012,4,26,3,0,1,42,43
2012,4,26,3,1,1,22,23
2012,4,26,3,2,3,10,13
2012,4,26,3,3,1,5,6
2012,4,26,3,4,1,1,2
2012,4,26,3,5,0,17,17
2012,4,26,3,6,5,122,127
2012,4,26,3,7,3,221,224
2012,4,26,3,8,4,357,361
2012,4,26,3,9,12,188,200
2012,4,26,3,10,14,125,139
2012,4,26,3,11,16,135,151
2012,4,26,3,12,24,180,204
2012,4,26,3,13,19,178,197
2012,4,26,3,14,37,132,169
2012,4,26,3,15,39,165,204
2012,4,26,3,16,37,281,318
2012,4,26,3,17,49,564,613
2012,4,26,3,18,75,588,663
2012,4,26,3,19,57,407,464
2012,4,26,3,20,23,314,337
2012,4,26,3,21,28,222,250
2012,4,26,3,22,20,163,183
2012,4,26,3,23,6,106,112
2012,4,27,4,0,12,61,73
2012,4,27,4,1,3,32,35
2012,4,27,4,2,4,18,22
2012,4,27,4,3,1,2,3
2012,4,27,4,4,0,6,6
2012,4,27,4,5,0,19,19
2012,4,27,4,6,5,115,120
2012,4,27,4,7,10,304,314
2012,4,27,4,8,17,573,590
2012,4,27,4,9,42,292,334
2012,4,27,4,10,63,172,235
2012,4,27,4,11,47,185,232
2012,4,27,4,12,63,244,307
2012,4,27,4,13,94,212,306
2012,4,27,4,14,94,206,300
2012,4,27,4,15,101,223,324
2012,4,27,4,16,105,335,440
2012,4,27,4,17,89,612,701
2012,4,27,4,18,94,559,653
2012,4,27,4,19,62,378,440
2012,4,27,4,20,49,240,289
2012,4,27,4,21,23,185,208
2012,4,27,4,22,24,134,158
2012,4,27,4,23,11,105,116
2012,4,28,5,0,4,99,103
2012,4,28,5,1,7,60,67
2012,4,28,5,2,8,49,57
2012,4,28,5,3,3,23,26
2012,4,28,5,4,0,2,2
2012,4,28,5,5,2,3,5
2012,4,28,5,6,10,18,28
2012,4,28,5,7,10,45,55
2012,4,28,5,8,24,134,158
2012,4,28,5,9,45,169,214
2012,4,28,5,10,60,231,291
2012,4,28,5,11,96,262,358
2012,4,28,5,12,105,276,381
2012,4,28,5,13,120,269,389
2012,4,28,5,14,147,293,440
2012,4,28,5,15,148,260,408
2012,4,28,5,16,132,244,376
2012,4,28,5,17,98,224,322
2012,4,28,5,18,17,73,90
2012,4,28,5,19,29,110,139
2012,4,28,5,20,21,81,102
2012,4,28,5,21,12,72,84
2012,4,28,5,22,17,66,83
2012,4,28,5,23,5,37,42
2012,4,29,6,0,0,36,36
2012,4,29,6,1,5,37,42
2012,4,29,6,2,4,36,40
2012,4,29,6,3,2,14,16
2012,4,29,6,4,0,4,4
2012,4,29,6,5,0,6,6
2012,4,29,6,6,1,6,7
2012,4,29,6,7,7,20,27
2012,4,29,6,8,26,81,107
2012,4,29,6,9,52,133,185
2012,4,29,6,10,127,253,380
2012,4,29,6,11,128,283,411
2012,4,29,6,12,223,361,584
2012,4,29,6,13,226,368,594
2012,4,29,6,14,281,372,653
2012,4,29,6,15,279,324,603
2012,4,29,6,16,240,347,587
2012,4,29,6,17,188,333,521
2012,4,29,6,18,164,323,487
2012,4,29,6,19,128,247,375
2012,4,29,6,20,45,198,243
2012,4,29,6,21,65,139,204
2012,4,29,6,22,23,85,108
2012,4,29,6,23,15,67,82
2012,4,30,0,0,12,36,48
2012,4,30,0,1,9,15,24
2012,4,30,0,2,3,5,8
2012,4,30,0,3,0,4,4
2012,4,30,0,4,0,2,2
2012,4,30,0,5,1,19,20
2012,4,30,0,6,2,121,123
2012,4,30,0,7,6,342,348
2012,4,30,0,8,17,579,596
2012,4,30,0,9,29,239,268
2012,4,30,0,10,41,115,156
2012,4,30,0,11,52,111,163
2012,4,30,0,12,45,180,225
2012,4,30,0,13,48,199,247
2012,4,30,0,14,56,162,218
2012,4,30,0,15,55,176,231
2012,4,30,0,16,44,303,347
2012,4,30,0,17,66,617,683
2012,4,30,0,18,53,611,664
2012,4,30,0,19,51,420,471
2012,4,30,0,20,28,280,308
2012,4,30,0,21,26,195,221
2012,4,30,0,22,11,123,134
2012,4,30,0,23,10,50,60
2012,5,1,1,0,7,28,35
2012,5,1,1,1,0,21,21
2012,5,1,1,2,1,7,8
2012,5,1,1,3,1,2,3
2012,5,1,1,4,1,7,8
2012,5,1,1,5,0,17,17
2012,5,1,1,6,2,24,26
2012,5,1,1,7,8,160,168
2012,5,1,1,8,19,537,556
2012,5,1,1,9,18,331,349
2012,5,1,1,10,30,142,172
2012,5,1,1,11,50,179,229
2012,5,1,1,12,41,228,269
2012,5,1,1,13,41,208,249
2012,5,1,1,14,37,166,203
2012,5,1,1,15,48,186,234
2012,5,1,1,16,41,313,354
2012,5,1,1,17,65,616,681
2012,5,1,1,18,81,662,743
2012,5,1,1,19,58,428,486
2012,5,1,1,20,36,298,334
2012,5,1,1,21,31,251,282
2012,5,1,1,22,21,190,211
2012,5,1,1,23,16,79,95
2012,5,2,2,0,4,43,47
2012,5,2,2,1,8,7,15
2012,5,2,2,2,7,9,16
2012,5,2,2,3,0,6,6
2012,5,2,2,4,2,2,4
2012,5,2,2,5,2,31,33
2012,5,2,2,6,3,116,119
2012,5,2,2,7,14,344,358
2012,5,2,2,8,26,639,665
2012,5,2,2,9,26,286,312
2012,5,2,2,10,28,147,175
2012,5,2,2,11,39,144,183
2012,5,2,2,12,35,210,245
2012,5,2,2,13,49,179,228
2012,5,2,2,14,51,189,240
2012,5,2,2,15,52,203,255
2012,5,2,2,16,54,313,367
2012,5,2,2,17,70,659,729
2012,5,2,2,18,43,770,813
2012,5,2,2,19,43,460,503
2012,5,2,2,20,42,294,336
2012,5,2,2,21,21,217,238
2012,5,2,2,22,27,146,173
2012,5,2,2,23,21,77,98
2012,5,3,3,0,15,75,90
2012,5,3,3,1,9,15,24
2012,5,3,3,2,4,13,17
2012,5,3,3,3,2,4,6
2012,5,3,3,4,0,2,2
2012,5,3,3,5,1,20,21
2012,5,3,3,6,8,128,136
2012,5,3,3,7,8,376,384
2012,5,3,3,8,19,607,626
2012,5,3,3,9,25,279,304
2012,5,3,3,10,36,131,167
2012,5,3,3,11,34,167,201
2012,5,3,3,12,64,235,299
2012,5,3,3,13,48,217,265
2012,5,3,3,14,33,171,204
2012,5,3,3,15,63,220,283
2012,5,3,3,16,45,325,370
2012,5,3,3,17,87,617,704
2012,5,3,3,18,64,641,705
2012,5,3,3,19,55,466,521
2012,5,3,3,20,52,368,420
2012,5,3,3,21,42,257,299
2012,5,3,3,22,29,217,246
2012,5,3,3,23,21,100,121
2012,5,4,4,0,19,70,89
2012,5,4,4,1,15,33,48
2012,5,4,4,2,0,11,11
2012,5,4,4,3,0,14,14
2012,5,4,4,4,0,3,3
2012,5,4,4,5,0,24,24
2012,5,4,4,6,8,127,135
2012,5,4,4,7,8,346,354
2012,5,4,4,8,34,584,618
2012,5,4,4,9,32,262,294
2012,5,4,4,10,45,154,199
2012,5,4,4,11,77,181,258
2012,5,4,4,12,46,125,171
2012,5,4,4,13,71,207,278
2012,5,4,4,14,83,158,241
2012,5,4,4,15,103,240,343
2012,5,4,4,16,82,355,437
2012,5,4,4,17,96,547,643
2012,5,4,4,18,77,564,641
2012,5,4,4,19,64,387,451
2012,5,4,4,20,58,255,313
2012,5,4,4,21,49,186,235
2012,5,4,4,22,50,182,232
2012,5,4,4,23,51,205,256
2012,5,5,5,0,42,111,153
2012,5,5,5,1,28,79,107
2012,5,5,5,2,24,51,75
2012,5,5,5,3,11,21,32
2012,5,5,5,4,0,9,9
2012,5,5,5,5,8,14,22
2012,5,5,5,6,9,33,42
2012,5,5,5,7,8,79,87
2012,5,5,5,8,42,155,197
2012,5,5,5,9,61,223,284
2012,5,5,5,10,148,284,432
2012,5,5,5,11,221,354,575
2012,5,5,5,12,220,330,550
2012,5,5,5,13,217,307,524
2012,5,5,5,14,187,241,428
2012,5,5,5,15,241,300,541
2012,5,5,5,16,230,310,540
2012,5,5,5,17,204,298,502
2012,5,5,5,18,156,278,434
2012,5,5,5,19,151,254,405
2012,5,5,5,20,100,209,309
2012,5,5,5,21,86,183,269
2012,5,5,5,22,67,150,217
2012,5,5,5,23,35,114,149
2012,5,6,6,0,23,111,134
2012,5,6,6,1,37,84,121
2012,5,6,6,2,29,64,93
2012,5,6,6,3,9,19,28
2012,5,6,6,4,9,7,16
2012,5,6,6,5,1,10,11
2012,5,6,6,6,3,14,17
2012,5,6,6,7,5,31,36
2012,5,6,6,8,23,91,114
2012,5,6,6,9,63,128,191
2012,5,6,6,10,112,220,332
2012,5,6,6,11,144,270,414
2012,5,6,6,12,207,350,557
2012,5,6,6,13,197,368,565
2012,5,6,6,14,226,292,518
2012,5,6,6,15,229,342,571
2012,5,6,6,16,181,363,544
2012,5,6,6,17,195,316,511
2012,5,6,6,18,131,331,462
2012,5,6,6,19,117,265,382
2012,5,6,6,20,73,203,276
2012,5,6,6,21,55,148,203
2012,5,6,6,22,44,113,157
2012,5,6,6,23,22,80,102
2012,5,7,0,0,13,21,34
2012,5,7,0,1,1,8,9
2012,5,7,0,2,1,5,6
2012,5,7,0,3,2,3,5
2012,5,7,0,4,0,2,2
2012,5,7,0,5,2,21,23
2012,5,7,0,6,7,134,141
2012,5,7,0,7,18,367,385
2012,5,7,0,8,31,606,637
2012,5,7,0,9,61,289,350
2012,5,7,0,10,62,127,189
2012,5,7,0,11,64,149,213
2012,5,7,0,12,74,188,262
2012,5,7,0,13,75,196,271
2012,5,7,0,14,59,180,239
2012,5,7,0,15,76,186,262
2012,5,7,0,16,68,320,388
2012,5,7,0,17,102,667,769
2012,5,7,0,18,78,602,680
2012,5,7,0,19,83,463,546
2012,5,7,0,20,46,277,323
2012,5,7,0,21,37,210,247
2012,5,7,0,22,26,147,173
2012,5,7,0,23,21,92,113
2012,5,8,1,0,10,28,38
2012,5,8,1,1,6,3,9
2012,5,8,1,2,9,7,16
2012,5,8,1,3,2,4,6
2012,5,8,1,4,0,5,5
2012,5,8,1,5,0,20,20
2012,5,8,1,6,7,157,164
2012,5,8,1,7,21,441,462
2012,5,8,1,8,36,604,640
2012,5,8,1,9,36,258,294
2012,5,8,1,10,46,111,157
2012,5,8,1,11,60,157,217
2012,5,8,1,12,60,203,263
2012,5,8,1,13,53,166,219
2012,5,8,1,14,8,63,71
2012,5,8,1,15,40,94,134
2012,5,8,1,16,54,334,388
2012,5,8,1,17,77,640,717
2012,5,8,1,18,69,640,709
2012,5,8,1,19,58,399,457
2012,5,8,1,20,40,261,301
2012,5,8,1,21,21,202,223
2012,5,8,1,22,13,133,146
2012,5,8,1,23,10,53,63
2012,5,9,2,0,8,27,35
2012,5,9,2,1,3,11,14
2012,5,9,2,2,0,1,1
2012,5,9,2,3,0,2,2
2012,5,9,2,4,0,5,5
2012,5,9,2,5,1,26,27
2012,5,9,2,6,5,121,126
2012,5,9,2,7,17,401,418
2012,5,9,2,8,28,592,620
2012,5,9,2,9,40,285,325
2012,5,9,2,10,40,113,153
2012,5,9,2,11,45,156,201
2012,5,9,2,12,58,221,279
2012,5,9,2,13,50,216,266
2012,5,9,2,14,68,174,242
2012,5,9,2,15,68,190,258
2012,5,9,2,16,68,289,357
2012,5,9,2,17,76,629,705
2012,5,9,2,18,23,349,372
2012,5,9,2,19,2,96,98
2012,5,9,2,20,3,48,51
2012,5,9,2,21,4,30,34
2012,5,9,2,22,5,61,66
2012,5,9,2,23,8,47,55
2012,5,10,3,0,2,31,33
2012,5,10,3,1,2,9,11
2012,5,10,3,2,0,3,3
2012,5,10,3,3,0,3,3
2012,5,10,3,4,0,2,2
2012,5,10,3,5,1,23,24
2012,5,10,3,6,9,130,139
2012,5,10,3,7,8,390,398
2012,5,10,3,8,27,600,627
2012,5,10,3,9,62,299,361
2012,5,10,3,10,42,112,154
2012,5,10,3,11,77,179,256
2012,5,10,3,12,65,207,272
2012,5,10,3,13,90,228,318
2012,5,10,3,14,61,186,247
2012,5,10,3,15,79,192,271
2012,5,10,3,16,87,334,421
2012,5,10,3,17,84,648,732
2012,5,10,3,18,109,660,769
2012,5,10,3,19,84,468,552
2012,5,10,3,20,59,314,373
2012,5,10,3,21,19,211,230
2012,5,10,3,22,36,196,232
2012,5,10,3,23,23,112,135
2012,5,11,4,0,17,47,64
2012,5,11,4,1,14,32,46
2012,5,11,4,2,15,16,31
2012,5,11,4,3,5,8,13
2012,5,11,4,4,3,6,9
2012,5,11,4,5,3,23,26
2012,5,11,4,6,7,128,135
2012,5,11,4,7,6,345,351
2012,5,11,4,8,41,578,619
2012,5,11,4,9,34,287,321
2012,5,11,4,10,67,141,208
2012,5,11,4,11,88,203,291
2012,5,11,4,12,89,259,348
2012,5,11,4,13,100,263,363
2012,5,11,4,14,116,217,333
2012,5,11,4,15,140,299,439
2012,5,11,4,16,128,397,525
2012,5,11,4,17,102,675,777
2012,5,11,4,18,78,517,595
2012,5,11,4,19,73,428,501
2012,5,11,4,20,64,276,340
2012,5,11,4,21,45,225,270
2012,5,11,4,22,44,190,234
2012,5,11,4,23,38,142,180
2012,5,12,5,0,25,111,136
2012,5,12,5,1,14,79,93
2012,5,12,5,2,10,46,56
2012,5,12,5,3,14,20,34
2012,5,12,5,4,3,6,9
2012,5,12,5,5,5,6,11
2012,5,12,5,6,10,23,33
2012,5,12,5,7,10,57,67
2012,5,12,5,8,22,156,178
2012,5,12,5,9,87,248,335
2012,5,12,5,10,132,279,411
2012,5,12,5,11,157,365,522
2012,5,12,5,12,206,353,559
2012,5,12,5,13,293,366,659
2012,5,12,5,14,257,358,615
2012,5,12,5,15,269,321,590
2012,5,12,5,16,254,337,591
2012,5,12,5,17,233,343,576
2012,5,12,5,18,164,382,546
2012,5,12,5,19,166,273,439
2012,5,12,5,20,113,174,287
2012,5,12,5,21,74,156,230
2012,5,12,5,22,62,212,274
2012,5,12,5,23,42,134,176
2012,5,13,6,0,19,79,98
2012,5,13,6,1,22,72,94
2012,5,13,6,2,22,60,82
2012,5,13,6,3,2,26,28
2012,5,13,6,4,2,7,9
2012,5,13,6,5,4,7,11
2012,5,13,6,6,6,15,21
2012,5,13,6,7,18,42,60
2012,5,13,6,8,32,124,156
2012,5,13,6,9,79,143,222
2012,5,13,6,10,128,222,350
2012,5,13,6,11,150,278,428
2012,5,13,6,12,188,342,530
2012,5,13,6,13,255,347,602
2012,5,13,6,14,228,324,552
2012,5,13,6,15,190,309,499
2012,5,13,6,16,225,339,564
2012,5,13,6,17,191,287,478
2012,5,13,6,18,129,260,389
2012,5,13,6,19,107,232,339
2012,5,13,6,20,67,163,230
2012,5,13,6,21,48,121,169
2012,5,13,6,22,42,89,131
2012,5,13,6,23,17,57,74
2012,5,14,0,0,21,14,35
2012,5,14,0,1,5,6,11
2012,5,14,0,2,1,1,2
2012,5,14,0,3,0,2,2
2012,5,14,0,4,3,3,6
2012,5,14,0,5,1,24,25
2012,5,14,0,6,3,62,65
2012,5,14,0,7,3,72,75
2012,5,14,0,8,1,155,156
2012,5,14,0,9,5,105,110
2012,5,14,0,10,6,53,59
2012,5,14,0,11,12,67,79
2012,5,14,0,12,53,132,185
2012,5,14,0,13,33,143,176
2012,5,14,0,14,43,128,171
2012,5,14,0,15,40,156,196
2012,5,14,0,16,20,91,111
2012,5,14,0,17,25,204,229
2012,5,14,0,18,17,283,300
2012,5,14,0,19,10,294,304
2012,5,14,0,20,11,178,189
2012,5,14,0,21,7,145,152
2012,5,14,0,22,11,118,129
2012,5,14,0,23,11,64,75
2012,5,15,1,0,7,25,32
2012,5,15,1,1,5,14,19
2012,5,15,1,2,1,3,4
2012,5,15,1,3,1,5,6
2012,5,15,1,4,1,4,5
2012,5,15,1,5,0,8,8
2012,5,15,1,6,2,22,24
2012,5,15,1,7,1,91,92
2012,5,15,1,8,8,401,409
2012,5,15,1,9,28,327,355
2012,5,15,1,10,27,144,171
2012,5,15,1,11,38,186,224
2012,5,15,1,12,44,220,264
2012,5,15,1,13,35,204,239
2012,5,15,1,14,39,144,183
2012,5,15,1,15,51,203,254
2012,5,15,1,16,74,300,374
2012,5,15,1,17,75,601,676
2012,5,15,1,18,68,664,732
2012,5,15,1,19,57,455,512
2012,5,15,1,20,30,233,263
2012,5,15,1,21,11,98,109
2012,5,15,1,22,9,74,83
2012,5,15,1,23,13,58,71
2012,5,16,2,0,12,27,39
2012,5,16,2,1,7,14,21
2012,5,16,2,2,5,14,19
2012,5,16,2,3,1,5,6
2012,5,16,2,4,1,3,4
2012,5,16,2,5,4,34,38
2012,5,16,2,6,8,150,158
2012,5,16,2,7,14,426,440
2012,5,16,2,8,33,612,645
2012,5,16,2,9,33,314,347
2012,5,16,2,10,43,149,192
2012,5,16,2,11,55,212,267
2012,5,16,2,12,59,271,330
2012,5,16,2,13,77,273,350
2012,5,16,2,14,42,221,263
2012,5,16,2,15,52,222,274
2012,5,16,2,16,70,376,446
2012,5,16,2,17,104,767,871
2012,5,16,2,18,97,747,844
2012,5,16,2,19,91,499,590
2012,5,16,2,20,61,398,459
2012,5,16,2,21,63,329,392
2012,5,16,2,22,33,253,286
2012,5,16,2,23,26,106,132
2012,5,17,3,0,30,49,79
2012,5,17,3,1,12,16,28
2012,5,17,3,2,8,8,16
2012,5,17,3,3,0,3,3
2012,5,17,3,4,3,13,16
2012,5,17,3,5,1,34,35
2012,5,17,3,6,10,149,159
2012,5,17,3,7,25,446,471
2012,5,17,3,8,29,602,631
2012,5,17,3,9,57,287,344
2012,5,17,3,10,43,161,204
2012,5,17,3,11,77,202,279
2012,5,17,3,12,72,276,348
2012,5,17,3,13,86,241,327
2012,5,17,3,14,68,202,270
2012,5,17,3,15,83,232,315
2012,5,17,3,16,86,344,430
2012,5,17,3,17,133,719,852
2012,5,17,3,18,134,733,867
2012,5,17,3,19,86,451,537
2012,5,17,3,20,82,362,444
2012,5,17,3,21,45,254,299
2012,5,17,3,22,42,209,251
2012,5,17,3,23,29,137,166
2012,5,18,4,0,13,57,70
2012,5,18,4,1,16,33,49
2012,5,18,4,2,12,9,21
2012,5,18,4,3,6,8,14
2012,5,18,4,4,0,11,11
2012,5,18,4,5,1,33,34
2012,5,18,4,6,14,168,182
2012,5,18,4,7,40,474,514
2012,5,18,4,8,49,695,744
2012,5,18,4,9,57,303,360
2012,5,18,4,10,74,181,255
2012,5,18,4,11,109,225,334
2012,5,18,4,12,108,252,360
2012,5,18,4,13,98,297,395
2012,5,18,4,14,108,242,350
2012,5,18,4,15,131,260,391
2012,5,18,4,16,151,415,566
2012,5,18,4,17,124,686,810
2012,5,18,4,18,99,569,668
2012,5,18,4,19,91,392,483
2012,5,18,4,20,73,264,337
2012,5,18,4,21,49,209,258
2012,5,18,4,22,57,194,251
2012,5,18,4,23,41,133,174
2012,5,19,5,0,30,118,148
2012,5,19,5,1,20,84,104
2012,5,19,5,2,13,56,69
2012,5,19,5,3,10,23,33
2012,5,19,5,4,6,8,14
2012,5,19,5,5,1,11,12
2012,5,19,5,6,12,38,50
2012,5,19,5,7,28,67,95
2012,5,19,5,8,33,162,195
2012,5,19,5,9,79,213,292
2012,5,19,5,10,177,275,452
2012,5,19,5,11,235,351,586
2012,5,19,5,12,276,366,642
2012,5,19,5,13,332,371,703
2012,5,19,5,14,361,369,730
2012,5,19,5,15,356,315,671
2012,5,19,5,16,331,311,642
2012,5,19,5,17,279,347,626
2012,5,19,5,18,254,391,645
2012,5,19,5,19,203,229,432
2012,5,19,5,20,118,197,315
2012,5,19,5,21,81,178,259
2012,5,19,5,22,104,234,338
2012,5,19,5,23,71,168,239
2012,5,20,6,0,42,128,170
2012,5,20,6,1,28,102,130
2012,5,20,6,2,36,62,98
2012,5,20,6,3,26,40,66
2012,5,20,6,4,2,14,16
2012,5,20,6,5,1,7,8
2012,5,20,6,6,4,21,25
2012,5,20,6,7,35,55,90
2012,5,20,6,8,51,120,171
2012,5,20,6,9,129,184,313
2012,5,20,6,10,174,258,432
2012,5,20,6,11,258,322,580
2012,5,20,6,12,247,389,636
2012,5,20,6,13,243,363,606
2012,5,20,6,14,236,307,543
2012,5,20,6,15,246,256,502
2012,5,20,6,16,237,339,576
2012,5,20,6,17,209,339,548
2012,5,20,6,18,146,328,474
2012,5,20,6,19,142,260,402
2012,5,20,6,20,83,191,274
2012,5,20,6,21,51,182,233
2012,5,20,6,22,44,101,145
2012,5,20,6,23,32,54,86
2012,5,21,0,0,12,28,40
2012,5,21,0,1,4,11,15
2012,5,21,0,2,2,9,11
2012,5,21,0,3,0,2,2
2012,5,21,0,4,2,5,7
2012,5,21,0,5,1,14,15
2012,5,21,0,6,3,76,79
2012,5,21,0,7,7,146,153
2012,5,21,0,8,12,258,270
2012,5,21,0,9,14,171,185
2012,5,21,0,10,28,71,99
2012,5,21,0,11,24,82,106
2012,5,21,0,12,46,124,170
2012,5,21,0,13,49,135,184
2012,5,21,0,14,45,135,180
2012,5,21,0,15,67,158,225
2012,5,21,0,16,46,269,315
2012,5,21,0,17,40,467,507
2012,5,21,0,18,52,478,530
2012,5,21,0,19,57,391,448
2012,5,21,0,20,44,292,336
2012,5,21,0,21,31,208,239
2012,5,21,0,22,26,116,142
2012,5,21,0,23,18,79,97
2012,5,22,1,0,10,26,36
2012,5,22,1,1,11,16,27
2012,5,22,1,2,1,10,11
2012,5,22,1,3,0,5,5
2012,5,22,1,4,0,5,5
2012,5,22,1,5,0,17,17
2012,5,22,1,6,8,129,137
2012,5,22,1,7,9,314,323
2012,5,22,1,8,20,566,586
2012,5,22,1,9,46,286,332
2012,5,22,1,10,52,147,199
2012,5,22,1,11,39,150,189
2012,5,22,1,12,76,178,254
2012,5,22,1,13,48,195,243
2012,5,22,1,14,73,149,222
2012,5,22,1,15,54,191,245
2012,5,22,1,16,70,316,386
2012,5,22,1,17,69,715,784
2012,5,22,1,18,76,709,785
2012,5,22,1,19,44,320,364
2012,5,22,1,20,54,318,372
2012,5,22,1,21,28,232,260
2012,5,22,1,22,17,157,174
2012,5,22,1,23,14,90,104
2012,5,23,2,0,19,28,47
2012,5,23,2,1,23,9,32
2012,5,23,2,2,2,10,12
2012,5,23,2,3,0,5,5
2012,5,23,2,4,0,3,3
2012,5,23,2,5,6,28,34
2012,5,23,2,6,6,154,160
2012,5,23,2,7,16,450,466
2012,5,23,2,8,38,677,715
2012,5,23,2,9,39,258,297
2012,5,23,2,10,52,139,191
2012,5,23,2,11,46,151,197
2012,5,23,2,12,42,206,248
2012,5,23,2,13,69,201,270
2012,5,23,2,14,67,180,247
2012,5,23,2,15,65,192,257
2012,5,23,2,16,62,216,278
2012,5,23,2,17,45,239,284
2012,5,23,2,18,31,296,327
2012,5,23,2,19,40,336,376
2012,5,23,2,20,28,265,293
2012,5,23,2,21,24,221,245
2012,5,23,2,22,23,136,159
2012,5,23,2,23,23,83,106
2012,5,24,3,0,7,49,56
2012,5,24,3,1,9,21,30
2012,5,24,3,2,1,15,16
2012,5,24,3,3,1,3,4
2012,5,24,3,4,0,5,5
2012,5,24,3,5,1,29,30
2012,5,24,3,6,10,145,155
2012,5,24,3,7,22,390,412
2012,5,24,3,8,33,658,691
2012,5,24,3,9,34,265,299
2012,5,24,3,10,47,138,185
2012,5,24,3,11,61,160,221
2012,5,24,3,12,76,213,289
2012,5,24,3,13,69,233,302
2012,5,24,3,14,72,180,252
2012,5,24,3,15,69,222,291
2012,5,24,3,16,61,329,390
2012,5,24,3,17,120,678,798
2012,5,24,3,18,118,633,751
2012,5,24,3,19,76,415,491
2012,5,24,3,20,55,342,397
2012,5,24,3,21,48,237,285
2012,5,24,3,22,33,210,243
2012,5,24,3,23,36,130,166
2012,5,25,4,0,10,63,73
2012,5,25,4,1,8,34,42
2012,5,25,4,2,7,16,23
2012,5,25,4,3,8,6,14
2012,5,25,4,4,3,5,8
2012,5,25,4,5,2,28,30
2012,5,25,4,6,5,108,113
2012,5,25,4,7,7,351,358
2012,5,25,4,8,32,548,580
2012,5,25,4,9,52,288,340
2012,5,25,4,10,69,163,232
2012,5,25,4,11,90,191,281
2012,5,25,4,12,84,235,319
2012,5,25,4,13,86,247,333
2012,5,25,4,14,104,263,367
2012,5,25,4,15,106,360,466
2012,5,25,4,16,137,445,582
2012,5,25,4,17,124,529,653
2012,5,25,4,18,131,389,520
2012,5,25,4,19,111,292,403
2012,5,25,4,20,80,270,350
2012,5,25,4,21,62,193,255
2012,5,25,4,22,65,147,212
2012,5,25,4,23,34,132,166
2012,5,26,5,0,18,98,116
2012,5,26,5,1,18,64,82
2012,5,26,5,2,9,55,64
2012,5,26,5,3,9,22,31
2012,5,26,5,4,0,1,1
2012,5,26,5,5,0,10,10
2012,5,26,5,6,6,25,31
2012,5,26,5,7,10,44,54
2012,5,26,5,8,38,103,141
2012,5,26,5,9,97,192,289
2012,5,26,5,10,181,256,437
2012,5,26,5,11,208,311,519
2012,5,26,5,12,236,293,529
2012,5,26,5,13,265,274,539
2012,5,26,5,14,307,256,563
2012,5,26,5,15,274,239,513
2012,5,26,5,16,261,243,504
2012,5,26,5,17,235,227,462
2012,5,26,5,18,199,216,415
2012,5,26,5,19,159,214,373
2012,5,26,5,20,103,152,255
2012,5,26,5,21,100,151,251
2012,5,26,5,22,86,118,204
2012,5,26,5,23,36,114,150
2012,5,27,6,0,48,89,137
2012,5,27,6,1,17,61,78
2012,5,27,6,2,16,45,61
2012,5,27,6,3,11,25,36
2012,5,27,6,4,4,6,10
2012,5,27,6,5,2,5,7
2012,5,27,6,6,8,14,22
2012,5,27,6,7,22,30,52
2012,5,27,6,8,69,82,151
2012,5,27,6,9,130,140,270
2012,5,27,6,10,209,215,424
2012,5,27,6,11,268,250,518
2012,5,27,6,12,301,269,570
2012,5,27,6,13,270,228,498
2012,5,27,6,14,317,230,547
2012,5,27,6,15,290,245,535
2012,5,27,6,16,258,243,501
2012,5,27,6,17,275,247,522
2012,5,27,6,18,266,252,518
2012,5,27,6,19,230,211,441
2012,5,27,6,20,168,224,392
2012,5,27,6,21,64,79,143
2012,5,27,6,22,9,50,59
2012,5,27,6,23,31,65,96
2012,5,28,0,0,21,44,65
2012,5,28,0,1,14,45,59
2012,5,28,0,2,20,28,48
2012,5,28,0,3,6,12,18
2012,5,28,0,4,2,4,6
2012,5,28,0,5,4,5,9
2012,5,28,0,6,6,14,20
2012,5,28,0,7,24,43,67
2012,5,28,0,8,62,93,155
2012,5,28,0,9,121,142,263
2012,5,28,0,10,189,175,364
2012,5,28,0,11,254,220,474
2012,5,28,0,12,233,291,524
2012,5,28,0,13,272,284,556
2012,5,28,0,14,238,227,465
2012,5,28,0,15,181,279,460
2012,5,28,0,16,223,276,499
2012,5,28,0,17,158,247,405
2012,5,28,0,18,132,251,383
2012,5,28,0,19,148,247,395
2012,5,28,0,20,114,203,317
2012,5,28,0,21,66,181,247
2012,5,28,0,22,47,110,157
2012,5,28,0,23,22,60,82
2012,5,29,1,0,12,33,45
2012,5,29,1,1,1,13,14
2012,5,29,1,2,0,8,8
2012,5,29,1,3,1,2,3
2012,5,29,1,4,0,5,5
2012,5,29,1,5,0,32,32
2012,5,29,1,6,9,145,154
2012,5,29,1,7,19,430,449
2012,5,29,1,8,46,588,634
2012,5,29,1,9,26,231,257
2012,5,29,1,10,67,116,183
2012,5,29,1,11,50,147,197
2012,5,29,1,12,56,181,237
2012,5,29,1,13,63,175,238
2012,5,29,1,14,80,158,238
2012,5,29,1,15,71,184,255
2012,5,29,1,16,73,320,393
2012,5,29,1,17,106,673,779
2012,5,29,1,18,78,632,710
2012,5,29,1,19,69,455,524
2012,5,29,1,20,36,167,203
2012,5,29,1,21,3,68,71
2012,5,29,1,22,2,52,54
2012,5,29,1,23,10,40,50
2012,5,30,2,0,4,31,35
2012,5,30,2,1,0,4,4
2012,5,30,2,2,1,4,5
2012,5,30,2,3,0,5,5
2012,5,30,2,4,0,5,5
2012,5,30,2,5,1,40,41
2012,5,30,2,6,5,139,144
2012,5,30,2,7,14,467,481
2012,5,30,2,8,29,641,670
2012,5,30,2,9,23,281,304
2012,5,30,2,10,39,138,177
2012,5,30,2,11,53,153,206
2012,5,30,2,12,33,220,253
2012,5,30,2,13,53,232,285
2012,5,30,2,14,44,208,252
2012,5,30,2,15,54,221,275
2012,5,30,2,16,46,352,398
2012,5,30,2,17,83,755,838
2012,5,30,2,18,50,746,796
2012,5,30,2,19,50,505,555
2012,5,30,2,20,57,374,431
2012,5,30,2,21,41,262,303
2012,5,30,2,22,26,191,217
2012,5,30,2,23,39,121,160
2012,5,31,3,0,13,48,61
2012,5,31,3,1,4,21,25
2012,5,31,3,2,6,8,14
2012,5,31,3,3,0,8,8
2012,5,31,3,4,0,6,6
2012,5,31,3,5,1,32,33
2012,5,31,3,6,7,170,177
2012,5,31,3,7,18,488,506
2012,5,31,3,8,18,674,692
2012,5,31,3,9,47,264,311
2012,5,31,3,10,65,155,220
2012,5,31,3,11,65,153,218
2012,5,31,3,12,62,230,292
2012,5,31,3,13,77,216,293
2012,5,31,3,14,61,193,254
2012,5,31,3,15,81,209,290
2012,5,31,3,16,103,384,487
2012,5,31,3,17,85,741,826
2012,5,31,3,18,84,699,783
2012,5,31,3,19,104,487,591
2012,5,31,3,20,88,390,478
2012,5,31,3,21,41,318,359
2012,5,31,3,22,43,221,264
2012,5,31,3,23,26,114,140
2012,6,1,4,0,10,75,85
2012,6,1,4,1,0,34,34
2012,6,1,4,2,3,13,16
2012,6,1,4,3,0,4,4
2012,6,1,4,4,1,5,6
2012,6,1,4,5,4,41,45
2012,6,1,4,6,5,136,141
2012,6,1,4,7,33,368,401
2012,6,1,4,8,19,673,692
2012,6,1,4,9,24,273,297
2012,6,1,4,10,49,155,204
2012,6,1,4,11,42,193,235
2012,6,1,4,12,72,238,310
2012,6,1,4,13,76,239,315
2012,6,1,4,14,55,199,254
2012,6,1,4,15,45,213,258
2012,6,1,4,16,35,186,221
2012,6,1,4,17,24,202,226
2012,6,1,4,18,10,99,109
2012,6,1,4,19,4,41,45
2012,6,1,4,20,1,38,39
2012,6,1,4,21,12,73,85
2012,6,1,4,22,1,22,23
2012,6,1,4,23,6,67,73
2012,6,2,5,0,5,81,86
2012,6,2,5,1,15,61,76
2012,6,2,5,2,3,38,41
2012,6,2,5,3,8,18,26
2012,6,2,5,4,2,11,13
2012,6,2,5,5,1,11,12
2012,6,2,5,6,5,31,36
2012,6,2,5,7,9,77,86
2012,6,2,5,8,30,180,210
2012,6,2,5,9,89,243,332
2012,6,2,5,10,145,347,492
2012,6,2,5,11,179,356,535
2012,6,2,5,12,250,418,668
2012,6,2,5,13,279,400,679
2012,6,2,5,14,259,388,647
2012,6,2,5,15,297,405,702
2012,6,2,5,16,275,369,644
2012,6,2,5,17,248,338,586
2012,6,2,5,18,171,341,512
2012,6,2,5,19,185,369,554
2012,6,2,5,20,139,260,399
2012,6,2,5,21,96,220,316
2012,6,2,5,22,52,176,228
2012,6,2,5,23,53,185,238
2012,6,3,6,0,27,142,169
2012,6,3,6,1,21,100,121
2012,6,3,6,2,22,67,89
2012,6,3,6,3,16,34,50
2012,6,3,6,4,1,12,13
2012,6,3,6,5,1,11,12
2012,6,3,6,6,6,16,22
2012,6,3,6,7,6,29,35
2012,6,3,6,8,30,110,140
2012,6,3,6,9,70,230,300
2012,6,3,6,10,127,277,404
2012,6,3,6,11,199,312,511
2012,6,3,6,12,276,408,684
2012,6,3,6,13,265,421,686
2012,6,3,6,14,267,411,678
2012,6,3,6,15,236,408,644
2012,6,3,6,16,226,436,662
2012,6,3,6,17,192,386,578
2012,6,3,6,18,153,343,496
2012,6,3,6,19,116,337,453
2012,6,3,6,20,84,230,314
2012,6,3,6,21,66,180,246
2012,6,3,6,22,61,165,226
2012,6,3,6,23,26,82,108
2012,6,4,0,0,11,38,49
2012,6,4,0,1,4,10,14
2012,6,4,0,2,1,10,11
2012,6,4,0,3,0,5,5
2012,6,4,0,4,2,6,8
2012,6,4,0,5,2,33,35
2012,6,4,0,6,4,135,139
2012,6,4,0,7,13,504,517
2012,6,4,0,8,22,640,662
2012,6,4,0,9,38,244,282
2012,6,4,0,10,67,120,187
2012,6,4,0,11,71,168,239
2012,6,4,0,12,62,220,282
2012,6,4,0,13,85,189,274
2012,6,4,0,14,84,186,270
2012,6,4,0,15,77,215,292
2012,6,4,0,16,73,375,448
2012,6,4,0,17,101,733,834
2012,6,4,0,18,103,718,821
2012,6,4,0,19,91,554,645
2012,6,4,0,20,71,390,461
2012,6,4,0,21,40,225,265
2012,6,4,0,22,41,127,168
2012,6,4,0,23,8,78,86
2012,6,5,1,0,6,28,34
2012,6,5,1,1,2,18,20
2012,6,5,1,2,0,8,8
2012,6,5,1,3,0,5,5
2012,6,5,1,4,1,4,5
2012,6,5,1,5,1,35,36
2012,6,5,1,6,7,177,184
2012,6,5,1,7,29,540,569
2012,6,5,1,8,29,680,709
2012,6,5,1,9,50,285,335
2012,6,5,1,10,58,118,176
2012,6,5,1,11,65,162,227
2012,6,5,1,12,45,202,247
2012,6,5,1,13,66,201,267
2012,6,5,1,14,82,193,275
2012,6,5,1,15,54,218,272
2012,6,5,1,16,91,382,473
2012,6,5,1,17,86,763,849
2012,6,5,1,18,111,679,790
2012,6,5,1,19,68,444,512
2012,6,5,1,20,44,371,415
2012,6,5,1,21,30,253,283
2012,6,5,1,22,22,171,193
2012,6,5,1,23,20,93,113
2012,6,6,2,0,3,46,49
2012,6,6,2,1,6,21,27
2012,6,6,2,2,4,7,11
2012,6,6,2,3,0,8,8
2012,6,6,2,4,3,7,10
2012,6,6,2,5,1,37,38
2012,6,6,2,6,7,164,171
2012,6,6,2,7,16,530,546
2012,6,6,2,8,30,635,665
2012,6,6,2,9,35,268,303
2012,6,6,2,10,55,148,203
2012,6,6,2,11,65,161,226
2012,6,6,2,12,80,235,315
2012,6,6,2,13,73,230,303
2012,6,6,2,14,111,191,302
2012,6,6,2,15,75,225,300
2012,6,6,2,16,107,345,452
2012,6,6,2,17,72,652,724
2012,6,6,2,18,94,688,782
2012,6,6,2,19,52,485,537
2012,6,6,2,20,59,348,407
2012,6,6,2,21,38,260,298
2012,6,6,2,22,27,221,248
2012,6,6,2,23,13,110,123
2012,6,7,3,0,9,50,59
2012,6,7,3,1,5,17,22
2012,6,7,3,2,0,12,12
2012,6,7,3,3,0,5,5
2012,6,7,3,4,0,6,6
2012,6,7,3,5,0,34,34
2012,6,7,3,6,5,165,170
2012,6,7,3,7,20,505,525
2012,6,7,3,8,20,660,680
2012,6,7,3,9,37,300,337
2012,6,7,3,10,56,154,210
2012,6,7,3,11,67,170,237
2012,6,7,3,12,62,274,336
2012,6,7,3,13,65,250,315
2012,6,7,3,14,67,198,265
2012,6,7,3,15,99,234,333
2012,6,7,3,16,77,389,466
2012,6,7,3,17,91,778,869
2012,6,7,3,18,110,701,811
2012,6,7,3,19,65,537,602
2012,6,7,3,20,76,401,477
2012,6,7,3,21,30,283,313
2012,6,7,3,22,35,193,228
2012,6,7,3,23,42,135,177
2012,6,8,4,0,18,59,77
2012,6,8,4,1,4,25,29
2012,6,8,4,2,2,17,19
2012,6,8,4,3,0,8,8
2012,6,8,4,4,1,9,10
2012,6,8,4,5,1,28,29
2012,6,8,4,6,8,131,139
2012,6,8,4,7,19,409,428
2012,6,8,4,8,37,663,700
2012,6,8,4,9,47,334,381
2012,6,8,4,10,62,187,249
2012,6,8,4,11,65,199,264
2012,6,8,4,12,89,279,368
2012,6,8,4,13,129,287,416
2012,6,8,4,14,128,244,372
2012,6,8,4,15,98,299,397
2012,6,8,4,16,111,411,522
2012,6,8,4,17,114,679,793
2012,6,8,4,18,147,575,722
2012,6,8,4,19,95,459,554
2012,6,8,4,20,117,291,408
2012,6,8,4,21,83,256,339
2012,6,8,4,22,61,230,291
2012,6,8,4,23,52,163,215
2012,6,9,5,0,54,152,206
2012,6,9,5,1,34,89,123
2012,6,9,5,2,21,68,89
2012,6,9,5,3,12,28,40
2012,6,9,5,4,2,6,8
2012,6,9,5,5,4,14,18
2012,6,9,5,6,17,63,80
2012,6,9,5,7,26,61,87
2012,6,9,5,8,42,202,244
2012,6,9,5,9,99,241,340
2012,6,9,5,10,168,298,466
2012,6,9,5,11,218,351,569
2012,6,9,5,12,196,335,531
2012,6,9,5,13,236,349,585
2012,6,9,5,14,239,354,593
2012,6,9,5,15,218,337,555
2012,6,9,5,16,219,315,534
2012,6,9,5,17,238,257,495
2012,6,9,5,18,174,276,450
2012,6,9,5,19,128,232,360
2012,6,9,5,20,125,238,363
2012,6,9,5,21,105,211,316
2012,6,9,5,22,63,151,214
2012,6,9,5,23,69,161,230
2012,6,10,6,0,33,125,158
2012,6,10,6,1,32,84,116
2012,6,10,6,2,17,56,73
2012,6,10,6,3,6,23,29
2012,6,10,6,4,1,9,10
2012,6,10,6,5,3,10,13
2012,6,10,6,6,3,27,30
2012,6,10,6,7,21,41,62
2012,6,10,6,8,59,122,181
2012,6,10,6,9,91,175,266
2012,6,10,6,10,148,265,413
2012,6,10,6,11,184,315,499
2012,6,10,6,12,173,329,502
2012,6,10,6,13,204,288,492
2012,6,10,6,14,186,314,500
2012,6,10,6,15,158,316,474
2012,6,10,6,16,173,334,507
2012,6,10,6,17,184,337,521
2012,6,10,6,18,164,326,490
2012,6,10,6,19,115,259,374
2012,6,10,6,20,113,250,363
2012,6,10,6,21,83,170,253
2012,6,10,6,22,42,117,159
2012,6,10,6,23,30,80,110
2012,6,11,0,0,8,33,41
2012,6,11,0,1,9,15,24
2012,6,11,0,2,5,12,17
2012,6,11,0,3,2,4,6
2012,6,11,0,4,0,7,7
2012,6,11,0,5,1,36,37
2012,6,11,0,6,8,136,144
2012,6,11,0,7,25,477,502
2012,6,11,0,8,38,611,649
2012,6,11,0,9,57,258,315
2012,6,11,0,10,52,95,147
2012,6,11,0,11,59,143,202
2012,6,11,0,12,63,198,261
2012,6,11,0,13,63,184,247
2012,6,11,0,14,66,193,259
2012,6,11,0,15,72,185,257
2012,6,11,0,16,87,340,427
2012,6,11,0,17,85,715,800
2012,6,11,0,18,105,725,830
2012,6,11,0,19,88,507,595
2012,6,11,0,20,61,333,394
2012,6,11,0,21,32,218,250
2012,6,11,0,22,22,142,164
2012,6,11,0,23,8,72,80
2012,6,12,1,0,2,26,28
2012,6,12,1,1,5,11,16
2012,6,12,1,2,0,6,6
2012,6,12,1,3,3,9,12
2012,6,12,1,4,0,4,4
2012,6,12,1,5,1,27,28
2012,6,12,1,6,6,129,135
2012,6,12,1,7,16,287,303
2012,6,12,1,8,15,595,610
2012,6,12,1,9,31,253,284
2012,6,12,1,10,29,94,123
2012,6,12,1,11,8,57,65
2012,6,12,1,12,19,76,95
2012,6,12,1,13,11,48,59
2012,6,12,1,14,12,48,60
2012,6,12,1,15,22,94,116
2012,6,12,1,16,30,209,239
2012,6,12,1,17,56,625,681
2012,6,12,1,18,57,596,653
2012,6,12,1,19,47,444,491
2012,6,12,1,20,36,348,384
2012,6,12,1,21,41,232,273
2012,6,12,1,22,19,188,207
2012,6,12,1,23,11,78,89
2012,6,13,2,0,7,27,34
2012,6,13,2,1,7,21,28
2012,6,13,2,2,0,4,4
2012,6,13,2,3,1,7,8
2012,6,13,2,4,1,9,10
2012,6,13,2,5,2,36,38
2012,6,13,2,6,6,187,193
2012,6,13,2,7,25,479,504
2012,6,13,2,8,41,672,713
2012,6,13,2,9,54,298,352
2012,6,13,2,10,64,134,198
2012,6,13,2,11,64,182,246
2012,6,13,2,12,93,241,334
2012,6,13,2,13,52,203,255
2012,6,13,2,14,98,222,320
2012,6,13,2,15,65,216,281
2012,6,13,2,16,72,320,392
2012,6,13,2,17,75,782,857
2012,6,13,2,18,104,640,744
2012,6,13,2,19,123,548,671
2012,6,13,2,20,86,361,447
2012,6,13,2,21,79,317,396
2012,6,13,2,22,29,209,238
2012,6,13,2,23,25,128,153
2012,6,14,3,0,3,45,48
2012,6,14,3,1,4,17,21
2012,6,14,3,2,1,8,9
2012,6,14,3,3,1,4,5
2012,6,14,3,4,0,6,6
2012,6,14,3,5,0,40,40
2012,6,14,3,6,12,169,181
2012,6,14,3,7,26,480,506
2012,6,14,3,8,37,681,718
2012,6,14,3,9,45,312,357
2012,6,14,3,10,47,132,179
2012,6,14,3,11,60,168,228
2012,6,14,3,12,55,209,264
2012,6,14,3,13,71,212,283
2012,6,14,3,14,84,214,298
2012,6,14,3,15,111,212,323
2012,6,14,3,16,70,368,438
2012,6,14,3,17,117,750,867
2012,6,14,3,18,107,716,823
2012,6,14,3,19,96,483,579
2012,6,14,3,20,84,351,435
2012,6,14,3,21,67,270,337
2012,6,14,3,22,46,196,242
2012,6,14,3,23,36,136,172
2012,6,15,4,0,26,68,94
2012,6,15,4,1,9,42,51
2012,6,15,4,2,0,15,15
2012,6,15,4,3,2,3,5
2012,6,15,4,4,1,13,14
2012,6,15,4,5,2,31,33
2012,6,15,4,6,9,142,151
2012,6,15,4,7,17,412,429
2012,6,15,4,8,44,608,652
2012,6,15,4,9,58,305,363
2012,6,15,4,10,56,159,215
2012,6,15,4,11,106,180,286
2012,6,15,4,12,111,291,402
2012,6,15,4,13,121,271,392
2012,6,15,4,14,121,254,375
2012,6,15,4,15,107,270,377
2012,6,15,4,16,132,426,558
2012,6,15,4,17,125,698,823
2012,6,15,4,18,121,572,693
2012,6,15,4,19,98,369,467
2012,6,15,4,20,89,296,385
2012,6,15,4,21,83,250,333
2012,6,15,4,22,79,242,321
2012,6,15,4,23,46,176,222
2012,6,16,5,0,25,112,137
2012,6,16,5,1,16,79,95
2012,6,16,5,2,12,55,67
2012,6,16,5,3,8,19,27
2012,6,16,5,4,3,5,8
2012,6,16,5,5,2,21,23
2012,6,16,5,6,11,36,47
2012,6,16,5,7,10,68,78
2012,6,16,5,8,47,157,204
2012,6,16,5,9,88,279,367
2012,6,16,5,10,139,296,435
2012,6,16,5,11,213,353,566
2012,6,16,5,12,254,348,602
2012,6,16,5,13,293,324,617
2012,6,16,5,14,263,307,570
2012,6,16,5,15,295,288,583
2012,6,16,5,16,238,304,542
2012,6,16,5,17,244,349,593
2012,6,16,5,18,256,315,571
2012,6,16,5,19,184,277,461
2012,6,16,5,20,123,229,352
2012,6,16,5,21,98,192,290
2012,6,16,5,22,91,189,280
2012,6,16,5,23,49,134,183
2012,6,17,6,0,31,117,148
2012,6,17,6,1,21,67,88
2012,6,17,6,2,19,55,74
2012,6,17,6,3,6,22,28
2012,6,17,6,4,2,16,18
2012,6,17,6,5,4,13,17
2012,6,17,6,6,7,16,23
2012,6,17,6,7,18,30,48
2012,6,17,6,8,24,95,119
2012,6,17,6,9,91,183,274
2012,6,17,6,10,148,287,435
2012,6,17,6,11,196,350,546
2012,6,17,6,12,260,353,613
2012,6,17,6,13,267,347,614
2012,6,17,6,14,255,325,580
2012,6,17,6,15,203,260,463
2012,6,17,6,16,240,335,575
2012,6,17,6,17,232,361,593
2012,6,17,6,18,203,310,513
2012,6,17,6,19,146,244,390
2012,6,17,6,20,101,201,302
2012,6,17,6,21,76,170,246
2012,6,17,6,22,55,98,153
2012,6,17,6,23,29,79,108
2012,6,18,0,0,12,28,40
2012,6,18,0,1,9,5,14
2012,6,18,0,2,3,6,9
2012,6,18,0,3,1,3,4
2012,6,18,0,4,0,9,9
2012,6,18,0,5,1,21,22
2012,6,18,0,6,0,37,37
2012,6,18,0,7,10,135,145
2012,6,18,0,8,27,446,473
2012,6,18,0,9,28,221,249
2012,6,18,0,10,13,78,91
2012,6,18,0,11,25,96,121
2012,6,18,0,12,29,139,168
2012,6,18,0,13,51,174,225
2012,6,18,0,14,59,160,219
2012,6,18,0,15,61,176,237
2012,6,18,0,16,53,279,332
2012,6,18,0,17,54,669,723
2012,6,18,0,18,47,595,642
2012,6,18,0,19,51,410,461
2012,6,18,0,20,45,317,362
2012,6,18,0,21,35,237,272
2012,6,18,0,22,21,142,163
2012,6,18,0,23,17,57,74
2012,6,19,1,0,5,30,35
2012,6,19,1,1,1,13,14
2012,6,19,1,2,1,14,15
2012,6,19,1,3,1,7,8
2012,6,19,1,4,1,9,10
2012,6,19,1,5,3,34,37
2012,6,19,1,6,9,151,160
2012,6,19,1,7,18,461,479
2012,6,19,1,8,40,630,670
2012,6,19,1,9,40,288,328
2012,6,19,1,10,44,135,179
2012,6,19,1,11,56,174,230
2012,6,19,1,12,70,221,291
2012,6,19,1,13,69,202,271
2012,6,19,1,14,61,165,226
2012,6,19,1,15,72,187,259
2012,6,19,1,16,48,286,334
2012,6,19,1,17,86,725,811
2012,6,19,1,18,90,703,793
2012,6,19,1,19,82,432,514
2012,6,19,1,20,59,397,456
2012,6,19,1,21,37,239,276
2012,6,19,1,22,51,240,291
2012,6,19,1,23,23,102,125
2012,6,20,2,0,5,48,53
2012,6,20,2,1,7,20,27
2012,6,20,2,2,1,5,6
2012,6,20,2,3,2,6,8
2012,6,20,2,4,1,6,7
2012,6,20,2,5,2,37,39
2012,6,20,2,6,9,156,165
2012,6,20,2,7,20,442,462
2012,6,20,2,8,42,597,639
2012,6,20,2,9,40,274,314
2012,6,20,2,10,41,126,167
2012,6,20,2,11,54,134,188
2012,6,20,2,12,30,150,180
2012,6,20,2,13,48,163,211
2012,6,20,2,14,56,134,190
2012,6,20,2,15,36,143,179
2012,6,20,2,16,51,283,334
2012,6,20,2,17,80,609,689
2012,6,20,2,18,81,591,672
2012,6,20,2,19,89,449,538
2012,6,20,2,20,81,324,405
2012,6,20,2,21,42,302,344
2012,6,20,2,22,31,226,257
2012,6,20,2,23,21,101,122
2012,6,21,3,0,16,53,69
2012,6,21,3,1,2,16,18
2012,6,21,3,2,11,7,18
2012,6,21,3,3,3,8,11
2012,6,21,3,4,1,11,12
2012,6,21,3,5,3,36,39
2012,6,21,3,6,3,146,149
2012,6,21,3,7,26,436,462
2012,6,21,3,8,27,561,588
2012,6,21,3,9,32,224,256
2012,6,21,3,10,36,114,150
2012,6,21,3,11,40,120,160
2012,6,21,3,12,33,182,215
2012,6,21,3,13,31,140,171
2012,6,21,3,14,27,149,176
2012,6,21,3,15,40,152,192
2012,6,21,3,16,37,282,319
2012,6,21,3,17,80,535,615
2012,6,21,3,18,77,562,639
2012,6,21,3,19,83,415,498
2012,6,21,3,20,79,355,434
2012,6,21,3,21,55,256,311
2012,6,21,3,22,22,221,243
2012,6,21,3,23,12,134,146
2012,6,22,4,0,16,77,93
2012,6,22,4,1,3,28,31
2012,6,22,4,2,0,12,12
2012,6,22,4,3,1,6,7
2012,6,22,4,4,3,7,10
2012,6,22,4,5,3,35,38
2012,6,22,4,6,4,117,121
2012,6,22,4,7,19,339,358
2012,6,22,4,8,49,561,610
2012,6,22,4,9,55,278,333
2012,6,22,4,10,52,133,185
2012,6,22,4,11,75,158,233
2012,6,22,4,12,63,191,254
2012,6,22,4,13,71,227,298
2012,6,22,4,14,65,198,263
2012,6,22,4,15,72,212,284
2012,6,22,4,16,67,313,380
2012,6,22,4,17,95,551,646
2012,6,22,4,18,61,441,502
2012,6,22,4,19,45,317,362
2012,6,22,4,20,31,171,202
2012,6,22,4,21,40,177,217
2012,6,22,4,22,42,155,197
2012,6,22,4,23,29,145,174
2012,6,23,5,0,14,102,116
2012,6,23,5,1,16,107,123
2012,6,23,5,2,18,75,93
2012,6,23,5,3,9,32,41
2012,6,23,5,4,6,13,19
2012,6,23,5,5,1,11,12
2012,6,23,5,6,10,37,47
2012,6,23,5,7,19,59,78
2012,6,23,5,8,34,133,167
2012,6,23,5,9,85,247,332
2012,6,23,5,10,177,317,494
2012,6,23,5,11,167,348,515
2012,6,23,5,12,203,399,602
2012,6,23,5,13,226,337,563
2012,6,23,5,14,238,371,609
2012,6,23,5,15,217,266,483
2012,6,23,5,16,196,316,512
2012,6,23,5,17,214,316,530
2012,6,23,5,18,194,287,481
2012,6,23,5,19,184,239,423
2012,6,23,5,20,158,228,386
2012,6,23,5,21,99,223,322
2012,6,23,5,22,101,178,279
2012,6,23,5,23,69,156,225
2012,6,24,6,0,31,132,163
2012,6,24,6,1,39,88,127
2012,6,24,6,2,34,80,114
2012,6,24,6,3,19,41,60
2012,6,24,6,4,4,9,13
2012,6,24,6,5,1,7,8
2012,6,24,6,6,6,19,25
2012,6,24,6,7,23,48,71
2012,6,24,6,8,38,103,141
2012,6,24,6,9,63,169,232
2012,6,24,6,10,161,291,452
2012,6,24,6,11,215,290,505
2012,6,24,6,12,227,329,556
2012,6,24,6,13,237,348,585
2012,6,24,6,14,253,298,551
2012,6,24,6,15,197,289,486
2012,6,24,6,16,181,280,461
2012,6,24,6,17,203,329,532
2012,6,24,6,18,186,348,534
2012,6,24,6,19,176,247,423
2012,6,24,6,20,108,224,332
2012,6,24,6,21,76,177,253
2012,6,24,6,22,53,125,178
2012,6,24,6,23,20,67,87
2012,6,25,0,0,31,37,68
2012,6,25,0,1,11,20,31
2012,6,25,0,2,4,10,14
2012,6,25,0,3,1,4,5
2012,6,25,0,4,0,4,4
2012,6,25,0,5,1,42,43
2012,6,25,0,6,11,145,156
2012,6,25,0,7,30,454,484
2012,6,25,0,8,53,553,606
2012,6,25,0,9,37,231,268
2012,6,25,0,10,58,125,183
2012,6,25,0,11,54,127,181
2012,6,25,0,12,74,196,270
2012,6,25,0,13,79,180,259
2012,6,25,0,14,90,161,251
2012,6,25,0,15,65,168,233
2012,6,25,0,16,104,310,414
2012,6,25,0,17,76,757,833
2012,6,25,0,18,100,690,790
2012,6,25,0,19,74,508,582
2012,6,25,0,20,100,373,473
2012,6,25,0,21,50,281,331
2012,6,25,0,22,21,166,187
2012,6,25,0,23,15,88,103
2012,6,26,1,0,8,29,37
2012,6,26,1,1,11,19,30
2012,6,26,1,2,2,7,9
2012,6,26,1,3,2,7,9
2012,6,26,1,4,1,7,8
2012,6,26,1,5,3,36,39
2012,6,26,1,6,12,175,187
2012,6,26,1,7,21,528,549
2012,6,26,1,8,34,621,655
2012,6,26,1,9,30,298,328
2012,6,26,1,10,37,152,189
2012,6,26,1,11,46,189,235
2012,6,26,1,12,80,228,308
2012,6,26,1,13,74,232,306
2012,6,26,1,14,81,186,267
2012,6,26,1,15,88,226,314
2012,6,26,1,16,67,349,416
2012,6,26,1,17,104,793,897
2012,6,26,1,18,105,719,824
2012,6,26,1,19,83,529,612
2012,6,26,1,20,88,414,502
2012,6,26,1,21,61,267,328
2012,6,26,1,22,26,219,245
2012,6,26,1,23,13,118,131
2012,6,27,2,0,15,39,54
2012,6,27,2,1,5,18,23
2012,6,27,2,2,2,12,14
2012,6,27,2,3,1,7,8
2012,6,27,2,4,0,11,11
2012,6,27,2,5,2,34,36
2012,6,27,2,6,7,192,199
2012,6,27,2,7,29,498,527
2012,6,27,2,8,49,637,686
2012,6,27,2,9,29,252,281
2012,6,27,2,10,34,138,172
2012,6,27,2,11,64,145,209
2012,6,27,2,12,77,244,321
2012,6,27,2,13,77,244,321
2012,6,27,2,14,78,191,269
2012,6,27,2,15,61,186,247
2012,6,27,2,16,55,336,391
2012,6,27,2,17,113,730,843
2012,6,27,2,18,85,718,803
2012,6,27,2,19,101,540,641
2012,6,27,2,20,76,368,444
2012,6,27,2,21,54,313,367
2012,6,27,2,22,52,245,297
2012,6,27,2,23,11,148,159
2012,6,28,3,0,2,52,54
2012,6,28,3,1,11,14,25
2012,6,28,3,2,1,12,13
2012,6,28,3,3,1,6,7
2012,6,28,3,4,0,11,11
2012,6,28,3,5,8,39,47
2012,6,28,3,6,8,183,191
2012,6,28,3,7,24,484,508
2012,6,28,3,8,40,575,615
2012,6,28,3,9,33,317,350
2012,6,28,3,10,40,144,184
2012,6,28,3,11,41,170,211
2012,6,28,3,12,49,227,276
2012,6,28,3,13,31,204,235
2012,6,28,3,14,66,188,254
2012,6,28,3,15,24,194,218
2012,6,28,3,16,56,331,387
2012,6,28,3,17,71,633,704
2012,6,28,3,18,100,597,697
2012,6,28,3,19,79,491,570
2012,6,28,3,20,71,397,468
2012,6,28,3,21,89,309,398
2012,6,28,3,22,50,224,274
2012,6,28,3,23,26,145,171
2012,6,29,4,0,24,90,114
2012,6,29,4,1,9,33,42
2012,6,29,4,2,3,15,18
2012,6,29,4,3,3,5,8
2012,6,29,4,4,1,8,9
2012,6,29,4,5,6,39,45
2012,6,29,4,6,15,147,162
2012,6,29,4,7,19,361,380
2012,6,29,4,8,48,574,622
2012,6,29,4,9,39,260,299
2012,6,29,4,10,32,139,171
2012,6,29,4,11,51,137,188
2012,6,29,4,12,53,173,226
2012,6,29,4,13,45,194,239
2012,6,29,4,14,49,183,232
2012,6,29,4,15,47,183,230
2012,6,29,4,16,59,291,350
2012,6,29,4,17,82,457,539
2012,6,29,4,18,50,413,463
2012,6,29,4,19,60,303,363
2012,6,29,4,20,53,255,308
2012,6,29,4,21,41,195,236
2012,6,29,4,22,34,129,163
2012,6,29,4,23,6,42,48
2012,6,30,5,0,4,65,69
2012,6,30,5,1,3,55,58
2012,6,30,5,2,7,54,61
2012,6,30,5,3,3,20,23
2012,6,30,5,4,3,13,16
2012,6,30,5,5,3,7,10
2012,6,30,5,6,6,36,42
2012,6,30,5,7,10,82,92
2012,6,30,5,8,26,168,194
2012,6,30,5,9,41,234,275
2012,6,30,5,10,96,308,404
2012,6,30,5,11,102,350,452
2012,6,30,5,12,143,328,471
2012,6,30,5,13,105,323,428
2012,6,30,5,14,114,294,408
2012,6,30,5,15,117,287,404
2012,6,30,5,16,109,264,373
2012,6,30,5,17,131,229,360
2012,6,30,5,18,90,247,337
2012,6,30,5,19,134,240,374
2012,6,30,5,20,88,204,292
2012,6,30,5,21,48,165,213
2012,6,30,5,22,38,133,171
2012,6,30,5,23,33,119,152
2012,7,1,6,0,27,122,149
2012,7,1,6,1,12,81,93
2012,7,1,6,2,21,69,90
2012,7,1,6,3,6,27,33
2012,7,1,6,4,0,4,4
2012,7,1,6,5,3,7,10
2012,7,1,6,6,8,19,27
2012,7,1,6,7,13,37,50
2012,7,1,6,8,36,106,142
2012,7,1,6,9,51,168,219
2012,7,1,6,10,98,268,366
2012,7,1,6,11,121,256,377
2012,7,1,6,12,114,319,433
2012,7,1,6,13,111,309,420
2012,7,1,6,14,98,346,444
2012,7,1,6,15,101,244,345
2012,7,1,6,16,85,228,313
2012,7,1,6,17,90,323,413
2012,7,1,6,18,95,275,370
2012,7,1,6,19,103,279,382
2012,7,1,6,20,88,244,332
2012,7,1,6,21,77,181,258
2012,7,1,6,22,41,110,151
2012,7,1,6,23,22,88,110
2012,7,2,0,0,12,31,43
2012,7,2,0,1,3,14,17
2012,7,2,0,2,1,14,15
2012,7,2,0,3,0,5,5
2012,7,2,0,4,2,10,12
2012,7,2,0,5,3,37,40
2012,7,2,0,6,4,132,136
2012,7,2,0,7,8,390,398
2012,7,2,0,8,20,548,568
2012,7,2,0,9,56,239,295
2012,7,2,0,10,70,104,174
2012,7,2,0,11,67,134,201
2012,7,2,0,12,74,183,257
2012,7,2,0,13,74,162,236
2012,7,2,0,14,79,151,230
2012,7,2,0,15,59,175,234
2012,7,2,0,16,61,304,365
2012,7,2,0,17,82,665,747
2012,7,2,0,18,72,658,730
2012,7,2,0,19,71,510,581
2012,7,2,0,20,38,357,395
2012,7,2,0,21,17,241,258
2012,7,2,0,22,19,169,188
2012,7,2,0,23,12,90,102
2012,7,3,1,0,9,44,53
2012,7,3,1,1,5,9,14
2012,7,3,1,2,2,8,10
2012,7,3,1,3,0,2,2
2012,7,3,1,4,0,6,6
2012,7,3,1,5,2,33,35
2012,7,3,1,6,5,149,154
2012,7,3,1,7,21,462,483
2012,7,3,1,8,42,604,646
2012,7,3,1,9,46,226,272
2012,7,3,1,10,56,153,209
2012,7,3,1,11,66,151,217
2012,7,3,1,12,74,198,272
2012,7,3,1,13,80,203,283
2012,7,3,1,14,69,241,310
2012,7,3,1,15,71,330,401
2012,7,3,1,16,90,437,527
2012,7,3,1,17,102,620,722
2012,7,3,1,18,85,542,627
2012,7,3,1,19,66,431,497
2012,7,3,1,20,80,296,376
2012,7,3,1,21,36,160,196
2012,7,3,1,22,26,151,177
2012,7,3,1,23,19,152,171
2012,7,4,2,0,19,140,159
2012,7,4,2,1,27,96,123
2012,7,4,2,2,27,66,93
2012,7,4,2,3,9,23,32
2012,7,4,2,4,5,11,16
2012,7,4,2,5,5,14,19
2012,7,4,2,6,9,23,32
2012,7,4,2,7,10,62,72
2012,7,4,2,8,43,110,153
2012,7,4,2,9,90,203,293
2012,7,4,2,10,143,304,447
2012,7,4,2,11,164,321,485
2012,7,4,2,12,164,330,494
2012,7,4,2,13,177,322,499
2012,7,4,2,14,190,357,547
2012,7,4,2,15,155,299,454
2012,7,4,2,16,163,226,389
2012,7,4,2,17,161,253,414
2012,7,4,2,18,159,271,430
2012,7,4,2,19,177,255,432
2012,7,4,2,20,237,314,551
2012,7,4,2,21,222,362,584
2012,7,4,2,22,175,327,502
2012,7,4,2,23,31,152,183
2012,7,5,3,0,17,71,88
2012,7,5,3,1,6,24,30
2012,7,5,3,2,4,14,18
2012,7,5,3,3,2,5,7
2012,7,5,3,4,0,7,7
2012,7,5,3,5,1,28,29
2012,7,5,3,6,3,130,133
2012,7,5,3,7,27,316,343
2012,7,5,3,8,36,514,550
2012,7,5,3,9,47,246,293
2012,7,5,3,10,69,117,186
2012,7,5,3,11,107,137,244
2012,7,5,3,12,88,188,276
2012,7,5,3,13,129,181,310
2012,7,5,3,14,87,154,241
2012,7,5,3,15,71,183,254
2012,7,5,3,16,109,324,433
2012,7,5,3,17,114,575,689
2012,7,5,3,18,96,511,607
2012,7,5,3,19,128,375,503
2012,7,5,3,20,78,243,321
2012,7,5,3,21,91,232,323
2012,7,5,3,22,63,162,225
2012,7,5,3,23,32,99,131
2012,7,6,4,0,39,63,102
2012,7,6,4,1,7,22,29
2012,7,6,4,2,4,13,17
2012,7,6,4,3,1,6,7
2012,7,6,4,4,2,4,6
2012,7,6,4,5,4,31,35
2012,7,6,4,6,4,127,131
2012,7,6,4,7,20,333,353
2012,7,6,4,8,28,557,585
2012,7,6,4,9,55,249,304
2012,7,6,4,10,80,130,210
2012,7,6,4,11,92,141,233
2012,7,6,4,12,111,220,331
2012,7,6,4,13,99,194,293
2012,7,6,4,14,91,184,275
2012,7,6,4,15,79,206,285
2012,7,6,4,16,69,300,369
2012,7,6,4,17,90,486,576
2012,7,6,4,18,106,454,560
2012,7,6,4,19,112,306,418
2012,7,6,4,20,91,245,336
2012,7,6,4,21,77,223,300
2012,7,6,4,22,78,210,288
2012,7,6,4,23,27,137,164
2012,7,7,5,0,35,115,150
2012,7,7,5,1,16,55,71
2012,7,7,5,2,11,47,58
2012,7,7,5,3,12,19,31
2012,7,7,5,4,3,13,16
2012,7,7,5,5,2,12,14
2012,7,7,5,6,4,27,31
2012,7,7,5,7,8,63,71
2012,7,7,5,8,32,120,152
2012,7,7,5,9,69,187,256
2012,7,7,5,10,100,225,325
2012,7,7,5,11,122,245,367
2012,7,7,5,12,124,218,342
2012,7,7,5,13,116,244,360
2012,7,7,5,14,105,203,308
2012,7,7,5,15,113,193,306
2012,7,7,5,16,102,192,294
2012,7,7,5,17,103,176,279
2012,7,7,5,18,83,194,277
2012,7,7,5,19,68,219,287
2012,7,7,5,20,79,197,276
2012,7,7,5,21,51,150,201
2012,7,7,5,22,56,164,220
2012,7,7,5,23,34,114,148
2012,7,8,6,0,22,125,147
2012,7,8,6,1,25,99,124
2012,7,8,6,2,11,59,70
2012,7,8,6,3,1,34,35
2012,7,8,6,4,2,11,13
2012,7,8,6,5,1,5,6
2012,7,8,6,6,5,16,21
2012,7,8,6,7,19,33,52
2012,7,8,6,8,35,95,130
2012,7,8,6,9,70,172,242
2012,7,8,6,10,85,234,319
2012,7,8,6,11,120,269,389
2012,7,8,6,12,105,271,376
2012,7,8,6,13,118,219,337
2012,7,8,6,14,77,235,312
2012,7,8,6,15,80,218,298
2012,7,8,6,16,65,226,291
2012,7,8,6,17,68,202,270
2012,7,8,6,18,54,199,253
2012,7,8,6,19,66,184,250
2012,7,8,6,20,79,206,285
2012,7,8,6,21,58,149,207
2012,7,8,6,22,12,110,122
2012,7,8,6,23,25,98,123
2012,7,9,0,0,6,33,39
2012,7,9,0,1,5,13,18
2012,7,9,0,2,1,4,5
2012,7,9,0,3,0,5,5
2012,7,9,0,4,1,1,2
2012,7,9,0,5,1,27,28
2012,7,9,0,6,6,86,92
2012,7,9,0,7,7,223,230
2012,7,9,0,8,26,429,455
2012,7,9,0,9,38,325,363
2012,7,9,0,10,58,117,175
2012,7,9,0,11,72,144,216
2012,7,9,0,12,61,205,266
2012,7,9,0,13,67,188,255
2012,7,9,0,14,58,184,242
2012,7,9,0,15,66,214,280
2012,7,9,0,16,88,325,413
2012,7,9,0,17,108,741,849
2012,7,9,0,18,82,790,872
2012,7,9,0,19,88,543,631
2012,7,9,0,20,69,378,447
2012,7,9,0,21,33,298,331
2012,7,9,0,22,35,189,224
2012,7,9,0,23,22,109,131
2012,7,10,1,0,16,53,69
2012,7,10,1,1,0,15,15
2012,7,10,1,2,1,15,16
2012,7,10,1,3,0,3,3
2012,7,10,1,4,0,4,4
2012,7,10,1,5,3,39,42
2012,7,10,1,6,4,183,187
2012,7,10,1,7,31,489,520
2012,7,10,1,8,34,615,649
2012,7,10,1,9,47,284,331
2012,7,10,1,10,56,134,190
2012,7,10,1,11,92,157,249
2012,7,10,1,12,69,203,272
2012,7,10,1,13,77,203,280
2012,7,10,1,14,71,171,242
2012,7,10,1,15,77,188,265
2012,7,10,1,16,89,346,435
2012,7,10,1,17,103,769,872
2012,7,10,1,18,70,749,819
2012,7,10,1,19,55,359,414
2012,7,10,1,20,9,75,84
2012,7,10,1,21,7,83,90
2012,7,10,1,22,14,125,139
2012,7,10,1,23,29,74,103
2012,7,11,2,0,6,38,44
2012,7,11,2,1,3,11,14
2012,7,11,2,2,0,5,5
2012,7,11,2,3,0,5,5
2012,7,11,2,4,1,6,7
2012,7,11,2,5,5,36,41
2012,7,11,2,6,17,168,185
2012,7,11,2,7,26,471,497
2012,7,11,2,8,30,644,674
2012,7,11,2,9,30,298,328
2012,7,11,2,10,47,148,195
2012,7,11,2,11,56,173,229
2012,7,11,2,12,69,223,292
2012,7,11,2,13,65,208,273
2012,7,11,2,14,66,175,241
2012,7,11,2,15,56,220,276
2012,7,11,2,16,53,358,411
2012,7,11,2,17,90,740,830
2012,7,11,2,18,79,735,814
2012,7,11,2,19,73,560,633
2012,7,11,2,20,73,410,483
2012,7,11,2,21,69,322,391
2012,7,11,2,22,41,203,244
2012,7,11,2,23,20,132,152
2012,7,12,3,0,1,55,56
2012,7,12,3,1,0,21,21
2012,7,12,3,2,0,9,9
2012,7,12,3,3,0,10,10
2012,7,12,3,4,0,5,5
2012,7,12,3,5,4,40,44
2012,7,12,3,6,7,171,178
2012,7,12,3,7,32,480,512
2012,7,12,3,8,49,653,702
2012,7,12,3,9,42,285,327
2012,7,12,3,10,69,145,214
2012,7,12,3,11,49,166,215
2012,7,12,3,12,71,221,292
2012,7,12,3,13,52,225,277
2012,7,12,3,14,42,167,209
2012,7,12,3,15,63,208,271
2012,7,12,3,16,69,370,439
2012,7,12,3,17,91,704,795
2012,7,12,3,18,86,739,825
2012,7,12,3,19,97,532,629
2012,7,12,3,20,75,439,514
2012,7,12,3,21,44,329,373
2012,7,12,3,22,56,262,318
2012,7,12,3,23,33,178,211
2012,7,13,4,0,19,76,95
2012,7,13,4,1,17,42,59
2012,7,13,4,2,2,15,17
2012,7,13,4,3,2,7,9
2012,7,13,4,4,0,11,11
2012,7,13,4,5,4,30,34
2012,7,13,4,6,7,120,127
2012,7,13,4,7,27,353,380
2012,7,13,4,8,53,660,713
2012,7,13,4,9,70,344,414
2012,7,13,4,10,78,190,268
2012,7,13,4,11,68,220,288
2012,7,13,4,12,125,254,379
2012,7,13,4,13,100,274,374
2012,7,13,4,14,120,249,369
2012,7,13,4,15,92,261,353
2012,7,13,4,16,111,381,492
2012,7,13,4,17,138,697,835
2012,7,13,4,18,108,523,631
2012,7,13,4,19,103,385,488
2012,7,13,4,20,95,294,389
2012,7,13,4,21,76,223,299
2012,7,13,4,22,59,204,263
2012,7,13,4,23,37,175,212
2012,7,14,5,0,35,156,191
2012,7,14,5,1,13,105,118
2012,7,14,5,2,10,91,101
2012,7,14,5,3,9,31,40
2012,7,14,5,4,3,6,9
2012,7,14,5,5,0,5,5
2012,7,14,5,6,6,29,35
2012,7,14,5,7,7,41,48
2012,7,14,5,8,33,118,151
2012,7,14,5,9,82,200,282
2012,7,14,5,10,123,278,401
2012,7,14,5,11,143,296,439
2012,7,14,5,12,181,318,499
2012,7,14,5,13,219,372,591
2012,7,14,5,14,269,363,632
2012,7,14,5,15,243,317,560
2012,7,14,5,16,226,340,566
2012,7,14,5,17,199,259,458
2012,7,14,5,18,108,243,351
2012,7,14,5,19,156,275,431
2012,7,14,5,20,101,255,356
2012,7,14,5,21,69,200,269
2012,7,14,5,22,65,160,225
2012,7,14,5,23,55,156,211
2012,7,15,6,0,40,147,187
2012,7,15,6,1,49,119,168
2012,7,15,6,2,29,86,115
2012,7,15,6,3,15,42,57
2012,7,15,6,4,8,11,19
2012,7,15,6,5,2,7,9
2012,7,15,6,6,6,9,15
2012,7,15,6,7,17,30,47
2012,7,15,6,8,37,96,133
2012,7,15,6,9,58,163,221
2012,7,15,6,10,141,241,382
2012,7,15,6,11,170,281,451
2012,7,15,6,12,153,336,489
2012,7,15,6,13,171,309,480
2012,7,15,6,14,162,314,476
2012,7,15,6,15,182,307,489
2012,7,15,6,16,152,343,495
2012,7,15,6,17,122,314,436
2012,7,15,6,18,84,228,312
2012,7,15,6,19,109,203,312
2012,7,15,6,20,95,199,294
2012,7,15,6,21,59,164,223
2012,7,15,6,22,34,96,130
2012,7,15,6,23,25,66,91
2012,7,16,0,0,11,32,43
2012,7,16,0,1,1,10,11
2012,7,16,0,2,4,11,15
2012,7,16,0,3,2,4,6
2012,7,16,0,4,1,11,12
2012,7,16,0,5,10,40,50
2012,7,16,0,6,8,132,140
2012,7,16,0,7,24,459,483
2012,7,16,0,8,48,619,667
2012,7,16,0,9,51,297,348
2012,7,16,0,10,69,117,186
2012,7,16,0,11,57,125,182
2012,7,16,0,12,79,158,237
2012,7,16,0,13,63,176,239
2012,7,16,0,14,53,159,212
2012,7,16,0,15,61,176,237
2012,7,16,0,16,77,309,386
2012,7,16,0,17,86,669,755
2012,7,16,0,18,97,697,794
2012,7,16,0,19,92,503,595
2012,7,16,0,20,66,388,454
2012,7,16,0,21,45,283,328
2012,7,16,0,22,56,228,284
2012,7,16,0,23,27,139,166
2012,7,17,1,0,10,43,53
2012,7,17,1,1,4,21,25
2012,7,17,1,2,1,6,7
2012,7,17,1,3,0,3,3
2012,7,17,1,4,0,7,7
2012,7,17,1,5,7,31,38
2012,7,17,1,6,16,197,213
2012,7,17,1,7,26,500,526
2012,7,17,1,8,43,618,661
2012,7,17,1,9,32,288,320
2012,7,17,1,10,37,122,159
2012,7,17,1,11,60,146,206
2012,7,17,1,12,80,174,254
2012,7,17,1,13,53,168,221
2012,7,17,1,14,54,160,214
2012,7,17,1,15,57,187,244
2012,7,17,1,16,64,317,381
2012,7,17,1,17,95,675,770
2012,7,17,1,18,60,712,772
2012,7,17,1,19,69,478,547
2012,7,17,1,20,52,375,427
2012,7,17,1,21,50,283,333
2012,7,17,1,22,29,215,244
2012,7,17,1,23,22,139,161
2012,7,18,2,0,8,45,53
2012,7,18,2,1,2,14,16
2012,7,18,2,2,3,5,8
2012,7,18,2,3,2,2,4
2012,7,18,2,4,0,6,6
2012,7,18,2,5,5,41,46
2012,7,18,2,6,10,152,162
2012,7,18,2,7,23,472,495
2012,7,18,2,8,55,624,679
2012,7,18,2,9,44,253,297
2012,7,18,2,10,39,99,138
2012,7,18,2,11,47,136,183
2012,7,18,2,12,36,166,202
2012,7,18,2,13,49,154,203
2012,7,18,2,14,54,116,170
2012,7,18,2,15,42,152,194
2012,7,18,2,16,34,190,224
2012,7,18,2,17,35,335,370
2012,7,18,2,18,63,580,643
2012,7,18,2,19,78,438,516
2012,7,18,2,20,56,310,366
2012,7,18,2,21,53,266,319
2012,7,18,2,22,42,246,288
2012,7,18,2,23,19,112,131
2012,7,19,3,0,16,50,66
2012,7,19,3,1,6,19,25
2012,7,19,3,2,0,7,7
2012,7,19,3,3,1,4,5
2012,7,19,3,4,0,8,8
2012,7,19,3,5,5,35,40
2012,7,19,3,6,8,144,152
2012,7,19,3,7,23,450,473
2012,7,19,3,8,32,625,657
2012,7,19,3,9,36,282,318
2012,7,19,3,10,41,157,198
2012,7,19,3,11,54,162,216
2012,7,19,3,12,59,215,274
2012,7,19,3,13,74,180,254
2012,7,19,3,14,46,151,197
2012,7,19,3,15,66,226,292
2012,7,19,3,16,70,288,358
2012,7,19,3,17,93,678,771
2012,7,19,3,18,93,684,777
2012,7,19,3,19,53,480,533
2012,7,19,3,20,65,440,505
2012,7,19,3,21,38,294,332
2012,7,19,3,22,6,62,68
2012,7,19,3,23,3,62,65
2012,7,20,4,0,2,32,34
2012,7,20,4,1,2,9,11
2012,7,20,4,2,5,14,19
2012,7,20,4,3,7,29,36
2012,7,20,4,4,3,6,9
2012,7,20,4,5,2,40,42
2012,7,20,4,6,3,123,126
2012,7,20,4,7,14,346,360
2012,7,20,4,8,39,652,691
2012,7,20,4,9,45,328,373
2012,7,20,4,10,51,182,233
2012,7,20,4,11,51,161,212
2012,7,20,4,12,41,233,274
2012,7,20,4,13,20,136,156
2012,7,20,4,14,53,176,229
2012,7,20,4,15,47,169,216
2012,7,20,4,16,70,366,436
2012,7,20,4,17,95,620,715
2012,7,20,4,18,73,549,622
2012,7,20,4,19,44,358,402
2012,7,20,4,20,35,216,251
2012,7,20,4,21,14,108,122
2012,7,20,4,22,13,122,135
2012,7,20,4,23,18,148,166
2012,7,21,5,0,11,92,103
2012,7,21,5,1,10,62,72
2012,7,21,5,2,5,55,60
2012,7,21,5,3,7,18,25
2012,7,21,5,4,11,5,16
2012,7,21,5,5,7,10,17
2012,7,21,5,6,3,12,15
2012,7,21,5,7,8,29,37
2012,7,21,5,8,18,94,112
2012,7,21,5,9,32,175,207
2012,7,21,5,10,49,219,268
2012,7,21,5,11,80,225,305
2012,7,21,5,12,156,301,457
2012,7,21,5,13,106,248,354
2012,7,21,5,14,121,222,343
2012,7,21,5,15,148,232,380
2012,7,21,5,16,130,196,326
2012,7,21,5,17,92,149,241
2012,7,21,5,18,51,126,177
2012,7,21,5,19,67,171,238
2012,7,21,5,20,51,163,214
2012,7,21,5,21,29,134,163
2012,7,21,5,22,40,140,180
2012,7,21,5,23,32,117,149
2012,7,22,6,0,17,96,113
2012,7,22,6,1,31,99,130
2012,7,22,6,2,32,90,122
2012,7,22,6,3,13,30,43
2012,7,22,6,4,6,10,16
2012,7,22,6,5,0,6,6
2012,7,22,6,6,5,14,19
2012,7,22,6,7,13,25,38
2012,7,22,6,8,31,122,153
2012,7,22,6,9,79,179,258
2012,7,22,6,10,114,265,379
2012,7,22,6,11,191,314,505
2012,7,22,6,12,178,326,504
2012,7,22,6,13,238,388,626
2012,7,22,6,14,256,360,616
2012,7,22,6,15,254,370,624
2012,7,22,6,16,245,383,628
2012,7,22,6,17,188,368,556
2012,7,22,6,18,173,342,515
2012,7,22,6,19,180,342,522
2012,7,22,6,20,124,254,378
2012,7,22,6,21,88,257,345
2012,7,22,6,22,55,136,191
2012,7,22,6,23,33,90,123
2012,7,23,0,0,11,36,47
2012,7,23,0,1,7,20,27
2012,7,23,0,2,3,14,17
2012,7,23,0,3,0,2,2
2012,7,23,0,4,0,8,8
2012,7,23,0,5,3,48,51
2012,7,23,0,6,9,148,157
2012,7,23,0,7,17,404,421
2012,7,23,0,8,47,691,738
2012,7,23,0,9,57,288,345
2012,7,23,0,10,63,137,200
2012,7,23,0,11,69,129,198
2012,7,23,0,12,109,205,314
2012,7,23,0,13,64,176,240
2012,7,23,0,14,82,189,271
2012,7,23,0,15,76,205,281
2012,7,23,0,16,111,346,457
2012,7,23,0,17,87,760,847
2012,7,23,0,18,69,672,741
2012,7,23,0,19,94,488,582
2012,7,23,0,20,56,347,403
2012,7,23,0,21,45,251,296
2012,7,23,0,22,40,169,209
2012,7,23,0,23,16,98,114
2012,7,24,1,0,12,52,64
2012,7,24,1,1,7,10,17
2012,7,24,1,2,6,10,16
2012,7,24,1,3,1,5,6
2012,7,24,1,4,0,6,6
2012,7,24,1,5,5,45,50
2012,7,24,1,6,17,173,190
2012,7,24,1,7,24,492,516
2012,7,24,1,8,49,694,743
2012,7,24,1,9,40,299,339
2012,7,24,1,10,62,156,218
2012,7,24,1,11,45,156,201
2012,7,24,1,12,60,169,229
2012,7,24,1,13,73,200,273
2012,7,24,1,14,48,196,244
2012,7,24,1,15,73,212,285
2012,7,24,1,16,86,369,455
2012,7,24,1,17,94,775,869
2012,7,24,1,18,110,767,877
2012,7,24,1,19,109,523,632
2012,7,24,1,20,85,438,523
2012,7,24,1,21,53,325,378
2012,7,24,1,22,43,226,269
2012,7,24,1,23,38,154,192
2012,7,25,2,0,9,57,66
2012,7,25,2,1,2,26,28
2012,7,25,2,2,1,11,12
2012,7,25,2,3,1,11,12
2012,7,25,2,4,0,4,4
2012,7,25,2,5,5,54,59
2012,7,25,2,6,11,179,190
2012,7,25,2,7,34,473,507
2012,7,25,2,8,43,745,788
2012,7,25,2,9,65,277,342
2012,7,25,2,10,68,163,231
2012,7,25,2,11,79,202,281
2012,7,25,2,12,77,233,310
2012,7,25,2,13,81,231,312
2012,7,25,2,14,88,159,247
2012,7,25,2,15,94,223,317
2012,7,25,2,16,91,393,484
2012,7,25,2,17,130,783,913
2012,7,25,2,18,104,787,891
2012,7,25,2,19,116,582,698
2012,7,25,2,20,106,461,567
2012,7,25,2,21,71,326,397
2012,7,25,2,22,55,223,278
2012,7,25,2,23,52,187,239
2012,7,26,3,0,27,65,92
2012,7,26,3,1,6,23,29
2012,7,26,3,2,5,16,21
2012,7,26,3,3,0,8,8
2012,7,26,3,4,0,4,4
2012,7,26,3,5,2,40,42
2012,7,26,3,6,16,165,181
2012,7,26,3,7,17,478,495
2012,7,26,3,8,49,680,729
2012,7,26,3,9,55,289,344
2012,7,26,3,10,79,143,222
2012,7,26,3,11,69,143,212
2012,7,26,3,12,73,206,279
2012,7,26,3,13,53,189,242
2012,7,26,3,14,62,151,213
2012,7,26,3,15,65,173,238
2012,7,26,3,16,62,312,374
2012,7,26,3,17,110,628,738
2012,7,26,3,18,73,615,688
2012,7,26,3,19,80,534,614
2012,7,26,3,20,47,399,446
2012,7,26,3,21,35,236,271
2012,7,26,3,22,33,201,234
2012,7,26,3,23,18,127,145
2012,7,27,4,0,14,83,97
2012,7,27,4,1,12,42,54
2012,7,27,4,2,8,18,26
2012,7,27,4,3,3,9,12
2012,7,27,4,4,3,5,8
2012,7,27,4,5,3,34,37
2012,7,27,4,6,10,129,139
2012,7,27,4,7,13,397,410
2012,7,27,4,8,34,642,676
2012,7,27,4,9,34,329,363
2012,7,27,4,10,85,146,231
2012,7,27,4,11,67,184,251
2012,7,27,4,12,92,207,299
2012,7,27,4,13,83,231,314
2012,7,27,4,14,105,221,326
2012,7,27,4,15,81,242,323
2012,7,27,4,16,80,419,499
2012,7,27,4,17,101,598,699
2012,7,27,4,18,100,522,622
2012,7,27,4,19,93,423,516
2012,7,27,4,20,85,269,354
2012,7,27,4,21,71,189,260
2012,7,27,4,22,48,151,199
2012,7,27,4,23,34,155,189
2012,7,28,5,0,21,170,191
2012,7,28,5,1,11,69,80
2012,7,28,5,2,14,76,90
2012,7,28,5,3,10,33,43
2012,7,28,5,4,1,10,11
2012,7,28,5,5,4,10,14
2012,7,28,5,6,10,40,50
2012,7,28,5,7,18,58,76
2012,7,28,5,8,36,127,163
2012,7,28,5,9,110,227,337
2012,7,28,5,10,129,266,395
2012,7,28,5,11,162,295,457
2012,7,28,5,12,157,330,487
2012,7,28,5,13,173,325,498
2012,7,28,5,14,186,308,494
2012,7,28,5,15,206,291,497
2012,7,28,5,16,208,279,487
2012,7,28,5,17,199,280,479
2012,7,28,5,18,151,330,481
2012,7,28,5,19,115,223,338
2012,7,28,5,20,79,154,233
2012,7,28,5,21,94,206,300
2012,7,28,5,22,88,188,276
2012,7,28,5,23,52,156,208
2012,7,29,6,0,59,129,188
2012,7,29,6,1,49,109,158
2012,7,29,6,2,33,79,112
2012,7,29,6,3,18,37,55
2012,7,29,6,4,2,11,13
2012,7,29,6,5,3,14,17
2012,7,29,6,6,6,12,18
2012,7,29,6,7,4,36,40
2012,7,29,6,8,37,90,127
2012,7,29,6,9,64,162,226
2012,7,29,6,10,123,258,381
2012,7,29,6,11,183,326,509
2012,7,29,6,12,154,357,511
2012,7,29,6,13,181,302,483
2012,7,29,6,14,231,291,522
2012,7,29,6,15,195,306,501
2012,7,29,6,16,191,330,521
2012,7,29,6,17,164,367,531
2012,7,29,6,18,117,302,419
2012,7,29,6,19,143,300,443
2012,7,29,6,20,75,228,303
2012,7,29,6,21,72,199,271
2012,7,29,6,22,31,117,148
2012,7,29,6,23,18,82,100
2012,7,30,0,0,12,46,58
2012,7,30,0,1,4,15,19
2012,7,30,0,2,2,6,8
2012,7,30,0,3,0,3,3
2012,7,30,0,4,0,5,5
2012,7,30,0,5,4,43,47
2012,7,30,0,6,6,155,161
2012,7,30,0,7,14,455,469
2012,7,30,0,8,31,720,751
2012,7,30,0,9,34,259,293
2012,7,30,0,10,54,135,189
2012,7,30,0,11,69,146,215
2012,7,30,0,12,77,201,278
2012,7,30,0,13,57,169,226
2012,7,30,0,14,87,167,254
2012,7,30,0,15,51,185,236
2012,7,30,0,16,88,337,425
2012,7,30,0,17,62,765,827
2012,7,30,0,18,77,735,812
2012,7,30,0,19,81,584,665
2012,7,30,0,20,78,384,462
2012,7,30,0,21,71,251,322
2012,7,30,0,22,47,183,230
2012,7,30,0,23,34,116,150
2012,7,31,1,0,11,27,38
2012,7,31,1,1,3,18,21
2012,7,31,1,2,0,8,8
2012,7,31,1,3,1,5,6
2012,7,31,1,4,0,6,6
2012,7,31,1,5,5,40,45
2012,7,31,1,6,2,192,194
2012,7,31,1,7,21,492,513
2012,7,31,1,8,30,730,760
2012,7,31,1,9,31,302,333
2012,7,31,1,10,73,154,227
2012,7,31,1,11,54,170,224
2012,7,31,1,12,50,198,248
2012,7,31,1,13,69,219,288
2012,7,31,1,14,72,188,260
2012,7,31,1,15,29,115,144
2012,7,31,1,16,66,336,402
2012,7,31,1,17,94,726,820
2012,7,31,1,18,99,758,857
2012,7,31,1,19,90,524,614
2012,7,31,1,20,55,397,452
2012,7,31,1,21,60,292,352
2012,7,31,1,22,33,224,257
2012,7,31,1,23,20,127,147
2012,8,1,2,0,3,44,47
2012,8,1,2,1,5,28,33
2012,8,1,2,2,0,13,13
2012,8,1,2,3,0,7,7
2012,8,1,2,4,1,3,4
2012,8,1,2,5,3,46,49
2012,8,1,2,6,6,179,185
2012,8,1,2,7,19,468,487
2012,8,1,2,8,32,649,681
2012,8,1,2,9,34,316,350
2012,8,1,2,10,61,175,236
2012,8,1,2,11,54,180,234
2012,8,1,2,12,75,209,284
2012,8,1,2,13,59,221,280
2012,8,1,2,14,88,175,263
2012,8,1,2,15,89,206,295
2012,8,1,2,16,93,386,479
2012,8,1,2,17,103,734,837
2012,8,1,2,18,105,786,891
2012,8,1,2,19,88,564,652
2012,8,1,2,20,65,448,513
2012,8,1,2,21,36,284,320
2012,8,1,2,22,37,251,288
2012,8,1,2,23,18,134,152
2012,8,2,3,0,8,55,63
2012,8,2,3,1,6,36,42
2012,8,2,3,2,3,8,11
2012,8,2,3,3,0,6,6
2012,8,2,3,4,0,9,9
2012,8,2,3,5,4,37,41
2012,8,2,3,6,6,177,183
2012,8,2,3,7,21,452,473
2012,8,2,3,8,21,718,739
2012,8,2,3,9,31,312,343
2012,8,2,3,10,51,130,181
2012,8,2,3,11,59,167,226
2012,8,2,3,12,56,230,286
2012,8,2,3,13,98,212,310
2012,8,2,3,14,54,171,225
2012,8,2,3,15,68,202,270
2012,8,2,3,16,71,335,406
2012,8,2,3,17,90,775,865
2012,8,2,3,18,86,681,767
2012,8,2,3,19,98,509,607
2012,8,2,3,20,51,376,427
2012,8,2,3,21,41,301,342
2012,8,2,3,22,35,227,262
2012,8,2,3,23,25,152,177
2012,8,3,4,0,15,56,71
2012,8,3,4,1,11,32,43
2012,8,3,4,2,0,14,14
2012,8,3,4,3,1,5,6
2012,8,3,4,4,1,11,12
2012,8,3,4,5,2,35,37
2012,8,3,4,6,5,158,163
2012,8,3,4,7,25,396,421
2012,8,3,4,8,32,636,668
2012,8,3,4,9,69,327,396
2012,8,3,4,10,82,167,249
2012,8,3,4,11,77,186,263
2012,8,3,4,12,95,243,338
2012,8,3,4,13,98,247,345
2012,8,3,4,14,102,229,331
2012,8,3,4,15,112,268,380
2012,8,3,4,16,112,380,492
2012,8,3,4,17,95,646,741
2012,8,3,4,18,98,573,671
2012,8,3,4,19,81,388,469
2012,8,3,4,20,89,300,389
2012,8,3,4,21,54,224,278
2012,8,3,4,22,46,156,202
2012,8,3,4,23,26,170,196
2012,8,4,5,0,24,137,161
2012,8,4,5,1,23,99,122
2012,8,4,5,2,20,64,84
2012,8,4,5,3,11,19,30
2012,8,4,5,4,2,11,13
2012,8,4,5,5,1,16,17
2012,8,4,5,6,12,37,49
2012,8,4,5,7,18,49,67
2012,8,4,5,8,49,132,181
2012,8,4,5,9,61,217,278
2012,8,4,5,10,108,288,396
2012,8,4,5,11,155,315,470
2012,8,4,5,12,222,325,547
2012,8,4,5,13,195,332,527
2012,8,4,5,14,183,289,472
2012,8,4,5,15,205,284,489
2012,8,4,5,16,197,253,450
2012,8,4,5,17,179,313,492
2012,8,4,5,18,169,321,490
2012,8,4,5,19,133,264,397
2012,8,4,5,20,117,195,312
2012,8,4,5,21,96,193,289
2012,8,4,5,22,104,165,269
2012,8,4,5,23,61,161,222
2012,8,5,6,0,32,121,153
2012,8,5,6,1,8,79,87
2012,8,5,6,2,5,68,73
2012,8,5,6,3,9,32,41
2012,8,5,6,4,3,11,14
2012,8,5,6,5,1,18,19
2012,8,5,6,6,7,12,19
2012,8,5,6,7,18,50,68
2012,8,5,6,8,27,81,108
2012,8,5,6,9,61,168,229
2012,8,5,6,10,111,253,364
2012,8,5,6,11,155,282,437
2012,8,5,6,12,161,330,491
2012,8,5,6,13,208,315,523
2012,8,5,6,14,161,365,526
2012,8,5,6,15,164,286,450
2012,8,5,6,16,143,278,421
2012,8,5,6,17,122,260,382
2012,8,5,6,18,75,154,229
2012,8,5,6,19,46,139,185
2012,8,5,6,20,53,140,193
2012,8,5,6,21,51,157,208
2012,8,5,6,22,57,100,157
2012,8,5,6,23,29,58,87
2012,8,6,0,0,9,24,33
2012,8,6,0,1,1,10,11
2012,8,6,0,2,0,5,5
2012,8,6,0,3,0,5,5
2012,8,6,0,4,3,8,11
2012,8,6,0,5,2,23,25
2012,8,6,0,6,4,137,141
2012,8,6,0,7,14,393,407
2012,8,6,0,8,27,578,605
2012,8,6,0,9,28,248,276
2012,8,6,0,10,54,159,213
2012,8,6,0,11,108,152,260
2012,8,6,0,12,72,213,285
2012,8,6,0,13,85,204,289
2012,8,6,0,14,99,188,287
2012,8,6,0,15,91,183,274
2012,8,6,0,16,88,363,451
2012,8,6,0,17,112,746,858
2012,8,6,0,18,100,743,843
2012,8,6,0,19,109,531,640
2012,8,6,0,20,89,368,457
2012,8,6,0,21,72,245,317
2012,8,6,0,22,50,157,207
2012,8,6,0,23,16,97,113
2012,8,7,1,0,15,32,47
2012,8,7,1,1,2,16,18
2012,8,7,1,2,6,7,13
2012,8,7,1,3,0,6,6
2012,8,7,1,4,2,7,9
2012,8,7,1,5,3,33,36
2012,8,7,1,6,3,176,179
2012,8,7,1,7,21,481,502
2012,8,7,1,8,41,664,705
2012,8,7,1,9,44,283,327
2012,8,7,1,10,89,161,250
2012,8,7,1,11,84,130,214
2012,8,7,1,12,86,197,283
2012,8,7,1,13,68,185,253
2012,8,7,1,14,76,185,261
2012,8,7,1,15,100,206,306
2012,8,7,1,16,101,344,445
2012,8,7,1,17,125,743,868
2012,8,7,1,18,103,711,814
2012,8,7,1,19,104,506,610
2012,8,7,1,20,74,374,448
2012,8,7,1,21,70,247,317
2012,8,7,1,22,43,181,224
2012,8,7,1,23,18,120,138
2012,8,8,2,0,12,46,58
2012,8,8,2,1,3,20,23
2012,8,8,2,2,1,5,6
2012,8,8,2,3,1,6,7
2012,8,8,2,4,1,6,7
2012,8,8,2,5,3,40,43
2012,8,8,2,6,4,169,173
2012,8,8,2,7,24,458,482
2012,8,8,2,8,48,689,737
2012,8,8,2,9,33,308,341
2012,8,8,2,10,63,151,214
2012,8,8,2,11,80,159,239
2012,8,8,2,12,63,217,280
2012,8,8,2,13,101,212,313
2012,8,8,2,14,63,173,236
2012,8,8,2,15,110,168,278
2012,8,8,2,16,113,328,441
2012,8,8,2,17,107,751,858
2012,8,8,2,18,117,745,862
2012,8,8,2,19,119,567,686
2012,8,8,2,20,76,424,500
2012,8,8,2,21,70,311,381
2012,8,8,2,22,35,198,233
2012,8,8,2,23,16,120,136
2012,8,9,3,0,16,51,67
2012,8,9,3,1,5,23,28
2012,8,9,3,2,2,12,14
2012,8,9,3,3,1,5,6
2012,8,9,3,4,0,10,10
2012,8,9,3,5,4,37,41
2012,8,9,3,6,5,162,167
2012,8,9,3,7,24,451,475
2012,8,9,3,8,28,670,698
2012,8,9,3,9,54,299,353
2012,8,9,3,10,72,133,205
2012,8,9,3,11,94,166,260
2012,8,9,3,12,85,192,277
2012,8,9,3,13,80,201,281
2012,8,9,3,14,86,161,247
2012,8,9,3,15,63,204,267
2012,8,9,3,16,97,320,417
2012,8,9,3,17,111,699,810
2012,8,9,3,18,78,733,811
2012,8,9,3,19,90,533,623
2012,8,9,3,20,91,387,478
2012,8,9,3,21,50,286,336
2012,8,9,3,22,41,218,259
2012,8,9,3,23,19,137,156
2012,8,10,4,0,17,68,85
2012,8,10,4,1,6,35,41
2012,8,10,4,2,6,14,20
2012,8,10,4,3,3,6,9
2012,8,10,4,4,0,7,7
2012,8,10,4,5,4,29,33
2012,8,10,4,6,3,41,44
2012,8,10,4,7,5,128,133
2012,8,10,4,8,7,112,119
2012,8,10,4,9,21,199,220
2012,8,10,4,10,27,166,193
2012,8,10,4,11,73,178,251
2012,8,10,4,12,75,240,315
2012,8,10,4,13,66,224,290
2012,8,10,4,14,71,236,307
2012,8,10,4,15,100,224,324
2012,8,10,4,16,96,371,467
2012,8,10,4,17,111,619,730
2012,8,10,4,18,88,552,640
2012,8,10,4,19,98,394,492
2012,8,10,4,20,55,315,370
2012,8,10,4,21,50,236,286
2012,8,10,4,22,50,168,218
2012,8,10,4,23,33,159,192
2012,8,11,5,0,38,142,180
2012,8,11,5,1,32,84,116
2012,8,11,5,2,19,66,85
2012,8,11,5,3,2,19,21
2012,8,11,5,4,3,7,10
2012,8,11,5,5,2,9,11
2012,8,11,5,6,5,18,23
2012,8,11,5,7,8,54,62
2012,8,11,5,8,30,132,162
2012,8,11,5,9,54,217,271
2012,8,11,5,10,125,282,407
2012,8,11,5,11,203,296,499
2012,8,11,5,12,214,332,546
2012,8,11,5,13,228,341,569
2012,8,11,5,14,248,290,538
2012,8,11,5,15,246,316,562
2012,8,11,5,16,227,304,531
2012,8,11,5,17,220,292,512
2012,8,11,5,18,107,193,300
2012,8,11,5,19,97,178,275
2012,8,11,5,20,31,129,160
2012,8,11,5,21,26,102,128
2012,8,11,5,22,40,128,168
2012,8,11,5,23,42,121,163
2012,8,12,6,0,24,96,120
2012,8,12,6,1,21,92,113
2012,8,12,6,2,19,67,86
2012,8,12,6,3,11,37,48
2012,8,12,6,4,2,8,10
2012,8,12,6,5,1,9,10
2012,8,12,6,6,2,14,16
2012,8,12,6,7,9,30,39
2012,8,12,6,8,35,84,119
2012,8,12,6,9,64,153,217
2012,8,12,6,10,88,240,328
2012,8,12,6,11,167,282,449
2012,8,12,6,12,163,342,505
2012,8,12,6,13,178,365,543
2012,8,12,6,14,213,366,579
2012,8,12,6,15,235,342,577
2012,8,12,6,16,213,300,513
2012,8,12,6,17,186,319,505
2012,8,12,6,18,164,327,491
2012,8,12,6,19,148,317,465
2012,8,12,6,20,96,204,300
2012,8,12,6,21,78,142,220
2012,8,12,6,22,40,141,181
2012,8,12,6,23,25,85,110
2012,8,13,0,0,14,33,47
2012,8,13,0,1,3,11,14
2012,8,13,0,2,1,8,9
2012,8,13,0,3,1,5,6
2012,8,13,0,4,0,11,11
2012,8,13,0,5,3,33,36
2012,8,13,0,6,4,155,159
2012,8,13,0,7,11,425,436
2012,8,13,0,8,25,648,673
2012,8,13,0,9,40,265,305
2012,8,13,0,10,88,111,199
2012,8,13,0,11,94,151,245
2012,8,13,0,12,96,180,276
2012,8,13,0,13,79,175,254
2012,8,13,0,14,85,163,248
2012,8,13,0,15,80,194,274
2012,8,13,0,16,116,348,464
2012,8,13,0,17,102,716,818
2012,8,13,0,18,103,709,812
2012,8,13,0,19,88,467,555
2012,8,13,0,20,58,374,432
2012,8,13,0,21,44,246,290
2012,8,13,0,22,44,148,192
2012,8,13,0,23,28,100,128
2012,8,14,1,0,12,48,60
2012,8,14,1,1,8,19,27
2012,8,14,1,2,2,9,11
2012,8,14,1,3,0,3,3
2012,8,14,1,4,0,5,5
2012,8,14,1,5,1,35,36
2012,8,14,1,6,1,63,64
2012,8,14,1,7,1,178,179
2012,8,14,1,8,27,591,618
2012,8,14,1,9,48,354,402
2012,8,14,1,10,53,155,208
2012,8,14,1,11,69,127,196
2012,8,14,1,12,93,207,300
2012,8,14,1,13,83,203,286
2012,8,14,1,14,80,175,255
2012,8,14,1,15,84,199,283
2012,8,14,1,16,95,363,458
2012,8,14,1,17,78,734,812
2012,8,14,1,18,97,757,854
2012,8,14,1,19,94,533,627
2012,8,14,1,20,65,371,436
2012,8,14,1,21,56,252,308
2012,8,14,1,22,28,161,189
2012,8,14,1,23,53,114,167
2012,8,15,2,0,8,52,60
2012,8,15,2,1,6,31,37
2012,8,15,2,2,1,7,8
2012,8,15,2,3,1,10,11
2012,8,15,2,4,0,4,4
2012,8,15,2,5,4,35,39
2012,8,15,2,6,12,160,172
2012,8,15,2,7,25,467,492
2012,8,15,2,8,40,642,682
2012,8,15,2,9,57,310,367
2012,8,15,2,10,70,163,233
2012,8,15,2,11,80,155,235
2012,8,15,2,12,77,230,307
2012,8,15,2,13,88,206,294
2012,8,15,2,14,94,161,255
2012,8,15,2,15,70,196,266
2012,8,15,2,16,91,340,431
2012,8,15,2,17,102,749,851
2012,8,15,2,18,80,768,848
2012,8,15,2,19,124,525,649
2012,8,15,2,20,72,355,427
2012,8,15,2,21,49,266,315
2012,8,15,2,22,29,197,226
2012,8,15,2,23,18,120,138
2012,8,16,3,0,13,63,76
2012,8,16,3,1,3,18,21
2012,8,16,3,2,0,15,15
2012,8,16,3,3,0,4,4
2012,8,16,3,4,2,3,5
2012,8,16,3,5,7,30,37
2012,8,16,3,6,3,162,165
2012,8,16,3,7,16,448,464
2012,8,16,3,8,33,649,682
2012,8,16,3,9,41,296,337
2012,8,16,3,10,78,121,199
2012,8,16,3,11,83,191,274
2012,8,16,3,12,96,247,343
2012,8,16,3,13,81,219,300
2012,8,16,3,14,72,176,248
2012,8,16,3,15,63,197,260
2012,8,16,3,16,79,340,419
2012,8,16,3,17,130,767,897
2012,8,16,3,18,109,723,832
2012,8,16,3,19,119,558,677
2012,8,16,3,20,100,414,514
2012,8,16,3,21,83,273,356
2012,8,16,3,22,69,185,254
2012,8,16,3,23,58,168,226
2012,8,17,4,0,21,67,88
2012,8,17,4,1,16,38,54
2012,8,17,4,2,4,15,19
2012,8,17,4,3,0,6,6
2012,8,17,4,4,0,9,9
2012,8,17,4,5,2,34,36
2012,8,17,4,6,6,151,157
2012,8,17,4,7,11,368,379
2012,8,17,4,8,43,625,668
2012,8,17,4,9,58,320,378
2012,8,17,4,10,82,149,231
2012,8,17,4,11,98,205,303
2012,8,17,4,12,110,255,365
2012,8,17,4,13,103,254,357
2012,8,17,4,14,128,200,328
2012,8,17,4,15,127,256,383
2012,8,17,4,16,116,372,488
2012,8,17,4,17,144,647,791
2012,8,17,4,18,108,561,669
2012,8,17,4,19,88,403,491
2012,8,17,4,20,97,262,359
2012,8,17,4,21,57,198,255
2012,8,17,4,22,43,170,213
2012,8,17,4,23,21,100,121
2012,8,18,5,0,6,99,105
2012,8,18,5,1,14,78,92
2012,8,18,5,2,4,39,43
2012,8,18,5,3,7,23,30
2012,8,18,5,4,5,8,13
2012,8,18,5,5,2,7,9
2012,8,18,5,6,4,23,27
2012,8,18,5,7,12,52,64
2012,8,18,5,8,28,161,189
2012,8,18,5,9,81,211,292
2012,8,18,5,10,166,314,480
2012,8,18,5,11,180,356,536
2012,8,18,5,12,266,388,654
2012,8,18,5,13,289,355,644
2012,8,18,5,14,242,356,598
2012,8,18,5,15,250,346,596
2012,8,18,5,16,287,354,641
2012,8,18,5,17,256,379,635
2012,8,18,5,18,225,329,554
2012,8,18,5,19,164,324,488
2012,8,18,5,20,99,242,341
2012,8,18,5,21,90,248,338
2012,8,18,5,22,90,171,261
2012,8,18,5,23,60,175,235
2012,8,19,6,0,44,143,187
2012,8,19,6,1,29,102,131
2012,8,19,6,2,16,103,119
2012,8,19,6,3,21,34,55
2012,8,19,6,4,4,22,26
2012,8,19,6,5,3,8,11
2012,8,19,6,6,5,15,20
2012,8,19,6,7,12,29,41
2012,8,19,6,8,34,90,124
2012,8,19,6,9,86,184,270
2012,8,19,6,10,138,287,425
2012,8,19,6,11,83,189,272
2012,8,19,6,12,112,186,298
2012,8,19,6,13,50,112,162
2012,8,19,6,14,41,108,149
2012,8,19,6,15,89,187,276
2012,8,19,6,16,97,259,356
2012,8,19,6,17,76,267,343
2012,8,19,6,18,86,291,377
2012,8,19,6,19,72,269,341
2012,8,19,6,20,61,213,274
2012,8,19,6,21,36,154,190
2012,8,19,6,22,6,50,56
2012,8,19,6,23,7,39,46
2012,8,20,0,0,1,25,26
2012,8,20,0,1,0,10,10
2012,8,20,0,2,0,5,5
2012,8,20,0,3,0,3,3
2012,8,20,0,4,0,7,7
2012,8,20,0,5,2,35,37
2012,8,20,0,6,6,155,161
2012,8,20,0,7,15,427,442
2012,8,20,0,8,37,618,655
2012,8,20,0,9,55,302,357
2012,8,20,0,10,69,124,193
2012,8,20,0,11,90,151,241
2012,8,20,0,12,66,216,282
2012,8,20,0,13,97,194,291
2012,8,20,0,14,87,188,275
2012,8,20,0,15,102,207,309
2012,8,20,0,16,103,357,460
2012,8,20,0,17,83,810,893
2012,8,20,0,18,89,726,815
2012,8,20,0,19,33,266,299
2012,8,20,0,20,30,231,261
2012,8,20,0,21,26,219,245
2012,8,20,0,22,25,136,161
2012,8,20,0,23,10,92,102
2012,8,21,1,0,7,52,59
2012,8,21,1,1,11,22,33
2012,8,21,1,2,1,7,8
2012,8,21,1,3,0,3,3
2012,8,21,1,4,0,4,4
2012,8,21,1,5,4,30,34
2012,8,21,1,6,5,164,169
2012,8,21,1,7,19,500,519
2012,8,21,1,8,27,696,723
2012,8,21,1,9,47,281,328
2012,8,21,1,10,58,120,178
2012,8,21,1,11,61,195,256
2012,8,21,1,12,79,226,305
2012,8,21,1,13,76,255,331
2012,8,21,1,14,110,192,302
2012,8,21,1,15,76,226,302
2012,8,21,1,16,109,358,467
2012,8,21,1,17,92,786,878
2012,8,21,1,18,93,532,625
2012,8,21,1,19,56,420,476
2012,8,21,1,20,62,296,358
2012,8,21,1,21,41,239,280
2012,8,21,1,22,24,208,232
2012,8,21,1,23,23,113,136
2012,8,22,2,0,9,46,55
2012,8,22,2,1,1,20,21
2012,8,22,2,2,7,10,17
2012,8,22,2,3,0,7,7
2012,8,22,2,4,1,7,8
2012,8,22,2,5,2,38,40
2012,8,22,2,6,12,175,187
2012,8,22,2,7,16,537,553
2012,8,22,2,8,37,703,740
2012,8,22,2,9,41,335,376
2012,8,22,2,10,66,159,225
2012,8,22,2,11,71,196,267
2012,8,22,2,12,59,253,312
2012,8,22,2,13,74,242,316
2012,8,22,2,14,82,184,266
2012,8,22,2,15,94,222,316
2012,8,22,2,16,102,358,460
2012,8,22,2,17,72,711,783
2012,8,22,2,18,91,592,683
2012,8,22,2,19,56,524,580
2012,8,22,2,20,59,332,391
2012,8,22,2,21,60,291,351
2012,8,22,2,22,55,226,281
2012,8,22,2,23,27,113,140
2012,8,23,3,0,9,51,60
2012,8,23,3,1,10,15,25
2012,8,23,3,2,9,11,20
2012,8,23,3,3,3,6,9
2012,8,23,3,4,0,6,6
2012,8,23,3,5,1,36,37
2012,8,23,3,6,14,178,192
2012,8,23,3,7,18,463,481
2012,8,23,3,8,45,662,707
2012,8,23,3,9,58,354,412
2012,8,23,3,10,76,157,233
2012,8,23,3,11,86,192,278
2012,8,23,3,12,97,235,332
2012,8,23,3,13,93,253,346
2012,8,23,3,14,114,191,305
2012,8,23,3,15,104,201,305
2012,8,23,3,16,121,344,465
2012,8,23,3,17,111,709,820
2012,8,23,3,18,130,811,941
2012,8,23,3,19,96,537,633
2012,8,23,3,20,70,404,474
2012,8,23,3,21,53,276,329
2012,8,23,3,22,21,177,198
2012,8,23,3,23,24,133,157
2012,8,24,4,0,27,84,111
2012,8,24,4,1,5,37,42
2012,8,24,4,2,1,15,16
2012,8,24,4,3,2,6,8
2012,8,24,4,4,2,6,8
2012,8,24,4,5,1,37,38
2012,8,24,4,6,9,142,151
2012,8,24,4,7,13,412,425
2012,8,24,4,8,41,703,744
2012,8,24,4,9,58,331,389
2012,8,24,4,10,78,184,262
2012,8,24,4,11,69,212,281
2012,8,24,4,12,95,276,371
2012,8,24,4,13,79,272,351
2012,8,24,4,14,109,229,338
2012,8,24,4,15,99,251,350
2012,8,24,4,16,101,414,515
2012,8,24,4,17,117,695,812
2012,8,24,4,18,109,627,736
2012,8,24,4,19,106,430,536
2012,8,24,4,20,66,297,363
2012,8,24,4,21,58,248,306
2012,8,24,4,22,42,209,251
2012,8,24,4,23,38,140,178
2012,8,25,5,0,21,114,135
2012,8,25,5,1,15,100,115
2012,8,25,5,2,18,61,79
2012,8,25,5,3,7,31,38
2012,8,25,5,4,3,9,12
2012,8,25,5,5,4,10,14
2012,8,25,5,6,5,25,30
2012,8,25,5,7,14,88,102
2012,8,25,5,8,29,133,162
2012,8,25,5,9,60,228,288
2012,8,25,5,10,148,294,442
2012,8,25,5,11,143,314,457
2012,8,25,5,12,217,367,584
2012,8,25,5,13,186,331,517
2012,8,25,5,14,150,332,482
2012,8,25,5,15,79,154,233
2012,8,25,5,16,174,260,434
2012,8,25,5,17,132,271,403
2012,8,25,5,18,122,261,383
2012,8,25,5,19,97,257,354
2012,8,25,5,20,65,176,241
2012,8,25,5,21,60,148,208
2012,8,25,5,22,46,136,182
2012,8,25,5,23,34,124,158
2012,8,26,6,0,23,111,134
2012,8,26,6,1,18,116,134
2012,8,26,6,2,12,104,116
2012,8,26,6,3,11,42,53
2012,8,26,6,4,5,11,16
2012,8,26,6,5,3,13,16
2012,8,26,6,6,5,16,21
2012,8,26,6,7,11,23,34
2012,8,26,6,8,21,112,133
2012,8,26,6,9,67,196,263
2012,8,26,6,10,127,258,385
2012,8,26,6,11,150,332,482
2012,8,26,6,12,225,401,626
2012,8,26,6,13,166,375,541
2012,8,26,6,14,125,252,377
2012,8,26,6,15,132,259,391
2012,8,26,6,16,57,116,173
2012,8,26,6,17,61,172,233
2012,8,26,6,18,77,187,264
2012,8,26,6,19,80,212,292
2012,8,26,6,20,40,171,211
2012,8,26,6,21,26,140,166
2012,8,26,6,22,20,94,114
2012,8,26,6,23,21,59,80
2012,8,27,0,0,4,28,32
2012,8,27,0,1,3,4,7
2012,8,27,0,2,0,8,8
2012,8,27,0,3,1,3,4
2012,8,27,0,4,1,11,12
2012,8,27,0,5,4,32,36
2012,8,27,0,6,4,141,145
2012,8,27,0,7,15,418,433
2012,8,27,0,8,29,670,699
2012,8,27,0,9,40,302,342
2012,8,27,0,10,63,143,206
2012,8,27,0,11,47,182,229
2012,8,27,0,12,69,214,283
2012,8,27,0,13,77,211,288
2012,8,27,0,14,66,180,246
2012,8,27,0,15,77,205,282
2012,8,27,0,16,77,367,444
2012,8,27,0,17,101,744,845
2012,8,27,0,18,83,751,834
2012,8,27,0,19,74,499,573
2012,8,27,0,20,50,366,416
2012,8,27,0,21,39,239,278
2012,8,27,0,22,30,131,161
2012,8,27,0,23,35,79,114
2012,8,28,1,0,9,29,38
2012,8,28,1,1,4,17,21
2012,8,28,1,2,2,13,15
2012,8,28,1,3,0,4,4
2012,8,28,1,4,2,6,8
2012,8,28,1,5,3,39,42
2012,8,28,1,6,3,144,147
2012,8,28,1,7,14,255,269
2012,8,28,1,8,25,668,693
2012,8,28,1,9,44,351,395
2012,8,28,1,10,39,165,204
2012,8,28,1,11,47,171,218
2012,8,28,1,12,56,241,297
2012,8,28,1,13,56,232,288
2012,8,28,1,14,72,179,251
2012,8,28,1,15,59,258,317
2012,8,28,1,16,84,396,480
2012,8,28,1,17,90,774,864
2012,8,28,1,18,82,736,818
2012,8,28,1,19,82,515,597
2012,8,28,1,20,87,348,435
2012,8,28,1,21,38,276,314
2012,8,28,1,22,20,196,216
2012,8,28,1,23,17,92,109
2012,8,29,2,0,8,39,47
2012,8,29,2,1,2,12,14
2012,8,29,2,2,2,4,6
2012,8,29,2,3,0,9,9
2012,8,29,2,4,2,8,10
2012,8,29,2,5,3,37,40
2012,8,29,2,6,6,175,181
2012,8,29,2,7,23,531,554
2012,8,29,2,8,28,780,808
2012,8,29,2,9,40,308,348
2012,8,29,2,10,34,144,178
2012,8,29,2,11,67,186,253
2012,8,29,2,12,79,281,360
2012,8,29,2,13,68,232,300
2012,8,29,2,14,87,214,301
2012,8,29,2,15,96,242,338
2012,8,29,2,16,104,389,493
2012,8,29,2,17,108,762,870
2012,8,29,2,18,119,693,812
2012,8,29,2,19,120,523,643
2012,8,29,2,20,49,378,427
2012,8,29,2,21,48,265,313
2012,8,29,2,22,50,185,235
2012,8,29,2,23,34,123,157
2012,8,30,3,0,14,51,65
2012,8,30,3,1,6,17,23
2012,8,30,3,2,3,14,17
2012,8,30,3,3,0,5,5
2012,8,30,3,4,4,4,8
2012,8,30,3,5,2,33,35
2012,8,30,3,6,8,155,163
2012,8,30,3,7,31,501,532
2012,8,30,3,8,53,701,754
2012,8,30,3,9,57,339,396
2012,8,30,3,10,73,161,234
2012,8,30,3,11,85,191,276
2012,8,30,3,12,73,221,294
2012,8,30,3,13,76,214,290
2012,8,30,3,14,74,199,273
2012,8,30,3,15,99,239,338
2012,8,30,3,16,77,405,482
2012,8,30,3,17,93,751,844
2012,8,30,3,18,109,744,853
2012,8,30,3,19,78,532,610
2012,8,30,3,20,68,403,471
2012,8,30,3,21,32,275,307
2012,8,30,3,22,38,253,291
2012,8,30,3,23,19,133,152
2012,8,31,4,0,13,69,82
2012,8,31,4,1,8,24,32
2012,8,31,4,2,9,11,20
2012,8,31,4,3,3,2,5
2012,8,31,4,4,0,7,7
2012,8,31,4,5,2,27,29
2012,8,31,4,6,7,101,108
2012,8,31,4,7,21,400,421
2012,8,31,4,8,36,654,690
2012,8,31,4,9,61,337,398
2012,8,31,4,10,59,197,256
2012,8,31,4,11,88,221,309
2012,8,31,4,12,120,290,410
2012,8,31,4,13,97,271,368
2012,8,31,4,14,112,324,436
2012,8,31,4,15,109,417,526
2012,8,31,4,16,111,417,528
2012,8,31,4,17,129,488,617
2012,8,31,4,18,87,459,546
2012,8,31,4,19,91,361,452
2012,8,31,4,20,102,254,356
2012,8,31,4,21,71,232,303
2012,8,31,4,22,65,212,277
2012,8,31,4,23,32,142,174
2012,9,1,5,0,22,146,168
2012,9,1,5,1,11,68,79
2012,9,1,5,2,8,61,69
2012,9,1,5,3,6,29,35
2012,9,1,5,4,3,9,12
2012,9,1,5,5,2,20,22
2012,9,1,5,6,13,23,36
2012,9,1,5,7,8,58,66
2012,9,1,5,8,28,134,162
2012,9,1,5,9,62,175,237
2012,9,1,5,10,128,289,417
2012,9,1,5,11,219,273,492
2012,9,1,5,12,187,284,471
2012,9,1,5,13,237,267,504
2012,9,1,5,14,240,274,514
2012,9,1,5,15,257,306,563
2012,9,1,5,16,209,253,462
2012,9,1,5,17,205,258,463
2012,9,1,5,18,184,258,442
2012,9,1,5,19,157,235,392
2012,9,1,5,20,67,140,207
2012,9,1,5,21,21,83,104
2012,9,1,5,22,21,57,78
2012,9,1,5,23,57,88,145
2012,9,2,6,0,27,72,99
2012,9,2,6,1,15,58,73
2012,9,2,6,2,28,56,84
2012,9,2,6,3,9,33,42
2012,9,2,6,4,7,15,22
2012,9,2,6,5,2,10,12
2012,9,2,6,6,2,13,15
2012,9,2,6,7,13,29,42
2012,9,2,6,8,30,99,129
2012,9,2,6,9,88,144,232
2012,9,2,6,10,158,230,388
2012,9,2,6,11,226,263,489
2012,9,2,6,12,248,297,545
2012,9,2,6,13,263,230,493
2012,9,2,6,14,249,208,457
2012,9,2,6,15,179,176,355
2012,9,2,6,16,222,252,474
2012,9,2,6,17,219,284,503
2012,9,2,6,18,227,273,500
2012,9,2,6,19,140,152,292
2012,9,2,6,20,63,41,104
2012,9,2,6,21,79,92,171
2012,9,2,6,22,66,100,166
2012,9,2,6,23,53,70,123
2012,9,3,0,0,42,62,104
2012,9,3,0,1,18,37,55
2012,9,3,0,2,10,30,40
2012,9,3,0,3,6,22,28
2012,9,3,0,4,6,5,11
2012,9,3,0,5,1,3,4
2012,9,3,0,6,3,12,15
2012,9,3,0,7,6,37,43
2012,9,3,0,8,36,91,127
2012,9,3,0,9,71,158,229
2012,9,3,0,10,135,224,359
2012,9,3,0,11,187,272,459
2012,9,3,0,12,191,352,543
2012,9,3,0,13,209,357,566
2012,9,3,0,14,163,349,512
2012,9,3,0,15,168,281,449
2012,9,3,0,16,165,335,500
2012,9,3,0,17,181,317,498
2012,9,3,0,18,145,337,482
2012,9,3,0,19,73,301,374
2012,9,3,0,20,78,183,261
2012,9,3,0,21,42,142,184
2012,9,3,0,22,17,104,121
2012,9,3,0,23,12,58,70
2012,9,4,1,0,10,19,29
2012,9,4,1,1,15,9,24
2012,9,4,1,2,1,4,5
2012,9,4,1,3,1,9,10
2012,9,4,1,4,0,8,8
2012,9,4,1,5,1,37,38
2012,9,4,1,6,7,165,172
2012,9,4,1,7,13,480,493
2012,9,4,1,8,15,617,632
2012,9,4,1,9,30,293,323
2012,9,4,1,10,42,130,172
2012,9,4,1,11,39,159,198
2012,9,4,1,12,54,233,287
2012,9,4,1,13,72,203,275
2012,9,4,1,14,72,202,274
2012,9,4,1,15,68,224,292
2012,9,4,1,16,61,397,458
2012,9,4,1,17,110,746,856
2012,9,4,1,18,94,745,839
2012,9,4,1,19,50,502,552
2012,9,4,1,20,47,338,385
2012,9,4,1,21,28,240,268
2012,9,4,1,22,25,154,179
2012,9,4,1,23,12,83,95
2012,9,5,2,0,10,27,37
2012,9,5,2,1,2,11,13
2012,9,5,2,2,0,9,9
2012,9,5,2,3,0,4,4
2012,9,5,2,4,2,3,5
2012,9,5,2,5,1,39,40
2012,9,5,2,6,7,203,210
2012,9,5,2,7,11,489,500
2012,9,5,2,8,33,692,725
2012,9,5,2,9,27,263,290
2012,9,5,2,10,54,181,235
2012,9,5,2,11,61,156,217
2012,9,5,2,12,49,217,266
2012,9,5,2,13,50,184,234
2012,9,5,2,14,34,177,211
2012,9,5,2,15,41,204,245
2012,9,5,2,16,86,344,430
2012,9,5,2,17,83,780,863
2012,9,5,2,18,82,757,839
2012,9,5,2,19,64,598,662
2012,9,5,2,20,55,357,412
2012,9,5,2,21,18,278,296
2012,9,5,2,22,38,181,219
2012,9,5,2,23,24,126,150
2012,9,6,3,0,30,35,65
2012,9,6,3,1,2,16,18
2012,9,6,3,2,1,7,8
2012,9,6,3,3,0,9,9
2012,9,6,3,4,0,8,8
2012,9,6,3,5,3,35,38
2012,9,6,3,6,11,189,200
2012,9,6,3,7,21,461,482
2012,9,6,3,8,24,622,646
2012,9,6,3,9,8,115,123
2012,9,6,3,10,9,40,49
2012,9,6,3,11,10,52,62
2012,9,6,3,12,11,126,137
2012,9,6,3,13,39,152,191
2012,9,6,3,14,38,178,216
2012,9,6,3,15,42,228,270
2012,9,6,3,16,42,374,416
2012,9,6,3,17,67,741,808
2012,9,6,3,18,74,761,835
2012,9,6,3,19,54,504,558
2012,9,6,3,20,50,356,406
2012,9,6,3,21,32,240,272
2012,9,6,3,22,24,193,217
2012,9,6,3,23,19,150,169
2012,9,7,4,0,17,79,96
2012,9,7,4,1,10,19,29
2012,9,7,4,2,1,10,11
2012,9,7,4,3,0,9,9
2012,9,7,4,4,1,7,8
2012,9,7,4,5,1,39,40
2012,9,7,4,6,5,135,140
2012,9,7,4,7,21,465,486
2012,9,7,4,8,29,690,719
2012,9,7,4,9,33,311,344
2012,9,7,4,10,53,171,224
2012,9,7,4,11,81,215,296
2012,9,7,4,12,76,247,323
2012,9,7,4,13,71,283,354
2012,9,7,4,14,66,187,253
2012,9,7,4,15,66,265,331
2012,9,7,4,16,75,395,470
2012,9,7,4,17,88,684,772
2012,9,7,4,18,95,697,792
2012,9,7,4,19,70,498,568
2012,9,7,4,20,51,340,391
2012,9,7,4,21,55,246,301
2012,9,7,4,22,52,247,299
2012,9,7,4,23,28,220,248
2012,9,8,5,0,20,130,150
2012,9,8,5,1,10,107,117
2012,9,8,5,2,9,68,77
2012,9,8,5,3,3,40,43
2012,9,8,5,4,3,8,11
2012,9,8,5,5,2,13,15
2012,9,8,5,6,8,26,34
2012,9,8,5,7,11,71,82
2012,9,8,5,8,33,197,230
2012,9,8,5,9,87,261,348
2012,9,8,5,10,100,322,422
2012,9,8,5,11,173,405,578
2012,9,8,5,12,220,474,694
2012,9,8,5,13,233,435,668
2012,9,8,5,14,260,366,626
2012,9,8,5,15,175,337,512
2012,9,8,5,16,19,95,114
2012,9,8,5,17,52,119,171
2012,9,8,5,18,27,140,167
2012,9,8,5,19,28,187,215
2012,9,8,5,20,28,166,194
2012,9,8,5,21,26,155,181
2012,9,8,5,22,18,176,194
2012,9,8,5,23,12,121,133
2012,9,9,6,0,18,106,124
2012,9,9,6,1,20,104,124
2012,9,9,6,2,15,81,96
2012,9,9,6,3,14,32,46
2012,9,9,6,4,12,16,28
2012,9,9,6,5,16,39,55
2012,9,9,6,6,11,24,35
2012,9,9,6,7,20,50,70
2012,9,9,6,8,27,143,170
2012,9,9,6,9,85,214,299
2012,9,9,6,10,172,323,495
2012,9,9,6,11,194,391,585
2012,9,9,6,12,247,510,757
2012,9,9,6,13,238,491,729
2012,9,9,6,14,232,415,647
2012,9,9,6,15,284,412,696
2012,9,9,6,16,228,473,701
2012,9,9,6,17,213,458,671
2012,9,9,6,18,156,404,560
2012,9,9,6,19,134,362,496
2012,9,9,6,20,91,265,356
2012,9,9,6,21,57,149,206
2012,9,9,6,22,64,125,189
2012,9,9,6,23,22,70,92
2012,9,10,0,0,6,35,41
2012,9,10,0,1,7,11,18
2012,9,10,0,2,11,6,17
2012,9,10,0,3,5,7,12
2012,9,10,0,4,1,4,5
2012,9,10,0,5,4,36,40
2012,9,10,0,6,8,172,180
2012,9,10,0,7,20,427,447
2012,9,10,0,8,33,697,730
2012,9,10,0,9,40,321,361
2012,9,10,0,10,42,168,210
2012,9,10,0,11,69,167,236
2012,9,10,0,12,76,256,332
2012,9,10,0,13,72,251,323
2012,9,10,0,14,107,233,340
2012,9,10,0,15,115,231,346
2012,9,10,0,16,108,380,488
2012,9,10,0,17,127,744,871
2012,9,10,0,18,111,857,968
2012,9,10,0,19,71,562,633
2012,9,10,0,20,34,356,390
2012,9,10,0,21,29,256,285
2012,9,10,0,22,15,144,159
2012,9,10,0,23,7,86,93
2012,9,11,1,0,5,27,32
2012,9,11,1,1,0,10,10
2012,9,11,1,2,1,5,6
2012,9,11,1,3,1,7,8
2012,9,11,1,4,1,8,9
2012,9,11,1,5,3,41,44
2012,9,11,1,6,11,200,211
2012,9,11,1,7,24,572,596
2012,9,11,1,8,48,702,750
2012,9,11,1,9,35,323,358
2012,9,11,1,10,54,142,196
2012,9,11,1,11,60,187,247
2012,9,11,1,12,62,254,316
2012,9,11,1,13,72,256,328
2012,9,11,1,14,74,181,255
2012,9,11,1,15,73,253,326
2012,9,11,1,16,99,437,536
2012,9,11,1,17,168,802,970
2012,9,11,1,18,110,767,877
2012,9,11,1,19,56,540,596
2012,9,11,1,20,40,421,461
2012,9,11,1,21,28,282,310
2012,9,11,1,22,27,189,216
2012,9,11,1,23,18,91,109
2012,9,12,2,0,8,41,49
2012,9,12,2,1,2,19,21
2012,9,12,2,2,2,9,11
2012,9,12,2,3,0,7,7
2012,9,12,2,4,0,5,5
2012,9,12,2,5,4,44,48
2012,9,12,2,6,6,199,205
2012,9,12,2,7,24,533,557
2012,9,12,2,8,43,727,770
2012,9,12,2,9,50,278,328
2012,9,12,2,10,57,148,205
2012,9,12,2,11,51,181,232
2012,9,12,2,12,88,264,352
2012,9,12,2,13,85,238,323
2012,9,12,2,14,78,200,278
2012,9,12,2,15,75,243,318
2012,9,12,2,16,90,419,509
2012,9,12,2,17,114,811,925
2012,9,12,2,18,91,886,977
2012,9,12,2,19,78,557,635
2012,9,12,2,20,38,432,470
2012,9,12,2,21,27,279,306
2012,9,12,2,22,23,189,212
2012,9,12,2,23,16,111,127
2012,9,13,3,0,11,46,57
2012,9,13,3,1,6,22,28
2012,9,13,3,2,0,9,9
2012,9,13,3,3,2,9,11
2012,9,13,3,4,0,6,6
2012,9,13,3,5,3,54,57
2012,9,13,3,6,9,186,195
2012,9,13,3,7,22,549,571
2012,9,13,3,8,33,725,758
2012,9,13,3,9,46,292,338
2012,9,13,3,10,63,149,212
2012,9,13,3,11,71,183,254
2012,9,13,3,12,57,240,297
2012,9,13,3,13,60,223,283
2012,9,13,3,14,60,214,274
2012,9,13,3,15,99,253,352
2012,9,13,3,16,85,406,491
2012,9,13,3,17,97,787,884
2012,9,13,3,18,108,744,852
2012,9,13,3,19,80,594,674
2012,9,13,3,20,55,408,463
2012,9,13,3,21,26,291,317
2012,9,13,3,22,28,223,251
2012,9,13,3,23,33,137,170
2012,9,14,4,0,24,63,87
2012,9,14,4,1,6,35,41
2012,9,14,4,2,7,23,30
2012,9,14,4,3,5,9,14
2012,9,14,4,4,1,11,12
2012,9,14,4,5,1,40,41
2012,9,14,4,6,8,144,152
2012,9,14,4,7,17,437,454
2012,9,14,4,8,51,715,766
2012,9,14,4,9,46,301,347
2012,9,14,4,10,75,171,246
2012,9,14,4,11,84,196,280
2012,9,14,4,12,119,290,409
2012,9,14,4,13,107,301,408
2012,9,14,4,14,113,258,371
2012,9,14,4,15,94,273,367
2012,9,14,4,16,109,454,563
2012,9,14,4,17,137,757,894
2012,9,14,4,18,116,692,808
2012,9,14,4,19,83,496,579
2012,9,14,4,20,67,337,404
2012,9,14,4,21,42,270,312
2012,9,14,4,22,40,189,229
2012,9,14,4,23,27,168,195
2012,9,15,5,0,38,169,207
2012,9,15,5,1,8,101,109
2012,9,15,5,2,18,75,93
2012,9,15,5,3,6,31,37
2012,9,15,5,4,3,3,6
2012,9,15,5,5,1,15,16
2012,9,15,5,6,6,27,33
2012,9,15,5,7,10,63,73
2012,9,15,5,8,43,169,212
2012,9,15,5,9,79,263,342
2012,9,15,5,10,119,323,442
2012,9,15,5,11,228,399,627
2012,9,15,5,12,287,419,706
2012,9,15,5,13,327,377,704
2012,9,15,5,14,325,390,715
2012,9,15,5,15,312,342,654
2012,9,15,5,16,350,433,783
2012,9,15,5,17,295,434,729
2012,9,15,5,18,232,382,614
2012,9,15,5,19,169,309,478
2012,9,15,5,20,89,241,330
2012,9,15,5,21,86,210,296
2012,9,15,5,22,82,197,279
2012,9,15,5,23,47,182,229
2012,9,16,6,0,28,123,151
2012,9,16,6,1,35,82,117
2012,9,16,6,2,27,62,89
2012,9,16,6,3,10,38,48
2012,9,16,6,4,2,6,8
2012,9,16,6,5,3,10,13
2012,9,16,6,6,9,26,35
2012,9,16,6,7,28,43,71
2012,9,16,6,8,34,94,128
2012,9,16,6,9,70,226,296
2012,9,16,6,10,160,330,490
2012,9,16,6,11,183,376,559
2012,9,16,6,12,188,468,656
2012,9,16,6,13,240,454,694
2012,9,16,6,14,225,410,635
2012,9,16,6,15,215,342,557
2012,9,16,6,16,194,402,596
2012,9,16,6,17,177,393,570
2012,9,16,6,18,120,361,481
2012,9,16,6,19,91,312,403
2012,9,16,6,20,57,267,324
2012,9,16,6,21,43,148,191
2012,9,16,6,22,18,109,127
2012,9,16,6,23,9,85,94
2012,9,17,0,0,14,31,45
2012,9,17,0,1,9,12,21
2012,9,17,0,2,5,8,13
2012,9,17,0,3,0,7,7
2012,9,17,0,4,2,9,11
2012,9,17,0,5,1,44,45
2012,9,17,0,6,7,157,164
2012,9,17,0,7,18,474,492
2012,9,17,0,8,36,647,683
2012,9,17,0,9,34,265,299
2012,9,17,0,10,73,129,202
2012,9,17,0,11,61,191,252
2012,9,17,0,12,62,233,295
2012,9,17,0,13,112,231,343
2012,9,17,0,14,129,203,332
2012,9,17,0,15,82,256,338
2012,9,17,0,16,74,379,453
2012,9,17,0,17,102,740,842
2012,9,17,0,18,66,708,774
2012,9,17,0,19,51,435,486
2012,9,17,0,20,32,308,340
2012,9,17,0,21,28,205,233
2012,9,17,0,22,20,109,129
2012,9,17,0,23,4,66,70
2012,9,18,1,0,2,11,13
2012,9,18,1,1,0,5,5
2012,9,18,1,2,0,4,4
2012,9,18,1,3,0,6,6
2012,9,18,1,4,2,5,7
2012,9,18,1,5,3,45,48
2012,9,18,1,6,4,163,167
2012,9,18,1,7,13,343,356
2012,9,18,1,8,32,640,672
2012,9,18,1,9,27,266,293
2012,9,18,1,10,30,130,160
2012,9,18,1,11,36,115,151
2012,9,18,1,12,16,72,88
2012,9,18,1,13,17,97,114
2012,9,18,1,14,27,116,143
2012,9,18,1,15,1,35,36
2012,9,18,1,16,19,122,141
2012,9,18,1,17,36,302,338
2012,9,18,1,18,19,262,281
2012,9,18,1,19,22,302,324
2012,9,18,1,20,19,271,290
2012,9,18,1,21,21,186,207
2012,9,18,1,22,14,137,151
2012,9,18,1,23,11,67,78
2012,9,19,2,0,3,23,26
2012,9,19,2,1,0,12,12
2012,9,19,2,2,0,3,3
2012,9,19,2,3,1,4,5
2012,9,19,2,4,0,10,10
2012,9,19,2,5,2,54,56
2012,9,19,2,6,6,166,172
2012,9,19,2,7,16,529,545
2012,9,19,2,8,39,758,797
2012,9,19,2,9,26,336,362
2012,9,19,2,10,23,169,192
2012,9,19,2,11,44,203,247
2012,9,19,2,12,53,260,313
2012,9,19,2,13,55,234,289
2012,9,19,2,14,59,227,286
2012,9,19,2,15,57,254,311
2012,9,19,2,16,69,397,466
2012,9,19,2,17,74,812,886
2012,9,19,2,18,85,807,892
2012,9,19,2,19,72,539,611
2012,9,19,2,20,31,378,409
2012,9,19,2,21,25,324,349
2012,9,19,2,22,31,198,229
2012,9,19,2,23,17,106,123
2012,9,20,3,0,12,46,58
2012,9,20,3,1,4,14,18
2012,9,20,3,2,2,9,11
2012,9,20,3,3,0,6,6
2012,9,20,3,4,0,6,6
2012,9,20,3,5,4,52,56
2012,9,20,3,6,9,161,170
2012,9,20,3,7,20,514,534
2012,9,20,3,8,44,746,790
2012,9,20,3,9,25,330,355
2012,9,20,3,10,33,157,190
2012,9,20,3,11,37,206,243
2012,9,20,3,12,57,233,290
2012,9,20,3,13,68,268,336
2012,9,20,3,14,76,222,298
2012,9,20,3,15,60,231,291
2012,9,20,3,16,72,385,457
2012,9,20,3,17,91,885,976
2012,9,20,3,18,119,781,900
2012,9,20,3,19,69,534,603
2012,9,20,3,20,57,360,417
2012,9,20,3,21,28,246,274
2012,9,20,3,22,35,252,287
2012,9,20,3,23,17,137,154
2012,9,21,4,0,13,53,66
2012,9,21,4,1,11,38,49
2012,9,21,4,2,6,8,14
2012,9,21,4,3,1,11,12
2012,9,21,4,4,1,9,10
2012,9,21,4,5,2,47,49
2012,9,21,4,6,19,146,165
2012,9,21,4,7,35,468,503
2012,9,21,4,8,31,726,757
2012,9,21,4,9,35,348,383
2012,9,21,4,10,44,181,225
2012,9,21,4,11,79,242,321
2012,9,21,4,12,84,305,389
2012,9,21,4,13,105,316,421
2012,9,21,4,14,113,299,412
2012,9,21,4,15,90,333,423
2012,9,21,4,16,103,464,567
2012,9,21,4,17,107,739,846
2012,9,21,4,18,106,699,805
2012,9,21,4,19,95,493,588
2012,9,21,4,20,54,315,369
2012,9,21,4,21,46,266,312
2012,9,21,4,22,47,248,295
2012,9,21,4,23,23,163,186
2012,9,22,5,0,32,140,172
2012,9,22,5,1,18,106,124
2012,9,22,5,2,10,73,83
2012,9,22,5,3,6,39,45
2012,9,22,5,4,5,10,15
2012,9,22,5,5,2,15,17
2012,9,22,5,6,6,35,41
2012,9,22,5,7,7,70,77
2012,9,22,5,8,21,197,218
2012,9,22,5,9,88,289,377
2012,9,22,5,10,124,350,474
2012,9,22,5,11,189,437,626
2012,9,22,5,12,228,460,688
2012,9,22,5,13,273,434,707
2012,9,22,5,14,250,404,654
2012,9,22,5,15,307,443,750
2012,9,22,5,16,253,427,680
2012,9,22,5,17,195,451,646
2012,9,22,5,18,171,427,598
2012,9,22,5,19,99,308,407
2012,9,22,5,20,76,249,325
2012,9,22,5,21,59,202,261
2012,9,22,5,22,59,180,239
2012,9,22,5,23,34,137,171
2012,9,23,6,0,34,146,180
2012,9,23,6,1,23,119,142
2012,9,23,6,2,18,77,95
2012,9,23,6,3,13,41,54
2012,9,23,6,4,1,9,10
2012,9,23,6,5,1,5,6
2012,9,23,6,6,5,11,16
2012,9,23,6,7,9,48,57
2012,9,23,6,8,38,137,175
2012,9,23,6,9,71,205,276
2012,9,23,6,10,138,351,489
2012,9,23,6,11,186,384,570
2012,9,23,6,12,250,526,776
2012,9,23,6,13,257,445,702
2012,9,23,6,14,266,400,666
2012,9,23,6,15,265,375,640
2012,9,23,6,16,254,437,691
2012,9,23,6,17,227,496,723
2012,9,23,6,18,135,405,540
2012,9,23,6,19,82,331,413
2012,9,23,6,20,60,192,252
2012,9,23,6,21,51,145,196
2012,9,23,6,22,40,98,138
2012,9,23,6,23,30,70,100
2012,9,24,0,0,10,54,64
2012,9,24,0,1,6,12,18
2012,9,24,0,2,0,8,8
2012,9,24,0,3,0,5,5
2012,9,24,0,4,0,8,8
2012,9,24,0,5,2,35,37
2012,9,24,0,6,6,162,168
2012,9,24,0,7,17,513,530
2012,9,24,0,8,31,719,750
2012,9,24,0,9,42,286,328
2012,9,24,0,10,52,146,198
2012,9,24,0,11,71,167,238
2012,9,24,0,12,77,265,342
2012,9,24,0,13,80,248,328
2012,9,24,0,14,77,226,303
2012,9,24,0,15,84,216,300
2012,9,24,0,16,99,417,516
2012,9,24,0,17,89,809,898
2012,9,24,0,18,95,758,853
2012,9,24,0,19,56,534,590
2012,9,24,0,20,52,380,432
2012,9,24,0,21,26,230,256
2012,9,24,0,22,18,154,172
2012,9,24,0,23,11,83,94
2012,9,25,1,0,8,56,64
2012,9,25,1,1,2,11,13
2012,9,25,1,2,5,9,14
2012,9,25,1,3,2,3,5
2012,9,25,1,4,2,7,9
2012,9,25,1,5,1,46,47
2012,9,25,1,6,5,189,194
2012,9,25,1,7,17,539,556
2012,9,25,1,8,41,764,805
2012,9,25,1,9,28,381,409
2012,9,25,1,10,45,125,170
2012,9,25,1,11,63,155,218
2012,9,25,1,12,69,233,302
2012,9,25,1,13,48,257,305
2012,9,25,1,14,80,213,293
2012,9,25,1,15,56,247,303
2012,9,25,1,16,59,436,495
2012,9,25,1,17,107,860,967
2012,9,25,1,18,64,758,822
2012,9,25,1,19,49,490,539
2012,9,25,1,20,37,388,425
2012,9,25,1,21,34,263,297
2012,9,25,1,22,14,174,188
2012,9,25,1,23,9,89,98
2012,9,26,2,0,6,34,40
2012,9,26,2,1,10,19,29
2012,9,26,2,2,2,15,17
2012,9,26,2,3,4,6,10
2012,9,26,2,4,2,12,14
2012,9,26,2,5,1,35,36
2012,9,26,2,6,3,179,182
2012,9,26,2,7,9,523,532
2012,9,26,2,8,30,808,838
2012,9,26,2,9,27,307,334
2012,9,26,2,10,29,156,185
2012,9,26,2,11,46,181,227
2012,9,26,2,12,56,260,316
2012,9,26,2,13,67,273,340
2012,9,26,2,14,60,217,277
2012,9,26,2,15,69,231,300
2012,9,26,2,16,71,397,468
2012,9,26,2,17,77,876,953
2012,9,26,2,18,69,815,884
2012,9,26,2,19,38,589,627
2012,9,26,2,20,45,389,434
2012,9,26,2,21,32,328,360
2012,9,26,2,22,21,194,215
2012,9,26,2,23,13,102,115
2012,9,27,3,0,5,60,65
2012,9,27,3,1,5,16,21
2012,9,27,3,2,3,13,16
2012,9,27,3,3,0,7,7
2012,9,27,3,4,2,6,8
2012,9,27,3,5,2,64,66
2012,9,27,3,6,5,164,169
2012,9,27,3,7,12,546,558
2012,9,27,3,8,20,774,794
2012,9,27,3,9,30,305,335
2012,9,27,3,10,40,168,208
2012,9,27,3,11,67,227,294
2012,9,27,3,12,63,272,335
2012,9,27,3,13,61,265,326
2012,9,27,3,14,44,214,258
2012,9,27,3,15,41,255,296
2012,9,27,3,16,73,399,472
2012,9,27,3,17,87,818,905
2012,9,27,3,18,77,822,899
2012,9,27,3,19,48,511,559
2012,9,27,3,20,45,412,457
2012,9,27,3,21,18,235,253
2012,9,27,3,22,2,45,47
2012,9,27,3,23,1,44,45
2012,9,28,4,0,2,15,17
2012,9,28,4,1,0,13,13
2012,9,28,4,2,1,9,10
2012,9,28,4,3,0,7,7
2012,9,28,4,4,2,10,12
2012,9,28,4,5,1,37,38
2012,9,28,4,6,2,136,138
2012,9,28,4,7,10,384,394
2012,9,28,4,8,31,674,705
2012,9,28,4,9,27,399,426
2012,9,28,4,10,51,194,245
2012,9,28,4,11,109,252,361
2012,9,28,4,12,94,286,380
2012,9,28,4,13,106,304,410
2012,9,28,4,14,105,294,399
2012,9,28,4,15,104,288,392
2012,9,28,4,16,83,419,502
2012,9,28,4,17,101,707,808
2012,9,28,4,18,58,609,667
2012,9,28,4,19,38,470,508
2012,9,28,4,20,32,304,336
2012,9,28,4,21,32,205,237
2012,9,28,4,22,30,190,220
2012,9,28,4,23,26,164,190
2012,9,29,5,0,15,134,149
2012,9,29,5,1,12,89,101
2012,9,29,5,2,12,80,92
2012,9,29,5,3,4,25,29
2012,9,29,5,4,6,8,14
2012,9,29,5,5,2,13,15
2012,9,29,5,6,4,33,37
2012,9,29,5,7,12,61,73
2012,9,29,5,8,37,174,211
2012,9,29,5,9,69,263,332
2012,9,29,5,10,134,338,472
2012,9,29,5,11,217,446,663
2012,9,29,5,12,191,491,682
2012,9,29,5,13,233,453,686
2012,9,29,5,14,302,448,750
2012,9,29,5,15,271,456,727
2012,9,29,5,16,275,447,722
2012,9,29,5,17,256,456,712
2012,9,29,5,18,174,420,594
2012,9,29,5,19,119,351,470
2012,9,29,5,20,88,227,315
2012,9,29,5,21,73,219,292
2012,9,29,5,22,48,173,221
2012,9,29,5,23,35,161,196
2012,9,30,6,0,35,112,147
2012,9,30,6,1,31,85,116
2012,9,30,6,2,21,71,92
2012,9,30,6,3,17,41,58
2012,9,30,6,4,1,6,7
2012,9,30,6,5,1,9,10
2012,9,30,6,6,2,20,22
2012,9,30,6,7,14,43,57
2012,9,30,6,8,18,126,144
2012,9,30,6,9,74,211,285
2012,9,30,6,10,160,319,479
2012,9,30,6,11,222,369,591
2012,9,30,6,12,206,474,680
2012,9,30,6,13,180,414,594
2012,9,30,6,14,208,404,612
2012,9,30,6,15,230,419,649
2012,9,30,6,16,202,446,648
2012,9,30,6,17,195,380,575
2012,9,30,6,18,91,310,401
2012,9,30,6,19,34,223,257
2012,9,30,6,20,31,163,194
2012,9,30,6,21,19,104,123
2012,9,30,6,22,15,76,91
2012,9,30,6,23,8,49,57
2012,10,1,0,0,6,39,45
2012,10,1,0,1,5,13,18
2012,10,1,0,2,6,6,12
2012,10,1,0,3,1,6,7
2012,10,1,0,4,0,10,10
2012,10,1,0,5,2,34,36
2012,10,1,0,6,8,147,155
2012,10,1,0,7,13,470,483
2012,10,1,0,8,40,744,784
2012,10,1,0,9,26,314,340
2012,10,1,0,10,44,135,179
2012,10,1,0,11,76,196,272
2012,10,1,0,12,61,262,323
2012,10,1,0,13,80,225,305
2012,10,1,0,14,51,193,244
2012,10,1,0,15,95,234,329
2012,10,1,0,16,51,408,459
2012,10,1,0,17,65,791,856
2012,10,1,0,18,42,571,613
2012,10,1,0,19,33,483,516
2012,10,1,0,20,11,251,262
2012,10,1,0,21,13,205,218
2012,10,1,0,22,17,190,207
2012,10,1,0,23,17,88,105
2012,10,2,1,0,1,30,31
2012,10,2,1,1,0,11,11
2012,10,2,1,2,0,2,2
2012,10,2,1,3,1,4,5
2012,10,2,1,4,2,8,10
2012,10,2,1,5,1,42,43
2012,10,2,1,6,3,176,179
2012,10,2,1,7,4,256,260
2012,10,2,1,8,6,128,134
2012,10,2,1,9,3,83,86
2012,10,2,1,10,3,42,45
2012,10,2,1,11,7,92,99
2012,10,2,1,12,6,98,104
2012,10,2,1,13,6,148,154
2012,10,2,1,14,16,147,163
2012,10,2,1,15,14,195,209
2012,10,2,1,16,46,328,374
2012,10,2,1,17,38,677,715
2012,10,2,1,18,48,639,687
2012,10,2,1,19,27,368,395
2012,10,2,1,20,20,286,306
2012,10,2,1,21,24,265,289
2012,10,2,1,22,28,212,240
2012,10,2,1,23,11,87,98
2012,10,3,2,0,5,47,52
2012,10,3,2,1,3,16,19
2012,10,3,2,2,2,7,9
2012,10,3,2,3,0,7,7
2012,10,3,2,4,2,9,11
2012,10,3,2,5,2,32,34
2012,10,3,2,6,4,173,177
2012,10,3,2,7,11,504,515
2012,10,3,2,8,28,781,809
2012,10,3,2,9,30,332,362
2012,10,3,2,10,29,146,175
2012,10,3,2,11,52,178,230
2012,10,3,2,12,69,289,358
2012,10,3,2,13,55,224,279
2012,10,3,2,14,56,195,251
2012,10,3,2,15,59,260,319
2012,10,3,2,16,42,436,478
2012,10,3,2,17,84,833,917
2012,10,3,2,18,54,756,810
2012,10,3,2,19,49,544,593
2012,10,3,2,20,48,449,497
2012,10,3,2,21,14,195,209
2012,10,3,2,22,9,232,241
2012,10,3,2,23,21,199,220
2012,10,4,3,0,11,65,76
2012,10,4,3,1,2,23,25
2012,10,4,3,2,3,10,13
2012,10,4,3,3,5,6,11
2012,10,4,3,4,0,10,10
2012,10,4,3,5,2,37,39
2012,10,4,3,6,1,132,133
2012,10,4,3,7,12,379,391
2012,10,4,3,8,27,711,738
2012,10,4,3,9,40,319,359
2012,10,4,3,10,27,150,177
2012,10,4,3,11,38,176,214
2012,10,4,3,12,57,231,288
2012,10,4,3,13,63,231,294
2012,10,4,3,14,56,211,267
2012,10,4,3,15,77,248,325
2012,10,4,3,16,86,411,497
2012,10,4,3,17,112,789,901
2012,10,4,3,18,75,812,887
2012,10,4,3,19,67,467,534
2012,10,4,3,20,50,391,441
2012,10,4,3,21,33,288,321
2012,10,4,3,22,29,203,232
2012,10,4,3,23,18,137,155
2012,10,5,4,0,16,86,102
2012,10,5,4,1,3,43,46
2012,10,5,4,2,1,10,11
2012,10,5,4,3,5,11,16
2012,10,5,4,4,0,11,11
2012,10,5,4,5,0,41,41
2012,10,5,4,6,4,133,137
2012,10,5,4,7,11,417,428
2012,10,5,4,8,36,749,785
2012,10,5,4,9,58,326,384
2012,10,5,4,10,68,192,260
2012,10,5,4,11,90,214,304
2012,10,5,4,12,161,307,468
2012,10,5,4,13,117,307,424
2012,10,5,4,14,113,287,400
2012,10,5,4,15,150,320,470
2012,10,5,4,16,153,481,634
2012,10,5,4,17,158,742,900
2012,10,5,4,18,106,655,761
2012,10,5,4,19,67,433,500
2012,10,5,4,20,66,306,372
2012,10,5,4,21,47,220,267
2012,10,5,4,22,63,201,264
2012,10,5,4,23,23,148,171
2012,10,6,5,0,37,154,191
2012,10,6,5,1,25,116,141
2012,10,6,5,2,13,62,75
2012,10,6,5,3,2,54,56
2012,10,6,5,4,4,7,11
2012,10,6,5,5,2,8,10
2012,10,6,5,6,2,28,30
2012,10,6,5,7,13,71,84
2012,10,6,5,8,22,184,206
2012,10,6,5,9,130,265,395
2012,10,6,5,10,198,341,539
2012,10,6,5,11,258,389,647
2012,10,6,5,12,362,381,743
2012,10,6,5,13,310,400,710
2012,10,6,5,14,269,307,576
2012,10,6,5,15,279,341,620
2012,10,6,5,16,317,342,659
2012,10,6,5,17,268,342,610
2012,10,6,5,18,183,312,495
2012,10,6,5,19,102,239,341
2012,10,6,5,20,75,172,247
2012,10,6,5,21,78,137,215
2012,10,6,5,22,45,140,185
2012,10,6,5,23,37,142,179
2012,10,7,6,0,28,99,127
2012,10,7,6,1,29,80,109
2012,10,7,6,2,10,64,74
2012,10,7,6,3,5,17,22
2012,10,7,6,4,5,6,11
2012,10,7,6,5,2,8,10
2012,10,7,6,6,4,19,23
2012,10,7,6,7,6,29,35
2012,10,7,6,8,11,51,62
2012,10,7,6,9,16,70,86
2012,10,7,6,10,41,144,185
2012,10,7,6,11,76,260,336
2012,10,7,6,12,100,292,392
2012,10,7,6,13,80,240,320
2012,10,7,6,14,71,243,314
2012,10,7,6,15,74,232,306
2012,10,7,6,16,87,246,333
2012,10,7,6,17,35,122,157
2012,10,7,6,18,24,82,106
2012,10,7,6,19,17,97,114
2012,10,7,6,20,19,97,116
2012,10,7,6,21,22,91,113
2012,10,7,6,22,7,72,79
2012,10,7,6,23,12,68,80
2012,10,8,0,0,7,44,51
2012,10,8,0,1,2,35,37
2012,10,8,0,2,3,12,15
2012,10,8,0,3,2,8,10
2012,10,8,0,4,1,6,7
2012,10,8,0,5,2,17,19
2012,10,8,0,6,5,54,59
2012,10,8,0,7,3,151,154
2012,10,8,0,8,23,374,397
2012,10,8,0,9,59,273,332
2012,10,8,0,10,69,229,298
2012,10,8,0,11,72,236,308
2012,10,8,0,12,74,267,341
2012,10,8,0,13,82,323,405
2012,10,8,0,14,121,299,420
2012,10,8,0,15,76,294,370
2012,10,8,0,16,61,316,377
2012,10,8,0,17,81,416,497
2012,10,8,0,18,41,415,456
2012,10,8,0,19,38,333,371
2012,10,8,0,20,20,207,227
2012,10,8,0,21,17,134,151
2012,10,8,0,22,6,101,107
2012,10,8,0,23,9,60,69
2012,10,9,1,0,9,22,31
2012,10,9,1,1,0,13,13
2012,10,9,1,2,2,5,7
2012,10,9,1,3,0,3,3
2012,10,9,1,4,1,6,7
2012,10,9,1,5,0,19,19
2012,10,9,1,6,2,141,143
2012,10,9,1,7,5,357,362
2012,10,9,1,8,15,698,713
2012,10,9,1,9,37,345,382
2012,10,9,1,10,33,131,164
2012,10,9,1,11,37,156,193
2012,10,9,1,12,43,217,260
2012,10,9,1,13,54,184,238
2012,10,9,1,14,43,201,244
2012,10,9,1,15,59,195,254
2012,10,9,1,16,70,354,424
2012,10,9,1,17,73,733,806
2012,10,9,1,18,26,758,784
2012,10,9,1,19,31,483,514
2012,10,9,1,20,30,330,360
2012,10,9,1,21,16,209,225
2012,10,9,1,22,7,155,162
2012,10,9,1,23,8,76,84
2012,10,10,2,0,0,33,33
2012,10,10,2,1,2,6,8
2012,10,10,2,2,2,6,8
2012,10,10,2,3,0,6,6
2012,10,10,2,4,0,6,6
2012,10,10,2,5,2,38,40
2012,10,10,2,6,3,172,175
2012,10,10,2,7,9,498,507
2012,10,10,2,8,33,806,839
2012,10,10,2,9,35,331,366
2012,10,10,2,10,27,190,217
2012,10,10,2,11,53,238,291
2012,10,10,2,12,78,312,390
2012,10,10,2,13,60,237,297
2012,10,10,2,14,63,208,271
2012,10,10,2,15,58,261,319
2012,10,10,2,16,92,474,566
2012,10,10,2,17,91,857,948
2012,10,10,2,18,57,787,844
2012,10,10,2,19,32,534,566
2012,10,10,2,20,21,371,392
2012,10,10,2,21,18,251,269
2012,10,10,2,22,27,170,197
2012,10,10,2,23,17,119,136
2012,10,11,3,0,1,41,42
2012,10,11,3,1,1,10,11
2012,10,11,3,2,4,7,11
2012,10,11,3,3,0,3,3
2012,10,11,3,4,0,10,10
2012,10,11,3,5,0,42,42
2012,10,11,3,6,1,158,159
2012,10,11,3,7,11,467,478
2012,10,11,3,8,25,773,798
2012,10,11,3,9,27,328,355
2012,10,11,3,10,39,165,204
2012,10,11,3,11,76,175,251
2012,10,11,3,12,47,279,326
2012,10,11,3,13,48,243,291
2012,10,11,3,14,78,270,348
2012,10,11,3,15,102,358,460
2012,10,11,3,16,68,413,481
2012,10,11,3,17,90,737,827
2012,10,11,3,18,64,628,692
2012,10,11,3,19,81,662,743
2012,10,11,3,20,27,388,415
2012,10,11,3,21,24,236,260
2012,10,11,3,22,10,167,177
2012,10,11,3,23,10,176,186
2012,10,12,4,0,8,60,68
2012,10,12,4,1,8,29,37
2012,10,12,4,2,0,16,16
2012,10,12,4,3,0,6,6
2012,10,12,4,4,0,8,8
2012,10,12,4,5,2,33,35
2012,10,12,4,6,3,140,143
2012,10,12,4,7,8,384,392
2012,10,12,4,8,34,711,745
2012,10,12,4,9,26,374,400
2012,10,12,4,10,75,200,275
2012,10,12,4,11,61,252,313
2012,10,12,4,12,75,312,387
2012,10,12,4,13,81,300,381
2012,10,12,4,14,109,262,371
2012,10,12,4,15,138,317,455
2012,10,12,4,16,108,412,520
2012,10,12,4,17,131,706,837
2012,10,12,4,18,76,566,642
2012,10,12,4,19,40,453,493
2012,10,12,4,20,28,280,308
2012,10,12,4,21,21,169,190
2012,10,12,4,22,17,143,160
2012,10,12,4,23,11,89,100
2012,10,13,5,0,31,218,249
2012,10,13,5,1,23,123,146
2012,10,13,5,2,7,60,67
2012,10,13,5,3,2,13,15
2012,10,13,5,4,2,9,11
2012,10,13,5,5,0,11,11
2012,10,13,5,6,5,23,28
2012,10,13,5,7,10,60,70
2012,10,13,5,8,23,151,174
2012,10,13,5,9,46,220,266
2012,10,13,5,10,82,265,347
2012,10,13,5,11,192,335,527
2012,10,13,5,12,202,371,573
2012,10,13,5,13,235,435,670
2012,10,13,5,14,243,354,597
2012,10,13,5,15,251,364,615
2012,10,13,5,16,294,343,637
2012,10,13,5,17,193,335,528
2012,10,13,5,18,174,299,473
2012,10,13,5,19,73,259,332
2012,10,13,5,20,57,198,255
2012,10,13,5,21,47,157,204
2012,10,13,5,22,33,156,189
2012,10,13,5,23,27,98,125
2012,10,14,6,0,8,103,111
2012,10,14,6,1,16,96,112
2012,10,14,6,2,8,58,66
2012,10,14,6,3,3,25,28
2012,10,14,6,4,2,10,12
2012,10,14,6,5,5,6,11
2012,10,14,6,6,4,20,24
2012,10,14,6,7,7,44,51
2012,10,14,6,8,28,104,132
2012,10,14,6,9,62,161,223
2012,10,14,6,10,150,278,428
2012,10,14,6,11,156,338,494
2012,10,14,6,12,200,362,562
2012,10,14,6,13,218,401,619
2012,10,14,6,14,249,368,617
2012,10,14,6,15,213,355,568
2012,10,14,6,16,203,378,581
2012,10,14,6,17,193,346,539
2012,10,14,6,18,134,319,453
2012,10,14,6,19,68,268,336
2012,10,14,6,20,48,198,246
2012,10,14,6,21,40,156,196
2012,10,14,6,22,38,87,125
2012,10,14,6,23,27,78,105
2012,10,15,0,0,17,31,48
2012,10,15,0,1,5,24,29
2012,10,15,0,2,1,5,6
2012,10,15,0,3,2,2,4
2012,10,15,0,4,1,9,10
2012,10,15,0,5,2,38,40
2012,10,15,0,6,6,141,147
2012,10,15,0,7,15,461,476
2012,10,15,0,8,24,713,737
2012,10,15,0,9,31,328,359
2012,10,15,0,10,43,125,168
2012,10,15,0,11,88,175,263
2012,10,15,0,12,73,211,284
2012,10,15,0,13,37,109,146
2012,10,15,0,14,57,128,185
2012,10,15,0,15,70,190,260
2012,10,15,0,16,76,371,447
2012,10,15,0,17,96,670,766
2012,10,15,0,18,52,540,592
2012,10,15,0,19,12,227,239
2012,10,15,0,20,19,237,256
2012,10,15,0,21,16,190,206
2012,10,15,0,22,8,118,126
2012,10,15,0,23,9,72,81
2012,10,16,1,0,3,45,48
2012,10,16,1,1,4,9,13
2012,10,16,1,2,2,1,3
2012,10,16,1,3,0,2,2
2012,10,16,1,4,0,7,7
2012,10,16,1,5,5,47,52
2012,10,16,1,6,4,168,172
2012,10,16,1,7,20,505,525
2012,10,16,1,8,35,800,835
2012,10,16,1,9,32,323,355
2012,10,16,1,10,65,157,222
2012,10,16,1,11,56,172,228
2012,10,16,1,12,69,256,325
2012,10,16,1,13,68,260,328
2012,10,16,1,14,94,214,308
2012,10,16,1,15,76,270,346
2012,10,16,1,16,79,367,446
2012,10,16,1,17,104,839,943
2012,10,16,1,18,71,767,838
2012,10,16,1,19,40,491,531
2012,10,16,1,20,35,397,432
2012,10,16,1,21,19,176,195
2012,10,16,1,22,18,163,181
2012,10,16,1,23,23,176,199
2012,10,17,2,0,1,48,49
2012,10,17,2,1,3,14,17
2012,10,17,2,2,4,12,16
2012,10,17,2,3,0,7,7
2012,10,17,2,4,0,4,4
2012,10,17,2,5,2,39,41
2012,10,17,2,6,7,171,178
2012,10,17,2,7,15,449,464
2012,10,17,2,8,38,779,817
2012,10,17,2,9,38,344,382
2012,10,17,2,10,60,168,228
2012,10,17,2,11,78,156,234
2012,10,17,2,12,71,261,332
2012,10,17,2,13,73,237,310
2012,10,17,2,14,82,188,270
2012,10,17,2,15,62,239,301
2012,10,17,2,16,70,396,466
2012,10,17,2,17,122,766,888
2012,10,17,2,18,90,794,884
2012,10,17,2,19,49,467,516
2012,10,17,2,20,54,360,414
2012,10,17,2,21,28,301,329
2012,10,17,2,22,17,198,215
2012,10,17,2,23,15,84,99
2012,10,18,3,0,4,53,57
2012,10,18,3,1,0,14,14
2012,10,18,3,2,1,13,14
2012,10,18,3,3,0,5,5
2012,10,18,3,4,0,5,5
2012,10,18,3,5,1,41,42
2012,10,18,3,6,3,150,153
2012,10,18,3,7,20,488,508
2012,10,18,3,8,31,803,834
2012,10,18,3,9,41,346,387
2012,10,18,3,10,60,158,218
2012,10,18,3,11,79,189,268
2012,10,18,3,12,93,284,377
2012,10,18,3,13,96,236,332
2012,10,18,3,14,94,191,285
2012,10,18,3,15,69,284,353
2012,10,18,3,16,94,356,450
2012,10,18,3,17,102,788,890
2012,10,18,3,18,68,720,788
2012,10,18,3,19,42,471,513
2012,10,18,3,20,39,348,387
2012,10,18,3,21,38,245,283
2012,10,18,3,22,27,202,229
2012,10,18,3,23,6,111,117
2012,10,19,4,0,5,51,56
2012,10,19,4,1,4,12,16
2012,10,19,4,2,1,9,10
2012,10,19,4,3,0,5,5
2012,10,19,4,4,1,5,6
2012,10,19,4,5,1,35,36
2012,10,19,4,6,5,126,131
2012,10,19,4,7,5,149,154
2012,10,19,4,8,20,447,467
2012,10,19,4,9,26,363,389
2012,10,19,4,10,26,198,224
2012,10,19,4,11,41,211,252
2012,10,19,4,12,74,258,332
2012,10,19,4,13,87,288,375
2012,10,19,4,14,88,277,365
2012,10,19,4,15,93,302,395
2012,10,19,4,16,131,434,565
2012,10,19,4,17,48,377,425
2012,10,19,4,18,21,212,233
2012,10,19,4,19,19,213,232
2012,10,19,4,20,13,216,229
2012,10,19,4,21,17,189,206
2012,10,19,4,22,14,176,190
2012,10,19,4,23,13,118,131
2012,10,20,5,0,13,110,123
2012,10,20,5,1,2,93,95
2012,10,20,5,2,9,69,78
2012,10,20,5,3,2,27,29
2012,10,20,5,4,9,9,18
2012,10,20,5,5,6,7,13
2012,10,20,5,6,5,26,31
2012,10,20,5,7,6,59,65
2012,10,20,5,8,29,164,193
2012,10,20,5,9,106,257,363
2012,10,20,5,10,111,312,423
2012,10,20,5,11,204,408,612
2012,10,20,5,12,267,436,703
2012,10,20,5,13,273,441,714
2012,10,20,5,14,335,376,711
2012,10,20,5,15,308,403,711
2012,10,20,5,16,325,366,691
2012,10,20,5,17,347,384,731
2012,10,20,5,18,165,356,521
2012,10,20,5,19,77,268,345
2012,10,20,5,20,61,198,259
2012,10,20,5,21,72,224,296
2012,10,20,5,22,47,155,202
2012,10,20,5,23,27,136,163
2012,10,21,6,0,35,119,154
2012,10,21,6,1,20,97,117
2012,10,21,6,2,44,88,132
2012,10,21,6,3,12,29,41
2012,10,21,6,4,8,13,21
2012,10,21,6,5,6,4,10
2012,10,21,6,6,8,18,26
2012,10,21,6,7,13,43,56
2012,10,21,6,8,39,104,143
2012,10,21,6,9,77,192,269
2012,10,21,6,10,167,276,443
2012,10,21,6,11,191,356,547
2012,10,21,6,12,236,439,675
2012,10,21,6,13,243,383,626
2012,10,21,6,14,235,405,640
2012,10,21,6,15,240,383,623
2012,10,21,6,16,182,409,591
2012,10,21,6,17,153,338,491
2012,10,21,6,18,71,342,413
2012,10,21,6,19,50,216,266
2012,10,21,6,20,35,160,195
2012,10,21,6,21,42,124,166
2012,10,21,6,22,18,95,113
2012,10,21,6,23,7,59,66
2012,10,22,0,0,3,28,31
2012,10,22,0,1,0,11,11
2012,10,22,0,2,1,4,5
2012,10,22,0,3,1,5,6
2012,10,22,0,4,1,6,7
2012,10,22,0,5,2,44,46
2012,10,22,0,6,4,140,144
2012,10,22,0,7,15,437,452
2012,10,22,0,8,32,696,728
2012,10,22,0,9,25,335,360
2012,10,22,0,10,51,161,212
2012,10,22,0,11,63,148,211
2012,10,22,0,12,52,231,283
2012,10,22,0,13,88,227,315
2012,10,22,0,14,73,209,282
2012,10,22,0,15,74,222,296
2012,10,22,0,16,80,444,524
2012,10,22,0,17,84,838,922
2012,10,22,0,18,60,726,786
2012,10,22,0,19,36,478,514
2012,10,22,0,20,21,382,403
2012,10,22,0,21,19,155,174
2012,10,22,0,22,25,158,183
2012,10,22,0,23,20,143,163
2012,10,23,1,0,5,32,37
2012,10,23,1,1,1,16,17
2012,10,23,1,2,1,6,7
2012,10,23,1,3,0,1,1
2012,10,23,1,4,1,6,7
2012,10,23,1,5,1,49,50
2012,10,23,1,6,6,152,158
2012,10,23,1,7,12,519,531
2012,10,23,1,8,28,733,761
2012,10,23,1,9,29,305,334
2012,10,23,1,10,50,171,221
2012,10,23,1,11,52,201,253
2012,10,23,1,12,80,298,378
2012,10,23,1,13,59,244,303
2012,10,23,1,14,67,229,296
2012,10,23,1,15,76,270,346
2012,10,23,1,16,108,433,541
2012,10,23,1,17,67,871,938
2012,10,23,1,18,64,762,826
2012,10,23,1,19,25,457,482
2012,10,23,1,20,45,334,379
2012,10,23,1,21,35,260,295
2012,10,23,1,22,20,174,194
2012,10,23,1,23,9,102,111
2012,10,24,2,0,7,39,46
2012,10,24,2,1,4,23,27
2012,10,24,2,2,0,6,6
2012,10,24,2,3,0,4,4
2012,10,24,2,4,1,5,6
2012,10,24,2,5,1,52,53
2012,10,24,2,6,11,162,173
2012,10,24,2,7,20,506,526
2012,10,24,2,8,24,777,801
2012,10,24,2,9,24,349,373
2012,10,24,2,10,29,142,171
2012,10,24,2,11,47,189,236
2012,10,24,2,12,48,268,316
2012,10,24,2,13,65,241,306
2012,10,24,2,14,64,237,301
2012,10,24,2,15,63,245,308
2012,10,24,2,16,67,465,532
2012,10,24,2,17,87,876,963
2012,10,24,2,18,63,795,858
2012,10,24,2,19,50,522,572
2012,10,24,2,20,45,396,441
2012,10,24,2,21,33,280,313
2012,10,24,2,22,30,208,238
2012,10,24,2,23,12,111,123
2012,10,25,3,0,19,57,76
2012,10,25,3,1,6,22,28
2012,10,25,3,2,3,15,18
2012,10,25,3,3,0,8,8
2012,10,25,3,4,1,4,5
2012,10,25,3,5,2,53,55
2012,10,25,3,6,3,168,171
2012,10,25,3,7,18,477,495
2012,10,25,3,8,33,746,779
2012,10,25,3,9,23,320,343
2012,10,25,3,10,53,172,225
2012,10,25,3,11,57,181,238
2012,10,25,3,12,61,258,319
2012,10,25,3,13,49,264,313
2012,10,25,3,14,71,214,285
2012,10,25,3,15,63,242,305
2012,10,25,3,16,92,407,499
2012,10,25,3,17,112,774,886
2012,10,25,3,18,77,732,809
2012,10,25,3,19,45,497,542
2012,10,25,3,20,28,319,347
2012,10,25,3,21,24,247,271
2012,10,25,3,22,22,185,207
2012,10,25,3,23,13,122,135
2012,10,26,4,0,6,65,71
2012,10,26,4,1,4,32,36
2012,10,26,4,2,4,15,19
2012,10,26,4,3,5,8,13
2012,10,26,4,4,1,4,5
2012,10,26,4,5,3,47,50
2012,10,26,4,6,2,142,144
2012,10,26,4,7,13,408,421
2012,10,26,4,8,20,714,734
2012,10,26,4,9,56,347,403
2012,10,26,4,10,41,156,197
2012,10,26,4,11,68,222,290
2012,10,26,4,12,90,302,392
2012,10,26,4,13,77,260,337
2012,10,26,4,14,99,252,351
2012,10,26,4,15,142,306,448
2012,10,26,4,16,137,445,582
2012,10,26,4,17,125,692,817
2012,10,26,4,18,81,584,665
2012,10,26,4,19,72,399,471
2012,10,26,4,20,40,271,311
2012,10,26,4,21,40,252,292
2012,10,26,4,22,37,180,217
2012,10,26,4,23,19,159,178
2012,10,27,5,0,10,132,142
2012,10,27,5,1,23,123,146
2012,10,27,5,2,19,71,90
2012,10,27,5,3,5,21,26
2012,10,27,5,4,1,12,13
2012,10,27,5,5,2,7,9
2012,10,27,5,6,2,29,31
2012,10,27,5,7,7,79,86
2012,10,27,5,8,26,187,213
2012,10,27,5,9,88,240,328
2012,10,27,5,10,165,314,479
2012,10,27,5,11,197,388,585
2012,10,27,5,12,264,404,668
2012,10,27,5,13,310,450,760
2012,10,27,5,14,325,425,750
2012,10,27,5,15,310,401,711
2012,10,27,5,16,257,355,612
2012,10,27,5,17,248,370,618
2012,10,27,5,18,138,318,456
2012,10,27,5,19,67,233,300
2012,10,27,5,20,58,238,296
2012,10,27,5,21,49,160,209
2012,10,27,5,22,41,116,157
2012,10,27,5,23,31,136,167
2012,10,28,6,0,20,97,117
2012,10,28,6,1,22,111,133
2012,10,28,6,2,17,99,116
2012,10,28,6,3,18,61,79
2012,10,28,6,4,1,19,20
2012,10,28,6,5,6,22,28
2012,10,28,6,6,7,32,39
2012,10,28,6,7,17,48,65
2012,10,28,6,8,55,118,173
2012,10,28,6,9,124,206,330
2012,10,28,6,10,120,314,434
2012,10,28,6,11,110,352,462
2012,10,28,6,12,118,373,491
2012,10,28,6,13,75,316,391
2012,10,28,6,14,98,304,402
2012,10,28,6,15,76,225,301
2012,10,28,6,16,42,251,293
2012,10,28,6,17,37,188,225
2012,10,28,6,18,18,136,154
2012,10,28,6,19,7,47,54
2012,10,28,6,20,4,51,55
2012,10,28,6,21,2,44,46
2012,10,28,6,22,2,35,37
2012,10,28,6,23,2,12,14
2012,10,29,0,0,2,20,22
2012,10,30,1,13,11,105,116
2012,10,30,1,14,8,118,126
2012,10,30,1,15,10,114,124
2012,10,30,1,16,15,83,98
2012,10,30,1,17,19,105,124
2012,10,30,1,18,4,139,143
2012,10,30,1,19,6,109,115
2012,10,30,1,20,5,76,81
2012,10,30,1,21,4,60,64
2012,10,30,1,22,2,64,66
2012,10,30,1,23,3,36,39
2012,10,31,2,0,0,16,16
2012,10,31,2,1,0,8,8
2012,10,31,2,2,0,7,7
2012,10,31,2,3,0,3,3
2012,10,31,2,4,0,5,5
2012,10,31,2,5,0,24,24
2012,10,31,2,6,0,116,116
2012,10,31,2,7,3,334,337
2012,10,31,2,8,6,615,621
2012,10,31,2,9,17,280,297
2012,10,31,2,10,21,147,168
2012,10,31,2,11,37,152,189
2012,10,31,2,12,44,197,241
2012,10,31,2,13,22,191,213
2012,10,31,2,14,45,179,224
2012,10,31,2,15,33,197,230
2012,10,31,2,16,51,373,424
2012,10,31,2,17,39,684,723
2012,10,31,2,18,28,556,584
2012,10,31,2,19,27,383,410
2012,10,31,2,20,9,259,268
2012,10,31,2,21,12,180,192
2012,10,31,2,22,18,147,165
2012,10,31,2,23,7,94,101
2012,11,1,3,0,8,52,60
2012,11,1,3,1,8,22,30
2012,11,1,3,2,10,10,20
2012,11,1,3,3,5,10,15
2012,11,1,3,4,2,8,10
2012,11,1,3,5,1,39,40
2012,11,1,3,6,2,146,148
2012,11,1,3,7,6,414,420
2012,11,1,3,8,12,668,680
2012,11,1,3,9,21,310,331
2012,11,1,3,10,13,133,146
2012,11,1,3,11,14,156,170
2012,11,1,3,12,23,198,221
2012,11,1,3,13,49,199,248
2012,11,1,3,14,31,154,185
2012,11,1,3,15,35,179,214
2012,11,1,3,16,31,313,344
2012,11,1,3,17,37,652,689
2012,11,1,3,18,50,628,678
2012,11,1,3,19,28,424,452
2012,11,1,3,20,16,280,296
2012,11,1,3,21,29,238,267
2012,11,1,3,22,27,175,202
2012,11,1,3,23,8,112,120
2012,11,2,4,0,10,40,50
2012,11,2,4,1,5,19,24
2012,11,2,4,2,3,7,10
2012,11,2,4,3,0,3,3
2012,11,2,4,4,1,6,7
2012,11,2,4,5,1,25,26
2012,11,2,4,6,2,120,122
2012,11,2,4,7,8,349,357
2012,11,2,4,8,31,656,687
2012,11,2,4,9,27,355,382
2012,11,2,4,10,21,183,204
2012,11,2,4,11,42,179,221
2012,11,2,4,12,52,240,292
2012,11,2,4,13,64,230,294
2012,11,2,4,14,63,199,262
2012,11,2,4,15,51,255,306
2012,11,2,4,16,48,373,421
2012,11,2,4,17,57,581,638
2012,11,2,4,18,32,490,522
2012,11,2,4,19,38,336,374
2012,11,2,4,20,14,207,221
2012,11,2,4,21,23,133,156
2012,11,2,4,22,14,135,149
2012,11,2,4,23,11,108,119
2012,11,3,5,0,9,99,108
2012,11,3,5,1,6,83,89
2012,11,3,5,2,10,36,46
2012,11,3,5,3,6,22,28
2012,11,3,5,4,8,8,16
2012,11,3,5,5,1,8,9
2012,11,3,5,6,4,17,21
2012,11,3,5,7,1,58,59
2012,11,3,5,8,10,132,142
2012,11,3,5,9,31,188,219
2012,11,3,5,10,68,260,328
2012,11,3,5,11,56,284,340
2012,11,3,5,12,74,320,394
2012,11,3,5,13,110,339,449
2012,11,3,5,14,136,319,455
2012,11,3,5,15,117,331,448
2012,11,3,5,16,108,292,400
2012,11,3,5,17,112,298,410
2012,11,3,5,18,58,239,297
2012,11,3,5,19,22,217,239
2012,11,3,5,20,23,158,181
2012,11,3,5,21,31,135,166
2012,11,3,5,22,13,133,146
2012,11,3,5,23,15,133,148
2012,11,4,6,0,5,97,102
2012,11,4,6,1,26,139,165
2012,11,4,6,2,6,31,37
2012,11,4,6,3,1,10,11
2012,11,4,6,4,2,7,9
2012,11,4,6,5,0,5,5
2012,11,4,6,6,2,14,16
2012,11,4,6,7,11,39,50
2012,11,4,6,8,34,115,149
2012,11,4,6,9,56,161,217
2012,11,4,6,10,73,287,360
2012,11,4,6,11,134,311,445
2012,11,4,6,12,150,354,504
2012,11,4,6,13,122,371,493
2012,11,4,6,14,149,360,509
2012,11,4,6,15,149,300,449
2012,11,4,6,16,119,316,435
2012,11,4,6,17,57,270,327
2012,11,4,6,18,31,206,237
2012,11,4,6,19,24,203,227
2012,11,4,6,20,7,134,141
2012,11,4,6,21,16,71,87
2012,11,4,6,22,15,64,79
2012,11,4,6,23,12,41,53
2012,11,5,0,0,3,20,23
2012,11,5,0,1,0,8,8
2012,11,5,0,2,2,4,6
2012,11,5,0,3,1,3,4
2012,11,5,0,4,5,11,16
2012,11,5,0,5,1,38,39
2012,11,5,0,6,4,135,139
2012,11,5,0,7,8,453,461
2012,11,5,0,8,19,629,648
2012,11,5,0,9,18,239,257
2012,11,5,0,10,30,112,142
2012,11,5,0,11,31,119,150
2012,11,5,0,12,38,206,244
2012,11,5,0,13,39,183,222
2012,11,5,0,14,31,165,196
2012,11,5,0,15,24,207,231
2012,11,5,0,16,35,325,360
2012,11,5,0,17,34,604,638
2012,11,5,0,18,19,523,542
2012,11,5,0,19,11,361,372
2012,11,5,0,20,13,228,241
2012,11,5,0,21,8,144,152
2012,11,5,0,22,4,111,115
2012,11,5,0,23,0,53,53
2012,11,6,1,0,1,18,19
2012,11,6,1,1,0,8,8
2012,11,6,1,2,0,2,2
2012,11,6,1,3,0,4,4
2012,11,6,1,4,0,7,7
2012,11,6,1,5,1,40,41
2012,11,6,1,6,6,143,149
2012,11,6,1,7,9,378,387
2012,11,6,1,8,20,568,588
2012,11,6,1,9,25,338,363
2012,11,6,1,10,41,189,230
2012,11,6,1,11,39,177,216
2012,11,6,1,12,31,217,248
2012,11,6,1,13,46,232,278
2012,11,6,1,14,44,196,240
2012,11,6,1,15,45,227,272
2012,11,6,1,16,33,369,402
2012,11,6,1,17,30,597,627
2012,11,6,1,18,20,477,497
2012,11,6,1,19,15,356,371
2012,11,6,1,20,10,218,228
2012,11,6,1,21,14,137,151
2012,11,6,1,22,17,136,153
2012,11,6,1,23,19,186,205
2012,11,7,2,0,49,234,283
2012,11,7,2,1,6,86,92
2012,11,7,2,2,6,68,74
2012,11,7,2,3,2,9,11
2012,11,7,2,4,0,9,9
2012,11,7,2,5,0,27,27
2012,11,7,2,6,3,115,118
2012,11,7,2,7,5,314,319
2012,11,7,2,8,18,583,601
2012,11,7,2,9,17,351,368
2012,11,7,2,10,27,151,178
2012,11,7,2,11,15,132,147
2012,11,7,2,12,24,188,212
2012,11,7,2,13,23,158,181
2012,11,7,2,14,19,142,161
2012,11,7,2,15,20,178,198
2012,11,7,2,16,23,250,273
2012,11,7,2,17,16,501,517
2012,11,7,2,18,17,448,465
2012,11,7,2,19,17,302,319
2012,11,7,2,20,7,249,256
2012,11,7,2,21,5,121,126
2012,11,7,2,22,4,56,60
2012,11,7,2,23,3,37,40
2012,11,8,3,0,1,14,15
2012,11,8,3,1,1,11,12
2012,11,8,3,2,1,5,6
2012,11,8,3,4,1,9,10
2012,11,8,3,5,0,35,35
2012,11,8,3,6,2,122,124
2012,11,8,3,7,12,411,423
2012,11,8,3,8,16,652,668
2012,11,8,3,9,22,253,275
2012,11,8,3,10,13,148,161
2012,11,8,3,11,16,155,171
2012,11,8,3,12,33,202,235
2012,11,8,3,13,33,195,228
2012,11,8,3,14,33,149,182
2012,11,8,3,15,32,201,233
2012,11,8,3,16,18,321,339
2012,11,8,3,17,36,556,592
2012,11,8,3,18,16,491,507
2012,11,8,3,19,14,359,373
2012,11,8,3,20,10,235,245
2012,11,8,3,21,11,222,233
2012,11,8,3,22,14,147,161
2012,11,8,3,23,5,82,87
2012,11,9,4,0,9,46,55
2012,11,9,4,1,3,17,20
2012,11,9,4,2,1,11,12
2012,11,9,4,3,3,6,9
2012,11,9,4,4,0,14,14
2012,11,9,4,5,2,25,27
2012,11,9,4,6,5,126,131
2012,11,9,4,7,9,332,341
2012,11,9,4,8,25,668,693
2012,11,9,4,9,23,304,327
2012,11,9,4,10,34,163,197
2012,11,9,4,11,66,185,251
2012,11,9,4,12,48,214,262
2012,11,9,4,13,62,237,299
2012,11,9,4,14,67,207,274
2012,11,9,4,15,78,278,356
2012,11,9,4,16,57,377,434
2012,11,9,4,17,61,593,654
2012,11,9,4,18,46,450,496
2012,11,9,4,19,30,331,361
2012,11,9,4,20,20,235,255
2012,11,9,4,21,23,176,199
2012,11,9,4,22,17,146,163
2012,11,9,4,23,20,142,162
2012,11,10,5,0,16,106,122
2012,11,10,5,1,8,68,76
2012,11,10,5,2,2,42,44
2012,11,10,5,3,9,11,20
2012,11,10,5,4,2,4,6
2012,11,10,5,5,1,9,10
2012,11,10,5,6,5,11,16
2012,11,10,5,7,14,57,71
2012,11,10,5,8,16,130,146
2012,11,10,5,9,43,216,259
2012,11,10,5,10,86,264,350
2012,11,10,5,11,143,323,466
2012,11,10,5,12,258,348,606
2012,11,10,5,13,268,383,651
2012,11,10,5,14,280,347,627
2012,11,10,5,15,216,351,567
2012,11,10,5,16,227,378,605
2012,11,10,5,17,183,318,501
2012,11,10,5,18,103,256,359
2012,11,10,5,19,55,228,283
2012,11,10,5,20,39,153,192
2012,11,10,5,21,51,169,220
2012,11,10,5,22,39,154,193
2012,11,10,5,23,26,120,146
2012,11,11,6,0,14,110,124
2012,11,11,6,1,26,82,108
2012,11,11,6,2,12,58,70
2012,11,11,6,3,9,39,48
2012,11,11,6,4,5,6,11
2012,11,11,6,5,0,12,12
2012,11,11,6,6,3,16,19
2012,11,11,6,7,12,56,68
2012,11,11,6,8,32,87,119
2012,11,11,6,9,94,179,273
2012,11,11,6,10,133,272,405
2012,11,11,6,11,180,324,504
2012,11,11,6,12,195,390,585
2012,11,11,6,13,262,424,686
2012,11,11,6,14,292,362,654
2012,11,11,6,15,304,420,724
2012,11,11,6,16,260,393,653
2012,11,11,6,17,151,342,493
2012,11,11,6,18,102,303,405
2012,11,11,6,19,69,208,277
2012,11,11,6,20,54,146,200
2012,11,11,6,21,44,127,171
2012,11,11,6,22,21,113,134
2012,11,11,6,23,16,93,109
2012,11,12,0,0,6,43,49
2012,11,12,0,1,4,26,30
2012,11,12,0,2,6,14,20
2012,11,12,0,3,1,3,4
2012,11,12,0,4,1,3,4
2012,11,12,0,5,1,23,24
2012,11,12,0,6,7,64,71
2012,11,12,0,7,16,248,264
2012,11,12,0,8,50,490,540
2012,11,12,0,9,60,337,397
2012,11,12,0,10,82,184,266
2012,11,12,0,11,112,255,367
2012,11,12,0,12,105,314,419
2012,11,12,0,13,108,312,420
2012,11,12,0,14,134,310,444
2012,11,12,0,15,102,280,382
2012,11,12,0,16,87,347,434
2012,11,12,0,17,66,530,596
2012,11,12,0,18,65,486,551
2012,11,12,0,19,30,323,353
2012,11,12,0,20,31,273,304
2012,11,12,0,21,10,145,155
2012,11,12,0,22,12,100,112
2012,11,12,0,23,1,62,63
2012,11,13,1,0,5,18,23
2012,11,13,1,1,0,5,5
2012,11,13,1,2,7,4,11
2012,11,13,1,3,2,3,5
2012,11,13,1,4,0,9,9
2012,11,13,1,5,0,18,18
2012,11,13,1,6,2,48,50
2012,11,13,1,7,1,106,107
2012,11,13,1,8,4,207,211
2012,11,13,1,9,1,109,110
2012,11,13,1,10,10,84,94
2012,11,13,1,11,22,133,155
2012,11,13,1,12,16,180,196
2012,11,13,1,13,30,188,218
2012,11,13,1,14,34,169,203
2012,11,13,1,15,33,184,217
2012,11,13,1,16,28,282,310
2012,11,13,1,17,33,575,608
2012,11,13,1,18,45,514,559
2012,11,13,1,19,12,344,356
2012,11,13,1,20,12,211,223
2012,11,13,1,21,9,178,187
2012,11,13,1,22,15,120,135
2012,11,13,1,23,6,78,84
2012,11,14,2,0,4,20,24
2012,11,14,2,1,2,10,12
2012,11,14,2,2,0,1,1
2012,11,14,2,3,0,5,5
2012,11,14,2,4,0,6,6
2012,11,14,2,5,0,39,39
2012,11,14,2,6,4,142,146
2012,11,14,2,7,10,405,415
2012,11,14,2,8,27,664,691
2012,11,14,2,9,22,310,332
2012,11,14,2,10,18,153,171
2012,11,14,2,11,25,126,151
2012,11,14,2,12,40,200,240
2012,11,14,2,13,32,182,214
2012,11,14,2,14,20,161,181
2012,11,14,2,15,32,228,260
2012,11,14,2,16,31,290,321
2012,11,14,2,17,19,564,583
2012,11,14,2,18,24,543,567
2012,11,14,2,19,28,368,396
2012,11,14,2,20,15,252,267
2012,11,14,2,21,5,208,213
2012,11,14,2,22,6,167,173
2012,11,14,2,23,9,78,87
2012,11,15,3,0,1,33,34
2012,11,15,3,1,2,14,16
2012,11,15,3,2,0,7,7
2012,11,15,3,3,0,2,2
2012,11,15,3,4,0,5,5
2012,11,15,3,5,3,34,37
2012,11,15,3,6,1,146,147
2012,11,15,3,7,7,403,410
2012,11,15,3,8,21,625,646
2012,11,15,3,9,17,306,323
2012,11,15,3,10,11,142,153
2012,11,15,3,11,28,138,166
2012,11,15,3,12,29,184,213
2012,11,15,3,13,20,197,217
2012,11,15,3,14,27,174,201
2012,11,15,3,15,26,191,217
2012,11,15,3,16,24,318,342
2012,11,15,3,17,22,541,563
2012,11,15,3,18,10,563,573
2012,11,15,3,19,11,375,386
2012,11,15,3,20,23,262,285
2012,11,15,3,21,20,204,224
2012,11,15,3,22,10,143,153
2012,11,15,3,23,7,118,125
2012,11,16,4,0,7,58,65
2012,11,16,4,1,5,16,21
2012,11,16,4,2,0,9,9
2012,11,16,4,3,0,6,6
2012,11,16,4,4,0,5,5
2012,11,16,4,5,2,34,36
2012,11,16,4,6,4,126,130
2012,11,16,4,7,5,362,367
2012,11,16,4,8,17,694,711
2012,11,16,4,9,21,330,351
2012,11,16,4,10,33,165,198
2012,11,16,4,11,33,185,218
2012,11,16,4,12,28,262,290
2012,11,16,4,13,52,226,278
2012,11,16,4,14,47,204,251
2012,11,16,4,15,30,237,267
2012,11,16,4,16,33,350,383
2012,11,16,4,17,41,539,580
2012,11,16,4,18,22,483,505
2012,11,16,4,19,26,306,332
2012,11,16,4,20,20,207,227
2012,11,16,4,21,21,157,178
2012,11,16,4,22,23,139,162
2012,11,16,4,23,14,114,128
2012,11,17,5,0,11,95,106
2012,11,17,5,1,13,74,87
2012,11,17,5,2,8,41,49
2012,11,17,5,3,2,19,21
2012,11,17,5,4,1,6,7
2012,11,17,5,5,1,10,11
2012,11,17,5,6,0,21,21
2012,11,17,5,7,8,70,78
2012,11,17,5,8,30,138,168
2012,11,17,5,9,48,200,248
2012,11,17,5,10,62,258,320
2012,11,17,5,11,80,343,423
2012,11,17,5,12,117,359,476
2012,11,17,5,13,179,346,525
2012,11,17,5,14,175,380,555
2012,11,17,5,15,175,374,549
2012,11,17,5,16,144,325,469
2012,11,17,5,17,101,302,403
2012,11,17,5,18,34,237,271
2012,11,17,5,19,45,208,253
2012,11,17,5,20,30,142,172
2012,11,17,5,21,15,124,139
2012,11,17,5,22,15,130,145
2012,11,17,5,23,19,114,133
2012,11,18,6,0,11,118,129
2012,11,18,6,1,14,81,95
2012,11,18,6,2,8,65,73
2012,11,18,6,3,9,37,46
2012,11,18,6,4,4,8,12
2012,11,18,6,5,5,7,12
2012,11,18,6,6,2,13,15
2012,11,18,6,7,3,39,42
2012,11,18,6,8,19,100,119
2012,11,18,6,9,49,155,204
2012,11,18,6,10,79,250,329
2012,11,18,6,11,92,267,359
2012,11,18,6,12,101,341,442
2012,11,18,6,13,113,334,447
2012,11,18,6,14,125,303,428
2012,11,18,6,15,89,318,407
2012,11,18,6,16,59,313,372
2012,11,18,6,17,48,232,280
2012,11,18,6,18,36,240,276
2012,11,18,6,19,16,194,210
2012,11,18,6,20,9,120,129
2012,11,18,6,21,17,93,110
2012,11,18,6,22,8,66,74
2012,11,18,6,23,6,53,59
2012,11,19,0,0,5,22,27
2012,11,19,0,1,0,19,19
2012,11,19,0,2,0,5,5
2012,11,19,0,3,0,2,2
2012,11,19,0,4,1,11,12
2012,11,19,0,5,1,38,39
2012,11,19,0,6,3,128,131
2012,11,19,0,7,5,381,386
2012,11,19,0,8,13,650,663
2012,11,19,0,9,18,260,278
2012,11,19,0,10,33,106,139
2012,11,19,0,11,33,164,197
2012,11,19,0,12,35,207,242
2012,11,19,0,13,46,205,251
2012,11,19,0,14,47,170,217
2012,11,19,0,15,44,213,257
2012,11,19,0,16,55,325,380
2012,11,19,0,17,33,586,619
2012,11,19,0,18,21,559,580
2012,11,19,0,19,25,381,406
2012,11,19,0,20,7,252,259
2012,11,19,0,21,15,188,203
2012,11,19,0,22,7,106,113
2012,11,19,0,23,2,72,74
2012,11,20,1,0,3,26,29
2012,11,20,1,1,3,10,13
2012,11,20,1,2,0,5,5
2012,11,20,1,3,0,2,2
2012,11,20,1,4,0,6,6
2012,11,20,1,5,2,32,34
2012,11,20,1,6,2,146,148
2012,11,20,1,7,7,411,418
2012,11,20,1,8,16,649,665
2012,11,20,1,9,28,298,326
2012,11,20,1,10,32,144,176
2012,11,20,1,11,45,160,205
2012,11,20,1,12,70,243,313
2012,11,20,1,13,49,218,267
2012,11,20,1,14,47,177,224
2012,11,20,1,15,61,226,287
2012,11,20,1,16,60,335,395
2012,11,20,1,17,37,553,590
2012,11,20,1,18,16,534,550
2012,11,20,1,19,23,361,384
2012,11,20,1,20,11,224,235
2012,11,20,1,21,14,143,157
2012,11,20,1,22,7,115,122
2012,11,20,1,23,1,82,83
2012,11,21,2,0,1,25,26
2012,11,21,2,1,1,13,14
2012,11,21,2,2,2,6,8
2012,11,21,2,3,0,2,2
2012,11,21,2,4,0,10,10
2012,11,21,2,5,1,28,29
2012,11,21,2,6,2,99,101
2012,11,21,2,7,11,262,273
2012,11,21,2,8,12,539,551
2012,11,21,2,9,45,320,365
2012,11,21,2,10,22,150,172
2012,11,21,2,11,43,198,241
2012,11,21,2,12,74,270,344
2012,11,21,2,13,70,295,365
2012,11,21,2,14,84,329,413
2012,11,21,2,15,68,381,449
2012,11,21,2,16,59,410,469
2012,11,21,2,17,41,333,374
2012,11,21,2,18,24,287,311
2012,11,21,2,19,23,220,243
2012,11,21,2,20,11,125,136
2012,11,21,2,21,8,97,105
2012,11,21,2,22,6,82,88
2012,11,21,2,23,7,50,57
2012,11,22,3,0,3,43,46
2012,11,22,3,1,5,37,42
2012,11,22,3,2,3,15,18
2012,11,22,3,3,0,6,6
2012,11,22,3,4,1,2,3
2012,11,22,3,5,2,6,8
2012,11,22,3,6,2,15,17
2012,11,22,3,7,7,49,56
2012,11,22,3,8,20,77,97
2012,11,22,3,9,25,94,119
2012,11,22,3,10,65,154,219
2012,11,22,3,11,89,143,232
2012,11,22,3,12,117,145,262
2012,11,22,3,13,125,144,269
2012,11,22,3,14,125,95,220
2012,11,22,3,15,132,96,228
2012,11,22,3,16,101,81,182
2012,11,22,3,17,66,43,109
2012,11,22,3,18,16,54,70
2012,11,22,3,19,13,31,44
2012,11,22,3,20,15,37,52
2012,11,22,3,21,7,39,46
2012,11,22,3,22,8,36,44
2012,11,22,3,23,8,28,36
2012,11,23,4,0,0,32,32
2012,11,23,4,1,2,11,13
2012,11,23,4,2,1,4,5
2012,11,23,4,3,1,0,1
2012,11,23,4,4,1,3,4
2012,11,23,4,5,0,10,10
2012,11,23,4,6,0,20,20
2012,11,23,4,7,5,72,77
2012,11,23,4,8,11,83,94
2012,11,23,4,9,32,80,112
2012,11,23,4,10,87,114,201
2012,11,23,4,11,121,130,251
2012,11,23,4,12,186,193,379
2012,11,23,4,13,224,200,424
2012,11,23,4,14,240,195,435
2012,11,23,4,15,233,214,447
2012,11,23,4,16,158,199,357
2012,11,23,4,17,117,183,300
2012,11,23,4,18,50,158,208
2012,11,23,4,19,33,121,154
2012,11,23,4,20,42,100,142
2012,11,23,4,21,23,75,98
2012,11,23,4,22,16,63,79
2012,11,23,4,23,20,47,67
2012,11,24,5,0,9,33,42
2012,11,24,5,1,1,19,20
2012,11,24,5,2,10,22,32
2012,11,24,5,3,6,5,11
2012,11,24,5,4,1,2,3
2012,11,24,5,5,1,2,3
2012,11,24,5,6,1,9,10
2012,11,24,5,7,4,21,25
2012,11,24,5,8,7,55,62
2012,11,24,5,9,26,96,122
2012,11,24,5,10,46,96,142
2012,11,24,5,11,55,131,186
2012,11,24,5,12,53,146,199
2012,11,24,5,13,64,161,225
2012,11,24,5,14,58,149,207
2012,11,24,5,15,59,139,198
2012,11,24,5,16,43,127,170
2012,11,24,5,17,29,97,126
2012,11,24,5,18,22,123,145
2012,11,24,5,19,9,74,83
2012,11,24,5,20,3,55,58
2012,11,24,5,21,9,66,75
2012,11,24,5,22,7,69,76
2012,11,24,5,23,9,48,57
2012,11,25,6,0,3,31,34
2012,11,25,6,1,4,32,36
2012,11,25,6,2,1,27,28
2012,11,25,6,3,0,8,8
2012,11,25,6,4,1,1,2
2012,11,25,6,5,0,3,3
2012,11,25,6,6,1,10,11
2012,11,25,6,7,2,19,21
2012,11,25,6,8,2,32,34
2012,11,25,6,9,13,83,96
2012,11,25,6,10,15,124,139
2012,11,25,6,11,49,155,204
2012,11,25,6,12,37,165,202
2012,11,25,6,13,37,158,195
2012,11,25,6,14,33,170,203
2012,11,25,6,15,36,209,245
2012,11,25,6,16,25,203,228
2012,11,25,6,17,11,170,181
2012,11,25,6,18,9,132,141
2012,11,25,6,19,13,114,127
2012,11,25,6,20,9,110,119
2012,11,25,6,21,4,60,64
2012,11,25,6,22,3,59,62
2012,11,25,6,23,1,40,41
2012,11,26,0,0,4,19,23
2012,11,26,0,1,1,9,10
2012,11,26,0,2,0,5,5
2012,11,26,0,3,1,4,5
2012,11,26,0,4,0,10,10
2012,11,26,0,5,0,41,41
2012,11,26,0,6,1,123,124
2012,11,26,0,7,2,363,365
2012,11,26,0,8,9,629,638
2012,11,26,0,9,10,276,286
2012,11,26,0,10,20,127,147
2012,11,26,0,11,18,112,130
2012,11,26,0,12,22,188,210
2012,11,26,0,13,20,197,217
2012,11,26,0,14,51,177,228
2012,11,26,0,15,49,181,230
2012,11,26,0,16,49,297,346
2012,11,26,0,17,13,540,553
2012,11,26,0,18,19,502,521
2012,11,26,0,19,16,355,371
2012,11,26,0,20,12,265,277
2012,11,26,0,21,9,172,181
2012,11,26,0,22,3,101,104
2012,11,26,0,23,8,57,65
2012,11,27,1,0,2,24,26
2012,11,27,1,1,0,6,6
2012,11,27,1,2,0,5,5
2012,11,27,1,3,1,3,4
2012,11,27,1,4,0,5,5
2012,11,27,1,5,0,31,31
2012,11,27,1,6,3,97,100
2012,11,27,1,7,4,289,293
2012,11,27,1,8,6,494,500
2012,11,27,1,9,11,257,268
2012,11,27,1,10,5,52,57
2012,11,27,1,11,6,59,65
2012,11,27,1,12,6,70,76
2012,11,27,1,13,4,73,77
2012,11,27,1,14,8,86,94
2012,11,27,1,15,9,146,155
2012,11,27,1,16,5,252,257
2012,11,27,1,17,13,514,527
2012,11,27,1,18,13,469,482
2012,11,27,1,19,12,338,350
2012,11,27,1,20,4,228,232
2012,11,27,1,21,6,179,185
2012,11,27,1,22,2,95,97
2012,11,27,1,23,3,64,67
2012,11,28,2,0,1,22,23
2012,11,28,2,1,0,12,12
2012,11,28,2,2,0,1,1
2012,11,28,2,3,0,3,3
2012,11,28,2,4,0,4,4
2012,11,28,2,5,0,39,39
2012,11,28,2,6,4,132,136
2012,11,28,2,7,6,403,409
2012,11,28,2,8,9,683,692
2012,11,28,2,9,13,309,322
2012,11,28,2,10,17,144,161
2012,11,28,2,11,19,127,146
2012,11,28,2,12,19,189,208
2012,11,28,2,13,21,193,214
2012,11,28,2,14,15,161,176
2012,11,28,2,15,7,172,179
2012,11,28,2,16,9,316,325
2012,11,28,2,17,17,546,563
2012,11,28,2,18,12,530,542
2012,11,28,2,19,9,378,387
2012,11,28,2,20,5,258,263
2012,11,28,2,21,4,219,223
2012,11,28,2,22,6,148,154
2012,11,28,2,23,5,73,78
2012,11,29,3,0,4,25,29
2012,11,29,3,1,1,15,16
2012,11,29,3,2,1,6,7
2012,11,29,3,4,0,7,7
2012,11,29,3,5,0,42,42
2012,11,29,3,6,1,120,121
2012,11,29,3,7,8,354,362
2012,11,29,3,8,15,664,679
2012,11,29,3,9,13,286,299
2012,11,29,3,10,25,153,178
2012,11,29,3,11,13,150,163
2012,11,29,3,12,11,225,236
2012,11,29,3,13,15,209,224
2012,11,29,3,14,13,174,187
2012,11,29,3,15,19,201,220
2012,11,29,3,16,24,346,370
2012,11,29,3,17,17,544,561
2012,11,29,3,18,17,520,537
2012,11,29,3,19,18,326,344
2012,11,29,3,20,11,241,252
2012,11,29,3,21,7,201,208
2012,11,29,3,22,4,147,151
2012,11,29,3,23,6,124,130
2012,11,30,4,0,4,48,52
2012,11,30,4,1,2,17,19
2012,11,30,4,2,2,10,12
2012,11,30,4,3,0,4,4
2012,11,30,4,4,0,3,3
2012,11,30,4,5,1,39,40
2012,11,30,4,6,2,104,106
2012,11,30,4,7,6,346,352
2012,11,30,4,8,20,709,729
2012,11,30,4,9,17,313,330
2012,11,30,4,10,10,159,169
2012,11,30,4,11,31,170,201
2012,11,30,4,12,25,243,268
2012,11,30,4,13,21,241,262
2012,11,30,4,14,26,225,251
2012,11,30,4,15,34,262,296
2012,11,30,4,16,37,368,405
2012,11,30,4,17,31,551,582
2012,11,30,4,18,20,489,509
2012,11,30,4,19,18,359,377
2012,11,30,4,20,12,233,245
2012,11,30,4,21,14,169,183
2012,11,30,4,22,18,145,163
2012,11,30,4,23,11,99,110
2012,12,1,5,0,9,99,108
2012,12,1,5,1,5,64,69
2012,12,1,5,2,3,47,50
2012,12,1,5,3,1,14,15
2012,12,1,5,4,0,5,5
2012,12,1,5,5,1,12,13
2012,12,1,5,6,7,20,27
2012,12,1,5,7,7,56,63
2012,12,1,5,8,11,133,144
2012,12,1,5,9,34,159,193
2012,12,1,5,10,45,211,256
2012,12,1,5,11,74,318,392
2012,12,1,5,12,119,327,446
2012,12,1,5,13,123,386,509
2012,12,1,5,14,110,369,479
2012,12,1,5,15,113,371,484
2012,12,1,5,16,89,354,443
2012,12,1,5,17,50,270,320
2012,12,1,5,18,42,255,297
2012,12,1,5,19,30,219,249
2012,12,1,5,20,28,170,198
2012,12,1,5,21,23,135,158
2012,12,1,5,22,17,130,147
2012,12,1,5,23,10,116,126
2012,12,2,6,0,9,108,117
2012,12,2,6,1,10,84,94
2012,12,2,6,2,2,72,74
2012,12,2,6,3,4,21,25
2012,12,2,6,4,1,6,7
2012,12,2,6,5,1,7,8
2012,12,2,6,6,1,15,16
2012,12,2,6,7,5,26,31
2012,12,2,6,8,12,81,93
2012,12,2,6,9,37,135,172
2012,12,2,6,10,63,230,293
2012,12,2,6,11,81,274,355
2012,12,2,6,12,111,409,520
2012,12,2,6,13,84,347,431
2012,12,2,6,14,142,331,473
2012,12,2,6,15,106,311,417
2012,12,2,6,16,85,358,443
2012,12,2,6,17,59,244,303
2012,12,2,6,18,25,178,203
2012,12,2,6,19,16,158,174
2012,12,2,6,20,12,142,154
2012,12,2,6,21,8,91,99
2012,12,2,6,22,11,85,96
2012,12,2,6,23,7,44,51
2012,12,3,0,0,3,18,21
2012,12,3,0,1,2,11,13
2012,12,3,0,2,1,9,10
2012,12,3,0,3,2,6,8
2012,12,3,0,4,1,4,5
2012,12,3,0,5,0,38,38
2012,12,3,0,6,2,136,138
2012,12,3,0,7,9,387,396
2012,12,3,0,8,19,712,731
2012,12,3,0,9,19,289,308
2012,12,3,0,10,31,105,136
2012,12,3,0,11,51,182,233
2012,12,3,0,12,40,228,268
2012,12,3,0,13,81,240,321
2012,12,3,0,14,51,209,260
2012,12,3,0,15,58,210,268
2012,12,3,0,16,45,397,442
2012,12,3,0,17,43,665,708
2012,12,3,0,18,26,666,692
2012,12,3,0,19,27,444,471
2012,12,3,0,20,16,284,300
2012,12,3,0,21,14,207,221
2012,12,3,0,22,5,139,144
2012,12,3,0,23,9,93,102
2012,12,4,1,0,6,49,55
2012,12,4,1,1,3,22,25
2012,12,4,1,2,3,5,8
2012,12,4,1,3,1,3,4
2012,12,4,1,4,0,7,7
2012,12,4,1,5,1,45,46
2012,12,4,1,6,3,150,153
2012,12,4,1,7,7,495,502
2012,12,4,1,8,21,700,721
2012,12,4,1,9,19,317,336
2012,12,4,1,10,26,130,156
2012,12,4,1,11,24,183,207
2012,12,4,1,12,39,273,312
2012,12,4,1,13,39,233,272
2012,12,4,1,14,39,231,270
2012,12,4,1,15,56,244,300
2012,12,4,1,16,44,391,435
2012,12,4,1,17,43,700,743
2012,12,4,1,18,38,693,731
2012,12,4,1,19,46,414,460
2012,12,4,1,20,34,272,306
2012,12,4,1,21,28,252,280
2012,12,4,1,22,26,155,181
2012,12,4,1,23,5,91,96
2012,12,5,2,0,6,31,37
2012,12,5,2,1,0,11,11
2012,12,5,2,2,2,7,9
2012,12,5,2,3,0,7,7
2012,12,5,2,4,1,9,10
2012,12,5,2,5,1,48,49
2012,12,5,2,6,5,119,124
2012,12,5,2,7,9,389,398
2012,12,5,2,8,22,737,759
2012,12,5,2,9,26,362,388
2012,12,5,2,10,14,127,141
2012,12,5,2,11,11,161,172
2012,12,5,2,12,24,208,232
2012,12,5,2,13,14,200,214
2012,12,5,2,14,39,179,218
2012,12,5,2,15,20,265,285
2012,12,5,2,16,23,354,377
2012,12,5,2,17,29,576,605
2012,12,5,2,18,29,580,609
2012,12,5,2,19,14,400,414
2012,12,5,2,20,19,274,293
2012,12,5,2,21,14,184,198
2012,12,5,2,22,4,101,105
2012,12,5,2,23,5,69,74
2012,12,6,3,0,1,43,44
2012,12,6,3,1,0,16,16
2012,12,6,3,2,0,9,9
2012,12,6,3,3,0,2,2
2012,12,6,3,4,1,8,9
2012,12,6,3,5,0,32,32
2012,12,6,3,6,2,122,124
2012,12,6,3,7,8,381,389
2012,12,6,3,8,13,646,659
2012,12,6,3,9,19,257,276
2012,12,6,3,10,23,122,145
2012,12,6,3,11,16,162,178
2012,12,6,3,12,29,206,235
2012,12,6,3,13,33,212,245
2012,12,6,3,14,37,175,212
2012,12,6,3,15,38,232,270
2012,12,6,3,16,39,292,331
2012,12,6,3,17,31,586,617
2012,12,6,3,18,23,542,565
2012,12,6,3,19,13,360,373
2012,12,6,3,20,5,222,227
2012,12,6,3,21,7,184,191
2012,12,6,3,22,2,131,133
2012,12,6,3,23,0,93,93
2012,12,7,4,0,3,45,48
2012,12,7,4,1,2,26,28
2012,12,7,4,2,0,11,11
2012,12,7,4,3,0,5,5
2012,12,7,4,4,0,10,10
2012,12,7,4,5,1,25,26
2012,12,7,4,6,0,84,84
2012,12,7,4,7,3,212,215
2012,12,7,4,8,11,430,441
2012,12,7,4,9,10,291,301
2012,12,7,4,10,16,150,166
2012,12,7,4,11,20,183,203
2012,12,7,4,12,36,204,240
2012,12,7,4,13,23,197,220
2012,12,7,4,14,40,175,215
2012,12,7,4,15,34,269,303
2012,12,7,4,16,39,336,375
2012,12,7,4,17,29,539,568
2012,12,7,4,18,25,473,498
2012,12,7,4,19,15,337,352
2012,12,7,4,20,12,229,241
2012,12,7,4,21,9,162,171
2012,12,7,4,22,15,150,165
2012,12,7,4,23,6,116,122
2012,12,8,5,0,5,98,103
2012,12,8,5,1,16,84,100
2012,12,8,5,2,3,67,70
2012,12,8,5,3,6,23,29
2012,12,8,5,4,3,9,12
2012,12,8,5,5,2,4,6
2012,12,8,5,6,1,19,20
2012,12,8,5,7,3,36,39
2012,12,8,5,8,5,106,111
2012,12,8,5,9,17,153,170
2012,12,8,5,10,43,244,287
2012,12,8,5,11,63,341,404
2012,12,8,5,12,122,364,486
2012,12,8,5,13,148,399,547
2012,12,8,5,14,164,378,542
2012,12,8,5,15,167,374,541
2012,12,8,5,16,139,368,507
2012,12,8,5,17,77,268,345
2012,12,8,5,18,40,264,304
2012,12,8,5,19,34,212,246
2012,12,8,5,20,20,162,182
2012,12,8,5,21,34,175,209
2012,12,8,5,22,23,137,160
2012,12,8,5,23,18,144,162
2012,12,9,6,0,15,103,118
2012,12,9,6,1,17,85,102
2012,12,9,6,2,8,70,78
2012,12,9,6,3,14,34,48
2012,12,9,6,4,1,11,12
2012,12,9,6,5,0,8,8
2012,12,9,6,6,0,6,6
2012,12,9,6,7,1,22,23
2012,12,9,6,8,1,68,69
2012,12,9,6,9,9,94,103
2012,12,9,6,10,39,180,219
2012,12,9,6,11,40,210,250
2012,12,9,6,12,60,255,315
2012,12,9,6,13,65,220,285
2012,12,9,6,14,42,190,232
2012,12,9,6,15,25,200,225
2012,12,9,6,16,33,220,253
2012,12,9,6,17,20,209,229
2012,12,9,6,18,17,181,198
2012,12,9,6,19,12,110,122
2012,12,9,6,20,6,102,108
2012,12,9,6,21,10,86,96
2012,12,9,6,22,3,75,78
2012,12,9,6,23,3,48,51
2012,12,10,0,0,0,20,20
2012,12,10,0,1,0,4,4
2012,12,10,0,2,2,3,5
2012,12,10,0,3,0,4,4
2012,12,10,0,4,3,9,12
2012,12,10,0,5,0,27,27
2012,12,10,0,6,2,121,123
2012,12,10,0,7,3,291,294
2012,12,10,0,8,9,575,584
2012,12,10,0,9,11,273,284
2012,12,10,0,10,12,121,133
2012,12,10,0,11,8,126,134
2012,12,10,0,12,23,150,173
2012,12,10,0,13,30,190,220
2012,12,10,0,14,31,179,210
2012,12,10,0,15,29,207,236
2012,12,10,0,16,37,308,345
2012,12,10,0,17,38,578,616
2012,12,10,0,18,20,544,564
2012,12,10,0,19,18,409,427
2012,12,10,0,20,13,287,300
2012,12,10,0,21,21,224,245
2012,12,10,0,22,11,115,126
2012,12,10,0,23,8,76,84
2012,12,11,1,0,2,29,31
2012,12,11,1,1,1,7,8
2012,12,11,1,2,0,1,1
2012,12,11,1,3,0,3,3
2012,12,11,1,4,0,8,8
2012,12,11,1,5,1,40,41
2012,12,11,1,6,0,118,118
2012,12,11,1,7,8,372,380
2012,12,11,1,8,16,708,724
2012,12,11,1,9,12,322,334
2012,12,11,1,10,12,142,154
2012,12,11,1,11,28,145,173
2012,12,11,1,12,13,213,226
2012,12,11,1,13,28,226,254
2012,12,11,1,14,19,185,204
2012,12,11,1,15,20,250,270
2012,12,11,1,16,24,334,358
2012,12,11,1,17,21,580,601
2012,12,11,1,18,23,523,546
2012,12,11,1,19,21,412,433
2012,12,11,1,20,9,248,257
2012,12,11,1,21,14,193,207
2012,12,11,1,22,6,100,106
2012,12,11,1,23,4,60,64
2012,12,12,2,0,1,33,34
2012,12,12,2,1,3,18,21
2012,12,12,2,2,5,4,9
2012,12,12,2,3,3,7,10
2012,12,12,2,4,0,4,4
2012,12,12,2,5,0,37,37
2012,12,12,2,6,2,126,128
2012,12,12,2,7,3,366,369
2012,12,12,2,8,18,670,688
2012,12,12,2,9,13,272,285
2012,12,12,2,10,20,116,136
2012,12,12,2,11,24,148,172
2012,12,12,2,12,14,218,232
2012,12,12,2,13,18,220,238
2012,12,12,2,14,34,191,225
2012,12,12,2,15,21,207,228
2012,12,12,2,16,19,310,329
2012,12,12,2,17,21,540,561
2012,12,12,2,18,25,515,540
2012,12,12,2,19,18,384,402
2012,12,12,2,20,25,243,268
2012,12,12,2,21,16,186,202
2012,12,12,2,22,4,118,122
2012,12,12,2,23,3,76,79
2012,12,13,3,0,1,31,32
2012,12,13,3,1,4,19,23
2012,12,13,3,2,3,5,8
2012,12,13,3,3,0,2,2
2012,12,13,3,4,0,8,8
2012,12,13,3,5,2,31,33
2012,12,13,3,6,2,112,114
2012,12,13,3,7,5,380,385
2012,12,13,3,8,24,655,679
2012,12,13,3,9,25,300,325
2012,12,13,3,10,28,139,167
2012,12,13,3,11,25,164,189
2012,12,13,3,12,30,252,282
2012,12,13,3,13,41,230,271
2012,12,13,3,14,31,211,242
2012,12,13,3,15,40,240,280
2012,12,13,3,16,50,356,406
2012,12,13,3,17,43,507,550
2012,12,13,3,18,20,446,466
2012,12,13,3,19,20,328,348
2012,12,13,3,20,6,235,241
2012,12,13,3,21,13,200,213
2012,12,13,3,22,7,141,148
2012,12,13,3,23,5,115,120
2012,12,14,4,0,4,43,47
2012,12,14,4,1,0,26,26
2012,12,14,4,2,3,6,9
2012,12,14,4,3,0,12,12
2012,12,14,4,4,1,9,10
2012,12,14,4,5,0,34,34
2012,12,14,4,6,1,112,113
2012,12,14,4,7,3,305,308
2012,12,14,4,8,13,623,636
2012,12,14,4,9,13,330,343
2012,12,14,4,10,28,162,190
2012,12,14,4,11,31,180,211
2012,12,14,4,12,29,244,273
2012,12,14,4,13,39,274,313
2012,12,14,4,14,48,251,299
2012,12,14,4,15,57,252,309
2012,12,14,4,16,45,372,417
2012,12,14,4,17,40,582,622
2012,12,14,4,18,23,432,455
2012,12,14,4,19,17,302,319
2012,12,14,4,20,12,209,221
2012,12,14,4,21,7,165,172
2012,12,14,4,22,4,134,138
2012,12,14,4,23,11,123,134
2012,12,15,5,0,4,90,94
2012,12,15,5,1,9,86,95
2012,12,15,5,2,6,63,69
2012,12,15,5,3,5,18,23
2012,12,15,5,4,1,5,6
2012,12,15,5,5,0,3,3
2012,12,15,5,6,0,11,11
2012,12,15,5,7,1,47,48
2012,12,15,5,8,8,111,119
2012,12,15,5,9,17,203,220
2012,12,15,5,10,23,250,273
2012,12,15,5,11,66,327,393
2012,12,15,5,12,89,364,453
2012,12,15,5,13,88,368,456
2012,12,15,5,14,92,334,426
2012,12,15,5,15,95,352,447
2012,12,15,5,16,85,328,413
2012,12,15,5,17,35,274,309
2012,12,15,5,18,40,232,272
2012,12,15,5,19,32,225,257
2012,12,15,5,20,23,178,201
2012,12,15,5,21,15,169,184
2012,12,15,5,22,22,134,156
2012,12,15,5,23,11,108,119
2012,12,16,6,0,8,102,110
2012,12,16,6,1,14,82,96
2012,12,16,6,2,8,79,87
2012,12,16,6,3,1,37,38
2012,12,16,6,4,1,10,11
2012,12,16,6,5,0,9,9
2012,12,16,6,6,0,6,6
2012,12,16,6,7,5,22,27
2012,12,16,6,8,12,76,88
2012,12,16,6,9,19,113,132
2012,12,16,6,10,42,215,257
2012,12,16,6,11,47,248,295
2012,12,16,6,12,67,350,417
2012,12,16,6,13,67,289,356
2012,12,16,6,14,50,260,310
2012,12,16,6,15,46,292,338
2012,12,16,6,16,66,334,400
2012,12,16,6,17,29,214,243
2012,12,16,6,18,8,99,107
2012,12,16,6,19,10,99,109
2012,12,16,6,20,14,108,122
2012,12,16,6,21,14,92,106
2012,12,16,6,22,6,83,89
2012,12,16,6,23,4,29,33
2012,12,17,0,0,2,26,28
2012,12,17,0,1,1,14,15
2012,12,17,0,2,1,4,5
2012,12,17,0,3,0,3,3
2012,12,17,0,4,2,3,5
2012,12,17,0,5,0,24,24
2012,12,17,0,6,1,107,108
2012,12,17,0,7,5,314,319
2012,12,17,0,8,10,582,592
2012,12,17,0,9,11,271,282
2012,12,17,0,10,15,120,135
2012,12,17,0,11,22,148,170
2012,12,17,0,12,21,211,232
2012,12,17,0,13,16,194,210
2012,12,17,0,14,12,169,181
2012,12,17,0,15,15,196,211
2012,12,17,0,16,15,287,302
2012,12,17,0,17,17,478,495
2012,12,17,0,18,14,493,507
2012,12,17,0,19,7,333,340
2012,12,17,0,20,8,192,200
2012,12,17,0,21,6,114,120
2012,12,17,0,22,5,49,54
2012,12,17,0,23,6,41,47
2012,12,18,1,0,0,18,18
2012,12,18,1,1,0,15,15
2012,12,18,1,2,2,5,7
2012,12,18,1,3,0,5,5
2012,12,18,1,4,3,5,8
2012,12,18,1,5,0,36,36
2012,12,18,1,6,1,117,118
2012,12,18,1,7,4,351,355
2012,12,18,1,8,10,652,662
2012,12,18,1,9,19,307,326
2012,12,18,1,10,22,162,184
2012,12,18,1,11,58,211,269
2012,12,18,1,12,49,264,313
2012,12,18,1,13,51,235,286
2012,12,18,1,14,56,191,247
2012,12,18,1,15,28,218,246
2012,12,18,1,16,40,323,363
2012,12,18,1,17,39,533,572
2012,12,18,1,18,13,512,525
2012,12,18,1,19,19,334,353
2012,12,18,1,20,4,264,268
2012,12,18,1,21,9,159,168
2012,12,18,1,22,5,127,132
2012,12,18,1,23,1,80,81
2012,12,19,2,0,6,35,41
2012,12,19,2,1,1,14,15
2012,12,19,2,2,1,2,3
2012,12,19,2,3,0,5,5
2012,12,19,2,4,1,6,7
2012,12,19,2,5,2,29,31
2012,12,19,2,6,3,109,112
2012,12,19,2,7,3,360,363
2012,12,19,2,8,13,665,678
2012,12,19,2,9,8,309,317
2012,12,19,2,10,17,147,164
2012,12,19,2,11,31,169,200
2012,12,19,2,12,33,203,236
2012,12,19,2,13,30,183,213
2012,12,19,2,14,33,185,218
2012,12,19,2,15,28,209,237
2012,12,19,2,16,37,297,334
2012,12,19,2,17,26,536,562
2012,12,19,2,18,23,546,569
2012,12,19,2,19,7,329,336
2012,12,19,2,20,10,231,241
2012,12,19,2,21,4,164,168
2012,12,19,2,22,12,117,129
2012,12,19,2,23,4,84,88
2012,12,20,3,0,2,40,42
2012,12,20,3,1,1,19,20
2012,12,20,3,2,2,6,8
2012,12,20,3,3,1,3,4
2012,12,20,3,4,0,6,6
2012,12,20,3,5,0,35,35
2012,12,20,3,6,4,114,118
2012,12,20,3,7,4,346,350
2012,12,20,3,8,14,585,599
2012,12,20,3,9,14,303,317
2012,12,20,3,10,23,138,161
2012,12,20,3,11,22,168,190
2012,12,20,3,12,31,181,212
2012,12,20,3,13,46,171,217
2012,12,20,3,14,43,171,214
2012,12,20,3,15,33,216,249
2012,12,20,3,16,21,281,302
2012,12,20,3,17,25,450,475
2012,12,20,3,18,22,359,381
2012,12,20,3,19,3,115,118
2012,12,20,3,20,1,49,50
2012,12,20,3,21,1,25,26
2012,12,20,3,22,1,20,21
2012,12,20,3,23,0,13,13
2012,12,21,4,0,0,17,17
2012,12,21,4,1,2,7,9
2012,12,21,4,2,0,3,3
2012,12,21,4,3,0,3,3
2012,12,21,4,4,1,5,6
2012,12,21,4,5,0,13,13
2012,12,21,4,6,4,76,80
2012,12,21,4,7,3,205,208
2012,12,21,4,8,8,464,472
2012,12,21,4,9,2,265,267
2012,12,21,4,10,8,146,154
2012,12,21,4,11,12,150,162
2012,12,21,4,12,25,199,224
2012,12,21,4,13,26,214,240
2012,12,21,4,14,20,199,219
2012,12,21,4,15,29,234,263
2012,12,21,4,16,28,253,281
2012,12,21,4,17,24,297,321
2012,12,21,4,18,7,236,243
2012,12,21,4,19,5,148,153
2012,12,21,4,20,8,104,112
2012,12,21,4,21,2,68,70
2012,12,21,4,22,6,57,63
2012,12,21,4,23,1,39,40
2012,12,22,5,0,1,30,31
2012,12,22,5,1,1,34,35
2012,12,22,5,2,0,23,23
2012,12,22,5,3,0,7,7
2012,12,22,5,4,3,2,5
2012,12,22,5,5,0,5,5
2012,12,22,5,6,0,13,13
2012,12,22,5,7,2,18,20
2012,12,22,5,8,0,29,29
2012,12,22,5,9,13,77,90
2012,12,22,5,10,13,105,118
2012,12,22,5,11,29,130,159
2012,12,22,5,12,18,128,146
2012,12,22,5,13,23,135,158
2012,12,22,5,14,20,141,161
2012,12,22,5,15,14,139,153
2012,12,22,5,16,23,124,147
2012,12,22,5,17,15,99,114
2012,12,22,5,18,7,75,82
2012,12,22,5,19,9,51,60
2012,12,22,5,20,6,55,61
2012,12,22,5,21,4,49,53
2012,12,22,5,22,1,38,39
2012,12,22,5,23,3,37,40
2012,12,23,6,0,3,24,27
2012,12,23,6,1,1,19,20
2012,12,23,6,2,1,17,18
2012,12,23,6,3,0,9,9
2012,12,23,6,4,1,3,4
2012,12,23,6,5,0,6,6
2012,12,23,6,6,4,5,9
2012,12,23,6,7,3,16,19
2012,12,23,6,8,5,43,48
2012,12,23,6,9,7,49,56
2012,12,23,6,10,26,67,93
2012,12,23,6,11,48,104,152
2012,12,23,6,12,52,144,196
2012,12,23,6,13,63,123,186
2012,12,23,6,14,57,118,175
2012,12,23,6,15,39,98,137
2012,12,23,6,16,53,137,190
2012,12,23,6,17,21,93,114
2012,12,23,6,18,8,85,93
2012,12,23,6,19,4,54,58
2012,12,23,6,20,0,52,52
2012,12,23,6,21,4,38,42
2012,12,23,6,22,5,53,58
2012,12,23,6,23,3,22,25
2012,12,24,0,0,0,12,12
2012,12,24,0,1,0,11,11
2012,12,24,0,2,0,5,5
2012,12,24,0,3,1,2,3
2012,12,24,0,5,0,9,9
2012,12,24,0,6,1,16,17
2012,12,24,0,7,3,27,30
2012,12,24,0,8,4,62,66
2012,12,24,0,9,17,68,85
2012,12,24,0,10,21,82,103
2012,12,24,0,11,20,104,124
2012,12,24,0,12,22,113,135
2012,12,24,0,13,16,54,70
2012,12,24,0,14,13,33,46
2012,12,24,0,15,6,27,33
2012,12,24,0,16,6,27,33
2012,12,24,0,17,7,19,26
2012,12,24,0,18,6,20,26
2012,12,24,0,19,4,14,18
2012,12,24,0,20,6,17,23
2012,12,24,0,21,13,9,22
2012,12,24,0,22,7,5,12
2012,12,24,0,23,1,10,11
2012,12,25,1,0,3,10,13
2012,12,25,1,1,0,13,13
2012,12,25,1,2,0,7,7
2012,12,25,1,4,0,1,1
2012,12,25,1,5,2,1,3
2012,12,25,1,6,1,6,7
2012,12,25,1,7,0,6,6
2012,12,25,1,8,1,10,11
2012,12,25,1,9,7,21,28
2012,12,25,1,10,11,21,32
2012,12,25,1,11,43,43,86
2012,12,25,1,12,62,52,114
2012,12,25,1,13,75,46,121
2012,12,25,1,14,58,68,126
2012,12,25,1,15,51,56,107
2012,12,25,1,16,48,38,86
2012,12,25,1,17,16,34,50
2012,12,25,1,18,20,23,43
2012,12,25,1,19,16,20,36
2012,12,25,1,20,11,29,40
2012,12,25,1,21,8,26,34
2012,12,25,1,22,3,16,19
2012,12,25,1,23,4,26,30
2012,12,26,2,0,1,8,9
2012,12,26,2,1,0,7,7
2012,12,26,2,2,0,1,1
2012,12,26,2,3,0,2,2
2012,12,26,2,4,0,2,2
2012,12,26,2,5,0,11,11
2012,12,26,2,6,0,36,36
2012,12,26,2,7,0,26,26
2012,12,26,2,8,0,31,31
2012,12,26,2,9,1,22,23
2012,12,26,2,10,0,8,8
2012,12,26,2,11,0,10,10
2012,12,26,2,12,0,10,10
2012,12,26,2,13,0,15,15
2012,12,26,2,14,0,20,20
2012,12,26,2,15,0,13,13
2012,12,26,2,16,0,13,13
2012,12,26,2,17,2,51,53
2012,12,26,2,18,1,42,43
2012,12,26,2,19,2,33,35
2012,12,26,2,20,0,32,32
2012,12,26,2,21,0,20,20
2012,12,26,2,22,0,11,11
2012,12,26,2,23,2,8,10
2012,12,27,3,0,0,3,3
2012,12,27,3,1,0,5,5
2012,12,27,3,2,0,2,2
2012,12,27,3,3,0,1,1
2012,12,27,3,4,0,3,3
2012,12,27,3,5,1,10,11
2012,12,27,3,6,0,45,45
2012,12,27,3,7,0,90,90
2012,12,27,3,8,2,206,208
2012,12,27,3,9,6,127,133
2012,12,27,3,10,8,67,75
2012,12,27,3,11,23,80,103
2012,12,27,3,12,22,87,109
2012,12,27,3,13,19,99,118
2012,12,27,3,14,25,94,119
2012,12,27,3,15,31,89,120
2012,12,27,3,16,23,151,174
2012,12,27,3,17,30,227,257
2012,12,27,3,18,9,188,197
2012,12,27,3,19,11,106,117
2012,12,27,3,20,12,79,91
2012,12,27,3,21,12,51,63
2012,12,27,3,22,11,33,44
2012,12,27,3,23,2,24,26
2012,12,28,4,0,3,22,25
2012,12,28,4,1,0,9,9
2012,12,28,4,2,0,5,5
2012,12,28,4,3,0,2,2
2012,12,28,4,4,0,4,4
2012,12,28,4,5,0,15,15
2012,12,28,4,6,2,49,51
2012,12,28,4,7,1,111,112
2012,12,28,4,8,1,238,239
2012,12,28,4,9,18,173,191
2012,12,28,4,10,77,85,162
2012,12,28,4,11,71,107,178
2012,12,28,4,12,72,150,222
2012,12,28,4,13,76,146,222
2012,12,28,4,14,84,177,261
2012,12,28,4,15,74,151,225
2012,12,28,4,16,42,208,250
2012,12,28,4,17,43,228,271
2012,12,28,4,18,16,197,213
2012,12,28,4,19,15,113,128
2012,12,28,4,20,14,83,97
2012,12,28,4,21,17,75,92
2012,12,28,4,22,13,49,62
2012,12,28,4,23,5,54,59
2012,12,29,5,0,1,25,26
2012,12,29,5,1,6,31,37
2012,12,29,5,2,1,18,19
2012,12,29,5,3,1,5,6
2012,12,29,5,4,0,3,3
2012,12,29,5,5,0,3,3
2012,12,29,5,6,0,7,7
2012,12,29,5,7,1,17,18
2012,12,29,5,8,9,35,44
2012,12,29,5,9,16,33,49
2012,12,29,5,10,6,35,41
2012,12,29,5,11,7,38,45
2012,12,29,5,12,5,43,48
2012,12,29,5,13,13,71,84
2012,12,29,5,14,10,88,98
2012,12,29,5,15,19,110,129
2012,12,29,5,16,22,125,147
2012,12,29,5,17,18,100,118
2012,12,29,5,18,8,102,110
2012,12,29,5,19,7,90,97
2012,12,29,5,20,2,64,66
2012,12,29,5,21,4,56,60
2012,12,29,5,22,3,51,54
2012,12,29,5,23,0,32,32
2012,12,30,6,0,0,41,41
2012,12,30,6,1,1,27,28
2012,12,30,6,2,0,19,19
2012,12,30,6,3,1,14,15
2012,12,30,6,4,0,7,7
2012,12,30,6,5,0,2,2
2012,12,30,6,6,1,7,8
2012,12,30,6,7,0,13,13
2012,12,30,6,8,1,32,33
2012,12,30,6,9,9,65,74
2012,12,30,6,10,31,91,122
2012,12,30,6,11,33,103,136
2012,12,30,6,12,47,97,144
2012,12,30,6,13,49,120,169
2012,12,30,6,14,39,121,160
2012,12,30,6,15,37,101,138
2012,12,30,6,16,31,102,133
2012,12,30,6,17,26,97,123
2012,12,30,6,18,12,113,125
2012,12,30,6,19,16,86,102
2012,12,30,6,20,9,63,72
2012,12,30,6,21,5,42,47
2012,12,30,6,22,6,30,36
2012,12,30,6,23,10,39,49
2012,12,31,0,0,4,30,34
2012,12,31,0,1,6,13,19
2012,12,31,0,2,3,8,11
2012,12,31,0,3,0,1,1
2012,12,31,0,4,0,3,3
2012,12,31,0,5,0,9,9
2012,12,31,0,6,0,40,40
2012,12,31,0,7,2,83,85
2012,12,31,0,8,9,187,196
2012,12,31,0,9,13,144,157
2012,12,31,0,10,33,87,120
2012,12,31,0,11,43,114,157
2012,12,31,0,12,52,172,224
2012,12,31,0,13,38,165,203
2012,12,31,0,14,62,185,247
2012,12,31,0,15,69,246,315
2012,12,31,0,16,30,184,214
2012,12,31,0,17,14,150,164
2012,12,31,0,18,10,112,122
2012,12,31,0,19,11,108,119
2012,12,31,0,20,8,81,89
2012,12,31,0,21,7,83,90
2012,12,31,0,22,13,48,61
2012,12,31,0,23,12,37,49
2013,1,1,1,0,9,34,43
2013,1,1,1,1,27,86,113
2013,1,1,1,2,27,104,131
2013,1,1,1,3,16,42,58
2013,1,1,1,4,4,15,19
2013,1,1,1,5,0,5,5
2013,1,1,1,6,4,10,14
2013,1,1,1,7,0,5,5
2013,1,1,1,8,3,12,15
2013,1,1,1,9,7,25,32
2013,1,1,1,10,5,48,53
2013,1,1,1,11,17,97,114
2013,1,1,1,12,42,112,154
2013,1,1,1,13,21,123,144
2013,1,1,1,14,61,113,174
2013,1,1,1,15,37,123,160
2013,1,1,1,16,45,121,166
2013,1,1,1,17,23,117,140
2013,1,1,1,18,12,106,118
2013,1,1,1,19,20,91,111
2013,1,1,1,20,7,64,71
2013,1,1,1,21,9,47,56
2013,1,1,1,22,19,36,55
2013,1,1,1,23,6,28,34
2013,1,2,2,0,0,9,9
2013,1,2,2,1,2,6,8
2013,1,2,2,2,0,2,2
2013,1,2,2,3,0,3,3
2013,1,2,2,4,0,4,4
2013,1,2,2,5,1,28,29
2013,1,2,2,6,2,91,93
2013,1,2,2,7,3,243,246
2013,1,2,2,8,6,490,496
2013,1,2,2,9,5,227,232
2013,1,2,2,10,35,92,127
2013,1,2,2,11,32,114,146
2013,1,2,2,12,25,143,168
2013,1,2,2,13,23,143,166
2013,1,2,2,14,14,118,132
2013,1,2,2,15,26,170,196
2013,1,2,2,16,30,240,270
2013,1,2,2,17,30,417,447
2013,1,2,2,18,19,349,368
2013,1,2,2,19,8,236,244
2013,1,2,2,20,5,119,124
2013,1,2,2,21,9,85,94
2013,1,2,2,22,5,52,57
2013,1,2,2,23,4,38,42
2013,1,3,3,0,1,15,16
2013,1,3,3,1,0,6,6
2013,1,3,3,2,0,2,2
2013,1,3,3,3,0,3,3
2013,1,3,3,4,0,2,2
2013,1,3,3,5,0,26,26
2013,1,3,3,6,3,96,99
2013,1,3,3,7,2,221,223
2013,1,3,3,8,10,513,523
2013,1,3,3,9,18,261,279
2013,1,3,3,10,16,119,135
2013,1,3,3,11,21,109,130
2013,1,3,3,12,30,142,172
2013,1,3,3,13,37,129,166
2013,1,3,3,14,25,133,158
2013,1,3,3,15,35,135,170
2013,1,3,3,16,31,235,266
2013,1,3,3,17,34,456,490
2013,1,3,3,18,15,385,400
2013,1,3,3,19,5,236,241
2013,1,3,3,20,5,128,133
2013,1,3,3,21,2,98,100
2013,1,3,3,22,1,79,80
2013,1,3,3,23,6,47,53
2013,1,4,4,0,6,17,23
2013,1,4,4,1,0,8,8
2013,1,4,4,2,1,3,4
2013,1,4,4,3,0,2,2
2013,1,4,4,4,0,7,7
2013,1,4,4,5,1,25,26
2013,1,4,4,6,4,81,85
2013,1,4,4,7,3,224,227
2013,1,4,4,8,7,531,538
2013,1,4,4,9,17,277,294
2013,1,4,4,10,12,119,131
2013,1,4,4,11,16,109,125
2013,1,4,4,12,26,175,201
2013,1,4,4,13,29,174,203
2013,1,4,4,14,50,152,202
2013,1,4,4,15,27,175,202
2013,1,4,4,16,23,258,281
2013,1,4,4,17,23,467,490
2013,1,4,4,18,14,372,386
2013,1,4,4,19,13,231,244
2013,1,4,4,20,13,153,166
2013,1,4,4,21,6,102,108
2013,1,4,4,22,5,89,94
2013,1,4,4,23,1,70,71
2013,1,5,5,0,3,49,52
2013,1,5,5,1,2,31,33
2013,1,5,5,2,5,27,32
2013,1,5,5,3,0,8,8
2013,1,5,5,4,0,7,7
2013,1,5,5,5,0,1,1
2013,1,5,5,6,2,10,12
2013,1,5,5,7,1,26,27
2013,1,5,5,8,6,64,70
2013,1,5,5,9,10,106,116
2013,1,5,5,10,24,171,195
2013,1,5,5,11,35,223,258
2013,1,5,5,12,51,269,320
2013,1,5,5,13,58,313,371
2013,1,5,5,14,60,287,347
2013,1,5,5,15,70,249,319
2013,1,5,5,16,64,248,312
2013,1,5,5,17,36,200,236
2013,1,5,5,18,17,204,221
2013,1,5,5,19,14,183,197
2013,1,5,5,20,25,140,165
2013,1,5,5,21,14,89,103
2013,1,5,5,22,5,93,98
2013,1,5,5,23,7,55,62
2013,1,6,6,0,7,69,76
2013,1,6,6,1,4,52,56
2013,1,6,6,2,1,46,47
2013,1,6,6,3,5,13,18
2013,1,6,6,4,0,5,5
2013,1,6,6,5,0,6,6
2013,1,6,6,6,1,10,11
2013,1,6,6,7,0,22,22
2013,1,6,6,8,2,59,61
2013,1,6,6,9,5,90,95
2013,1,6,6,10,27,223,250
2013,1,6,6,11,49,234,283
2013,1,6,6,12,52,317,369
2013,1,6,6,13,79,328,407
2013,1,6,6,14,96,289,385
2013,1,6,6,15,98,318,416
2013,1,6,6,16,59,303,362
2013,1,6,6,17,37,203,240
2013,1,6,6,18,10,170,180
2013,1,6,6,19,8,169,177
2013,1,6,6,20,8,120,128
2013,1,6,6,21,12,70,82
2013,1,6,6,22,17,58,75
2013,1,6,6,23,9,30,39
2013,1,7,0,0,2,15,17
2013,1,7,0,1,2,9,11
2013,1,7,0,2,0,4,4
2013,1,7,0,3,0,3,3
2013,1,7,0,4,0,7,7
2013,1,7,0,5,3,30,33
2013,1,7,0,6,2,124,126
2013,1,7,0,7,6,326,332
2013,1,7,0,8,11,613,624
2013,1,7,0,9,11,259,270
2013,1,7,0,10,8,89,97
2013,1,7,0,11,17,95,112
2013,1,7,0,12,25,178,203
2013,1,7,0,13,38,152,190
2013,1,7,0,14,40,136,176
2013,1,7,0,15,29,180,209
2013,1,7,0,16,34,311,345
2013,1,7,0,17,44,557,601
2013,1,7,0,18,23,517,540
2013,1,7,0,19,13,340,353
2013,1,7,0,20,9,211,220
2013,1,7,0,21,11,138,149
2013,1,7,0,22,3,91,94
2013,1,7,0,23,1,57,58
2013,1,8,1,0,0,22,22
2013,1,8,1,1,0,14,14
2013,1,8,1,2,3,1,4
2013,1,8,1,3,0,4,4
2013,1,8,1,4,0,4,4
2013,1,8,1,5,2,32,34
2013,1,8,1,6,1,101,102
2013,1,8,1,7,2,319,321
2013,1,8,1,8,14,661,675
2013,1,8,1,9,16,269,285
2013,1,8,1,10,32,114,146
2013,1,8,1,11,17,158,175
2013,1,8,1,12,46,187,233
2013,1,8,1,13,38,205,243
2013,1,8,1,14,38,167,205
2013,1,8,1,15,46,200,246
2013,1,8,1,16,50,314,364
2013,1,8,1,17,39,581,620
2013,1,8,1,18,37,573,610
2013,1,8,1,19,21,397,418
2013,1,8,1,20,23,220,243
2013,1,8,1,21,4,156,160
2013,1,8,1,22,9,93,102
2013,1,8,1,23,4,77,81
2013,1,9,2,0,0,28,28
2013,1,9,2,1,0,10,10
2013,1,9,2,2,0,5,5
2013,1,9,2,3,0,4,4
2013,1,9,2,4,0,8,8
2013,1,9,2,5,1,43,44
2013,1,9,2,6,3,128,131
2013,1,9,2,7,6,346,352
2013,1,9,2,8,19,679,698
2013,1,9,2,9,7,310,317
2013,1,9,2,10,14,121,135
2013,1,9,2,11,31,151,182
2013,1,9,2,12,45,180,225
2013,1,9,2,13,18,167,185
2013,1,9,2,14,32,133,165
2013,1,9,2,15,21,142,163
2013,1,9,2,16,32,260,292
2013,1,9,2,17,33,586,619
2013,1,9,2,18,18,551,569
2013,1,9,2,19,22,358,380
2013,1,9,2,20,13,245,258
2013,1,9,2,21,11,155,166
2013,1,9,2,22,17,107,124
2013,1,9,2,23,13,74,87
2013,1,10,3,0,1,30,31
2013,1,10,3,1,2,14,16
2013,1,10,3,2,1,7,8
2013,1,10,3,3,0,1,1
2013,1,10,3,4,1,4,5
2013,1,10,3,5,1,28,29
2013,1,10,3,6,2,101,103
2013,1,10,3,7,3,343,346
2013,1,10,3,8,17,676,693
2013,1,10,3,9,19,293,312
2013,1,10,3,10,17,136,153
2013,1,10,3,11,23,158,181
2013,1,10,3,12,24,215,239
2013,1,10,3,13,28,217,245
2013,1,10,3,14,27,170,197
2013,1,10,3,15,32,212,244
2013,1,10,3,16,34,330,364
2013,1,10,3,17,43,632,675
2013,1,10,3,18,24,516,540
2013,1,10,3,19,27,344,371
2013,1,10,3,20,15,267,282
2013,1,10,3,21,7,190,197
2013,1,10,3,22,8,114,122
2013,1,10,3,23,3,58,61
2013,1,11,4,0,3,36,39
2013,1,11,4,1,0,19,19
2013,1,11,4,2,0,7,7
2013,1,11,4,3,0,8,8
2013,1,11,4,4,0,5,5
2013,1,11,4,5,0,44,44
2013,1,11,4,6,1,100,101
2013,1,11,4,7,8,296,304
2013,1,11,4,8,21,652,673
2013,1,11,4,9,20,312,332
2013,1,11,4,10,23,139,162
2013,1,11,4,11,28,165,193
2013,1,11,4,12,15,165,180
2013,1,11,4,13,14,143,157
2013,1,11,4,14,21,191,212
2013,1,11,4,15,17,161,178
2013,1,11,4,16,10,165,175
2013,1,11,4,17,12,260,272
2013,1,11,4,18,13,328,341
2013,1,11,4,19,9,227,236
2013,1,11,4,20,9,167,176
2013,1,11,4,21,15,118,133
2013,1,11,4,22,9,105,114
2013,1,11,4,23,6,83,89
2013,1,12,5,0,3,77,80
2013,1,12,5,1,2,58,60
2013,1,12,5,2,3,46,49
2013,1,12,5,3,5,17,22
2013,1,12,5,4,0,3,3
2013,1,12,5,5,1,10,11
2013,1,12,5,6,4,17,21
2013,1,12,5,7,6,43,49
2013,1,12,5,8,13,106,119
2013,1,12,5,9,27,177,204
2013,1,12,5,10,36,251,287
2013,1,12,5,11,93,326,419
2013,1,12,5,12,122,365,487
2013,1,12,5,13,157,382,539
2013,1,12,5,14,222,435,657
2013,1,12,5,15,178,408,586
2013,1,12,5,16,132,385,517
2013,1,12,5,17,93,285,378
2013,1,12,5,18,53,241,294
2013,1,12,5,19,19,182,201
2013,1,12,5,20,19,184,203
2013,1,12,5,21,30,153,183
2013,1,12,5,22,13,121,134
2013,1,12,5,23,9,116,125
2013,1,13,6,0,4,91,95
2013,1,13,6,1,5,101,106
2013,1,13,6,2,7,64,71
2013,1,13,6,3,2,11,13
2013,1,13,6,4,1,5,6
2013,1,13,6,5,1,6,7
2013,1,13,6,6,2,12,14
2013,1,13,6,7,3,25,28
2013,1,13,6,8,15,69,84
2013,1,13,6,9,31,146,177
2013,1,13,6,10,52,240,292
2013,1,13,6,11,81,286,367
2013,1,13,6,12,126,304,430
2013,1,13,6,13,101,299,400
2013,1,13,6,14,87,292,379
2013,1,13,6,15,78,245,323
2013,1,13,6,16,82,288,370
2013,1,13,6,17,62,185,247
2013,1,13,6,18,15,149,164
2013,1,13,6,19,13,169,182
2013,1,13,6,20,27,134,161
2013,1,13,6,21,21,77,98
2013,1,13,6,22,12,64,76
2013,1,13,6,23,7,48,55
2013,1,14,0,0,2,11,13
2013,1,14,0,1,2,6,8
2013,1,14,0,2,2,4,6
2013,1,14,0,3,1,2,3
2013,1,14,0,4,0,6,6
2013,1,14,0,5,0,40,40
2013,1,14,0,6,0,135,135
2013,1,14,0,7,20,303,323
2013,1,14,0,8,18,604,622
2013,1,14,0,9,26,304,330
2013,1,14,0,10,40,149,189
2013,1,14,0,11,32,132,164
2013,1,14,0,12,43,180,223
2013,1,14,0,13,35,178,213
2013,1,14,0,14,35,164,199
2013,1,14,0,15,37,190,227
2013,1,14,0,16,30,281,311
2013,1,14,0,17,39,593,632
2013,1,14,0,18,28,561,589
2013,1,14,0,19,21,376,397
2013,1,14,0,20,15,213,228
2013,1,14,0,21,6,101,107
2013,1,14,0,22,10,48,58
2013,1,14,0,23,2,34,36
2013,1,15,1,0,0,16,16
2013,1,15,1,1,1,2,3
2013,1,15,1,3,1,2,3
2013,1,15,1,4,0,9,9
2013,1,15,1,5,2,20,22
2013,1,15,1,6,1,81,82
2013,1,15,1,7,7,148,155
2013,1,15,1,8,8,286,294
2013,1,15,1,9,10,166,176
2013,1,15,1,10,11,60,71
2013,1,15,1,11,14,56,70
2013,1,15,1,12,18,92,110
2013,1,15,1,13,25,146,171
2013,1,15,1,14,14,89,103
2013,1,15,1,15,24,147,171
2013,1,15,1,16,26,215,241
2013,1,15,1,17,21,404,425
2013,1,15,1,18,14,424,438
2013,1,15,1,19,12,155,167
2013,1,15,1,20,3,88,91
2013,1,15,1,21,6,42,48
2013,1,15,1,22,5,36,41
2013,1,15,1,23,1,15,16
2013,1,16,2,0,0,7,7
2013,1,16,2,1,1,3,4
2013,1,16,2,2,1,2,3
2013,1,16,2,3,0,1,1
2013,1,16,2,4,0,6,6
2013,1,16,2,5,0,22,22
2013,1,16,2,6,0,72,72
2013,1,16,2,7,7,259,266
2013,1,16,2,8,21,407,428
2013,1,16,2,9,5,168,173
2013,1,16,2,10,5,75,80
2013,1,16,2,11,13,75,88
2013,1,16,2,12,18,122,140
2013,1,16,2,13,19,121,140
2013,1,16,2,14,18,87,105
2013,1,16,2,15,6,100,106
2013,1,16,2,16,12,167,179
2013,1,16,2,17,12,402,414
2013,1,16,2,18,14,421,435
2013,1,16,2,19,13,288,301
2013,1,16,2,20,8,206,214
2013,1,16,2,21,12,171,183
2013,1,16,2,22,8,90,98
2013,1,16,2,23,4,42,46
2013,1,17,3,0,8,32,40
2013,1,17,3,1,6,10,16
2013,1,17,3,2,1,1,2
2013,1,17,3,3,0,3,3
2013,1,17,3,4,0,5,5
2013,1,17,3,5,2,29,31
2013,1,17,3,6,3,111,114
2013,1,17,3,7,9,318,327
2013,1,17,3,8,17,574,591
2013,1,17,3,9,24,316,340
2013,1,17,3,10,29,122,151
2013,1,17,3,11,18,161,179
2013,1,17,3,12,41,177,218
2013,1,17,3,13,33,150,183
2013,1,17,3,14,35,158,193
2013,1,17,3,15,26,168,194
2013,1,17,3,16,23,261,284
2013,1,17,3,17,37,516,553
2013,1,17,3,18,16,467,483
2013,1,17,3,19,11,303,314
2013,1,17,3,20,6,207,213
2013,1,17,3,21,4,178,182
2013,1,17,3,22,3,107,110
2013,1,17,3,23,10,81,91
2013,1,18,4,0,4,36,40
2013,1,18,4,1,0,16,16
2013,1,18,4,2,6,10,16
2013,1,18,4,3,1,4,5
2013,1,18,4,4,0,5,5
2013,1,18,4,5,0,26,26
2013,1,18,4,6,0,82,82
2013,1,18,4,7,5,259,264
2013,1,18,4,8,16,523,539
2013,1,18,4,9,15,311,326
2013,1,18,4,10,23,136,159
2013,1,18,4,11,22,141,163
2013,1,18,4,12,25,175,200
2013,1,18,4,13,28,196,224
2013,1,18,4,14,46,174,220
2013,1,18,4,15,39,188,227
2013,1,18,4,16,37,310,347
2013,1,18,4,17,18,447,465
2013,1,18,4,18,17,407,424
2013,1,18,4,19,9,249,258
2013,1,18,4,20,10,177,187
2013,1,18,4,21,9,113,122
2013,1,18,4,22,4,111,115
2013,1,18,4,23,6,76,82
2013,1,19,5,0,1,59,60
2013,1,19,5,1,3,47,50
2013,1,19,5,2,3,34,37
2013,1,19,5,3,2,12,14
2013,1,19,5,4,2,8,10
2013,1,19,5,5,1,9,10
2013,1,19,5,6,0,15,15
2013,1,19,5,7,5,43,48
2013,1,19,5,8,7,79,86
2013,1,19,5,9,21,161,182
2013,1,19,5,10,38,213,251
2013,1,19,5,11,79,261,340
2013,1,19,5,12,124,295,419
2013,1,19,5,13,136,328,464
2013,1,19,5,14,189,402,591
2013,1,19,5,15,152,358,510
2013,1,19,5,16,181,326,507
2013,1,19,5,17,110,266,376
2013,1,19,5,18,55,224,279
2013,1,19,5,19,28,193,221
2013,1,19,5,20,21,126,147
2013,1,19,5,21,14,114,128
2013,1,19,5,22,9,106,115
2013,1,19,5,23,18,96,114
2013,1,20,6,0,9,78,87
2013,1,20,6,1,6,85,91
2013,1,20,6,2,7,66,73
2013,1,20,6,3,7,34,41
2013,1,20,6,4,3,10,13
2013,1,20,6,5,0,11,11
2013,1,20,6,6,3,9,12
2013,1,20,6,7,1,31,32
2013,1,20,6,8,10,67,77
2013,1,20,6,9,28,122,150
2013,1,20,6,10,54,236,290
2013,1,20,6,11,122,309,431
2013,1,20,6,12,186,358,544
2013,1,20,6,13,207,340,547
2013,1,20,6,14,254,389,643
2013,1,20,6,15,255,424,679
2013,1,20,6,16,182,336,518
2013,1,20,6,17,134,269,403
2013,1,20,6,18,67,275,342
2013,1,20,6,19,38,183,221
2013,1,20,6,20,28,136,164
2013,1,20,6,21,22,114,136
2013,1,20,6,22,14,132,146
2013,1,20,6,23,20,97,117
2013,1,21,0,0,17,77,94
2013,1,21,0,1,7,46,53
2013,1,21,0,2,13,29,42
2013,1,21,0,3,6,10,16
2013,1,21,0,4,5,22,27
2013,1,21,0,5,5,27,32
2013,1,21,0,6,28,59,87
2013,1,21,0,7,56,129,185
2013,1,21,0,8,77,190,267
2013,1,21,0,9,81,229,310
2013,1,21,0,10,89,245,334
2013,1,21,0,11,46,202,248
2013,1,21,0,12,123,317,440
2013,1,21,0,13,120,346,466
2013,1,21,0,14,89,254,343
2013,1,21,0,15,60,228,288
2013,1,21,0,16,97,280,377
2013,1,21,0,17,42,247,289
2013,1,21,0,18,18,181,199
2013,1,21,0,19,13,141,154
2013,1,21,0,20,11,108,119
2013,1,21,0,21,9,90,99
2013,1,21,0,22,11,52,63
2013,1,21,0,23,4,38,42
2013,1,22,1,0,7,37,44
2013,1,22,1,1,2,7,9
2013,1,22,1,2,0,3,3
2013,1,22,1,3,2,6,8
2013,1,22,1,4,1,7,8
2013,1,22,1,5,0,28,28
2013,1,22,1,6,2,80,82
2013,1,22,1,7,6,238,244
2013,1,22,1,8,5,446,451
2013,1,22,1,9,9,204,213
2013,1,22,1,10,4,78,82
2013,1,22,1,11,7,63,70
2013,1,22,1,12,4,101,105
2013,1,22,1,13,5,87,92
2013,1,22,1,14,7,73,80
2013,1,22,1,15,6,106,112
2013,1,22,1,16,3,184,187
2013,1,22,1,17,5,323,328
2013,1,22,1,18,8,290,298
2013,1,22,1,19,3,207,210
2013,1,22,1,20,2,121,123
2013,1,22,1,21,0,94,94
2013,1,22,1,22,1,56,57
2013,1,22,1,23,0,23,23
2013,1,23,2,0,0,15,15
2013,1,23,2,1,0,7,7
2013,1,23,2,2,2,4,6
2013,1,23,2,3,0,2,2
2013,1,23,2,4,0,2,2
2013,1,23,2,5,0,19,19
2013,1,23,2,6,0,89,89
2013,1,23,2,7,2,231,233
2013,1,23,2,8,10,414,424
2013,1,23,2,9,3,200,203
2013,1,23,2,10,4,77,81
2013,1,23,2,11,6,94,100
2013,1,23,2,12,5,117,122
2013,1,23,2,13,5,132,137
2013,1,23,2,14,7,94,101
2013,1,23,2,15,5,112,117
2013,1,23,2,16,0,200,200
2013,1,23,2,17,5,374,379
2013,1,23,2,18,3,329,332
2013,1,23,2,19,3,262,265
2013,1,23,2,20,4,166,170
2013,1,23,2,21,2,116,118
2013,1,23,2,22,2,65,67
2013,1,23,2,23,1,30,31
2013,1,24,3,0,1,13,14
2013,1,24,3,1,0,6,6
2013,1,24,3,2,0,1,1
2013,1,24,3,3,0,1,1
2013,1,24,3,4,0,3,3
2013,1,24,3,5,0,19,19
2013,1,24,3,6,0,43,43
2013,1,24,3,7,0,90,90
2013,1,24,3,8,3,220,223
2013,1,24,3,9,4,154,158
2013,1,24,3,10,2,67,69
2013,1,24,3,11,1,82,83
2013,1,24,3,12,0,105,105
2013,1,24,3,13,1,92,93
2013,1,24,3,14,0,81,81
2013,1,24,3,15,1,109,110
2013,1,24,3,16,0,145,145
2013,1,24,3,17,1,322,323
2013,1,24,3,18,4,287,291
2013,1,24,3,19,1,201,202
2013,1,24,3,20,1,129,130
2013,1,24,3,21,0,125,125
2013,1,24,3,22,0,90,90
2013,1,24,3,23,0,43,43
2013,1,25,4,0,0,10,10
2013,1,25,4,1,1,6,7
2013,1,25,4,2,0,2,2
2013,1,25,4,3,0,2,2
2013,1,25,4,4,0,6,6
2013,1,25,4,5,0,26,26
2013,1,25,4,6,0,72,72
2013,1,25,4,7,3,171,174
2013,1,25,4,8,2,383,385
2013,1,25,4,9,3,248,251
2013,1,25,4,10,8,94,102
2013,1,25,4,11,1,116,117
2013,1,25,4,12,6,114,120
2013,1,25,4,13,5,120,125
2013,1,25,4,14,4,81,85
2013,1,25,4,15,1,84,85
2013,1,25,4,16,1,115,116
2013,1,25,4,17,3,171,174
2013,1,25,4,18,0,134,134
2013,1,25,4,19,1,117,118
2013,1,25,4,20,2,71,73
2013,1,25,4,21,1,82,83
2013,1,25,4,22,1,58,59
2013,1,25,4,23,1,48,49
2013,1,26,5,0,0,33,33
2013,1,26,5,1,2,27,29
2013,1,26,5,2,0,19,19
2013,1,26,5,3,1,9,10
2013,1,26,5,4,0,4,4
2013,1,26,5,5,0,2,2
2013,1,26,5,6,2,5,7
2013,1,26,5,7,1,14,15
2013,1,26,5,8,1,46,47
2013,1,26,5,9,5,119,124
2013,1,26,5,10,7,140,147
2013,1,26,5,11,10,173,183
2013,1,26,5,12,15,223,238
2013,1,26,5,13,16,214,230
2013,1,26,5,14,21,212,233
2013,1,26,5,15,11,209,220
2013,1,26,5,16,15,225,240
2013,1,26,5,17,18,197,215
2013,1,26,5,18,12,207,219
2013,1,26,5,19,6,165,171
2013,1,26,5,20,11,111,122
2013,1,26,5,21,6,89,95
2013,1,26,5,22,6,73,79
2013,1,26,5,23,13,70,83
2013,1,27,6,0,3,58,61
2013,1,27,6,1,3,66,69
2013,1,27,6,2,0,48,48
2013,1,27,6,3,3,27,30
2013,1,27,6,4,1,6,7
2013,1,27,6,5,1,5,6
2013,1,27,6,6,0,11,11
2013,1,27,6,7,0,19,19
2013,1,27,6,8,1,45,46
2013,1,27,6,9,7,89,96
2013,1,27,6,10,9,174,183
2013,1,27,6,11,21,184,205
2013,1,27,6,12,32,256,288
2013,1,27,6,13,35,227,262
2013,1,27,6,14,49,236,285
2013,1,27,6,15,38,277,315
2013,1,27,6,16,28,247,275
2013,1,27,6,17,13,232,245
2013,1,27,6,18,8,200,208
2013,1,27,6,19,6,118,124
2013,1,27,6,20,1,97,98
2013,1,27,6,21,2,57,59
2013,1,27,6,22,2,63,65
2013,1,27,6,23,0,27,27
2013,1,28,0,0,2,21,23
2013,1,28,0,1,0,7,7
2013,1,28,0,2,0,4,4
2013,1,28,0,3,0,2,2
2013,1,28,0,4,0,5,5
2013,1,28,0,5,0,15,15
2013,1,28,0,6,0,30,30
2013,1,28,0,7,1,69,70
2013,1,28,0,8,2,119,121
2013,1,28,0,9,0,75,75
2013,1,28,0,10,1,50,51
2013,1,28,0,11,2,101,103
2013,1,28,0,12,1,79,80
2013,1,28,0,13,3,85,88
2013,1,28,0,14,4,90,94
2013,1,28,0,15,8,127,135
2013,1,28,0,16,5,176,181
2013,1,28,0,17,6,409,415
2013,1,28,0,18,8,392,400
2013,1,28,0,19,5,292,297
2013,1,28,0,20,3,207,210
2013,1,28,0,21,3,168,171
2013,1,28,0,22,8,86,94
2013,1,28,0,23,3,59,62
2013,1,29,1,0,0,17,17
2013,1,29,1,1,4,12,16
2013,1,29,1,2,0,2,2
2013,1,29,1,3,0,2,2
2013,1,29,1,4,0,4,4
2013,1,29,1,5,0,31,31
2013,1,29,1,6,0,122,122
2013,1,29,1,7,3,336,339
2013,1,29,1,8,9,708,717
2013,1,29,1,9,9,331,340
2013,1,29,1,10,20,140,160
2013,1,29,1,11,24,157,181
2013,1,29,1,12,30,212,242
2013,1,29,1,13,36,218,254
2013,1,29,1,14,31,172,203
2013,1,29,1,15,46,236,282
2013,1,29,1,16,20,324,344
2013,1,29,1,17,39,684,723
2013,1,29,1,18,21,621,642
2013,1,29,1,19,11,411,422
2013,1,29,1,20,4,311,315
2013,1,29,1,21,8,241,249
2013,1,29,1,22,4,143,147
2013,1,29,1,23,2,78,80
2013,1,30,2,0,0,33,33
2013,1,30,2,1,1,16,17
2013,1,30,2,2,3,7,10
2013,1,30,2,3,1,2,3
2013,1,30,2,4,0,7,7
2013,1,30,2,5,0,26,26
2013,1,30,2,6,0,137,137
2013,1,30,2,7,6,402,408
2013,1,30,2,8,5,741,746
2013,1,30,2,9,9,317,326
2013,1,30,2,10,13,144,157
2013,1,30,2,11,14,135,149
2013,1,30,2,12,14,212,226
2013,1,30,2,13,22,172,194
2013,1,30,2,14,24,170,194
2013,1,30,2,15,15,185,200
2013,1,30,2,16,5,233,238
2013,1,30,2,17,16,531,547
2013,1,30,2,18,21,513,534
2013,1,30,2,19,10,353,363
2013,1,30,2,20,0,80,80
2013,1,30,2,21,1,46,47
2013,1,30,2,22,1,21,22
2013,1,30,2,23,1,22,23
2013,1,31,3,0,0,9,9
2013,1,31,3,1,0,6,6
2013,1,31,3,2,0,5,5
2013,1,31,3,3,0,3,3
2013,1,31,3,4,0,10,10
2013,1,31,3,5,0,28,28
2013,1,31,3,6,3,108,111
2013,1,31,3,7,7,304,311
2013,1,31,3,8,9,599,608
2013,1,31,3,9,6,318,324
2013,1,31,3,10,4,106,110
2013,1,31,3,11,12,154,166
2013,1,31,3,12,8,173,181
2013,1,31,3,13,9,142,151
2013,1,31,3,14,15,118,133
2013,1,31,3,15,9,140,149
2013,1,31,3,16,3,235,238
2013,1,31,3,17,12,534,546
2013,1,31,3,18,5,436,441
2013,1,31,3,19,5,280,285
2013,1,31,3,20,4,235,239
2013,1,31,3,21,3,158,161
2013,1,31,3,22,3,78,81
2013,1,31,3,23,3,59,62
2013,2,1,4,0,1,32,33
2013,2,1,4,1,1,19,20
2013,2,1,4,2,0,10,10
2013,2,1,4,3,0,2,2
2013,2,1,4,4,1,5,6
2013,2,1,4,5,1,30,31
2013,2,1,4,6,2,64,66
2013,2,1,4,7,2,151,153
2013,2,1,4,8,5,400,405
2013,2,1,4,9,5,263,268
2013,2,1,4,10,6,95,101
2013,2,1,4,11,6,117,123
2013,2,1,4,12,6,137,143
2013,2,1,4,13,11,121,132
2013,2,1,4,14,7,112,119
2013,2,1,4,15,8,119,127
2013,2,1,4,16,6,216,222
2013,2,1,4,17,7,387,394
2013,2,1,4,18,6,307,313
2013,2,1,4,19,1,183,184
2013,2,1,4,20,1,127,128
2013,2,1,4,21,0,90,90
2013,2,1,4,22,0,76,76
2013,2,1,4,23,1,54,55
2013,2,2,5,0,0,38,38
2013,2,2,5,1,0,31,31
2013,2,2,5,2,1,24,25
2013,2,2,5,3,1,9,10
2013,2,2,5,4,0,6,6
2013,2,2,5,5,0,2,2
2013,2,2,5,6,1,11,12
2013,2,2,5,7,2,35,37
2013,2,2,5,8,6,95,101
2013,2,2,5,9,14,121,135
2013,2,2,5,10,12,177,189
2013,2,2,5,11,18,181,199
2013,2,2,5,12,29,205,234
2013,2,2,5,13,29,195,224
2013,2,2,5,14,28,191,219
2013,2,2,5,15,27,236,263
2013,2,2,5,16,21,181,202
2013,2,2,5,17,17,122,139
2013,2,2,5,18,9,83,92
2013,2,2,5,19,4,67,71
2013,2,2,5,20,3,74,77
2013,2,2,5,21,4,54,58
2013,2,2,5,22,1,53,54
2013,2,2,5,23,6,49,55
2013,2,3,6,0,2,43,45
2013,2,3,6,1,3,41,44
2013,2,3,6,2,2,47,49
2013,2,3,6,3,1,18,19
2013,2,3,6,4,1,5,6
2013,2,3,6,5,0,3,3
2013,2,3,6,6,0,10,10
2013,2,3,6,7,0,17,17
2013,2,3,6,8,1,45,46
2013,2,3,6,9,6,71,77
2013,2,3,6,10,11,138,149
2013,2,3,6,11,21,188,209
2013,2,3,6,12,29,214,243
2013,2,3,6,13,19,192,211
2013,2,3,6,14,12,181,193
2013,2,3,6,15,11,181,192
2013,2,3,6,16,23,178,201
2013,2,3,6,17,22,239,261
2013,2,3,6,18,9,170,179
2013,2,3,6,19,4,70,74
2013,2,3,6,20,1,61,62
2013,2,3,6,21,0,65,65
2013,2,3,6,22,3,90,93
2013,2,3,6,23,4,134,138
2013,2,4,0,0,0,17,17
2013,2,4,0,1,0,5,5
2013,2,4,0,2,0,1,1
2013,2,4,0,3,0,5,5
2013,2,4,0,4,0,4,4
2013,2,4,0,5,0,20,20
2013,2,4,0,6,0,88,88
2013,2,4,0,7,1,279,280
2013,2,4,0,8,6,513,519
2013,2,4,0,9,8,283,291
2013,2,4,0,10,2,95,97
2013,2,4,0,11,15,97,112
2013,2,4,0,12,9,123,132
2013,2,4,0,13,12,126,138
2013,2,4,0,14,13,114,127
2013,2,4,0,15,11,135,146
2013,2,4,0,16,7,230,237
2013,2,4,0,17,12,485,497
2013,2,4,0,18,6,447,453
2013,2,4,0,19,8,301,309
2013,2,4,0,20,5,194,199
2013,2,4,0,21,4,143,147
2013,2,4,0,22,0,72,72
2013,2,4,0,23,3,47,50
2013,2,5,1,0,0,20,20
2013,2,5,1,1,0,7,7
2013,2,5,1,2,1,1,2
2013,2,5,1,3,0,3,3
2013,2,5,1,4,0,4,4
2013,2,5,1,5,2,21,23
2013,2,5,1,6,1,113,114
2013,2,5,1,7,3,308,311
2013,2,5,1,8,6,591,597
2013,2,5,1,9,8,281,289
2013,2,5,1,10,13,103,116
2013,2,5,1,11,13,142,155
2013,2,5,1,12,14,164,178
2013,2,5,1,13,10,174,184
2013,2,5,1,14,18,126,144
2013,2,5,1,15,11,150,161
2013,2,5,1,16,8,305,313
2013,2,5,1,17,9,529,538
2013,2,5,1,18,14,523,537
2013,2,5,1,19,5,336,341
2013,2,5,1,20,6,244,250
2013,2,5,1,21,3,155,158
2013,2,5,1,22,3,105,108
2013,2,5,1,23,3,57,60
2013,2,6,2,0,0,21,21
2013,2,6,2,1,2,6,8
2013,2,6,2,2,0,3,3
2013,2,6,2,3,0,1,1
2013,2,6,2,4,0,5,5
2013,2,6,2,5,2,37,39
2013,2,6,2,6,0,137,137
2013,2,6,2,7,4,354,358
2013,2,6,2,8,14,669,683
2013,2,6,2,9,16,291,307
2013,2,6,2,10,15,114,129
2013,2,6,2,11,8,115,123
2013,2,6,2,12,15,175,190
2013,2,6,2,13,14,172,186
2013,2,6,2,14,9,137,146
2013,2,6,2,15,11,191,202
2013,2,6,2,16,23,285,308
2013,2,6,2,17,11,552,563
2013,2,6,2,18,10,529,539
2013,2,6,2,19,6,353,359
2013,2,6,2,20,6,239,245
2013,2,6,2,21,4,182,186
2013,2,6,2,22,9,108,117
2013,2,6,2,23,0,60,60
2013,2,7,3,0,0,16,16
2013,2,7,3,1,0,4,4
2013,2,7,3,2,1,3,4
2013,2,7,3,3,0,5,5
2013,2,7,3,4,0,5,5
2013,2,7,3,5,2,25,27
2013,2,7,3,6,1,114,115
2013,2,7,3,7,3,316,319
2013,2,7,3,8,14,618,632
2013,2,7,3,9,11,254,265
2013,2,7,3,10,13,131,144
2013,2,7,3,11,22,127,149
2013,2,7,3,12,18,166,184
2013,2,7,3,13,17,168,185
2013,2,7,3,14,6,127,133
2013,2,7,3,15,14,152,166
2013,2,7,3,16,10,236,246
2013,2,7,3,17,16,528,544
2013,2,7,3,18,10,470,480
2013,2,7,3,19,3,312,315
2013,2,7,3,20,5,238,243
2013,2,7,3,21,6,145,151
2013,2,7,3,22,0,90,90
2013,2,7,3,23,3,63,66
2013,2,8,4,0,0,33,33
2013,2,8,4,1,0,18,18
2013,2,8,4,2,0,7,7
2013,2,8,4,3,0,2,2
2013,2,8,4,4,0,5,5
2013,2,8,4,5,2,19,21
2013,2,8,4,6,1,48,49
2013,2,8,4,7,2,90,92
2013,2,8,4,8,3,243,246
2013,2,8,4,9,5,206,211
2013,2,8,4,10,8,120,128
2013,2,8,4,11,11,113,124
2013,2,8,4,12,12,148,160
2013,2,8,4,13,7,145,152
2013,2,8,4,14,16,159,175
2013,2,8,4,15,11,156,167
2013,2,8,4,16,9,207,216
2013,2,8,4,17,16,458,474
2013,2,8,4,18,9,359,368
2013,2,8,4,19,10,251,261
2013,2,8,4,20,8,180,188
2013,2,8,4,21,5,130,135
2013,2,8,4,22,5,75,80
2013,2,8,4,23,6,72,78
2013,2,9,5,0,1,57,58
2013,2,9,5,1,1,47,48
2013,2,9,5,2,0,40,40
2013,2,9,5,3,2,8,10
2013,2,9,5,4,0,4,4
2013,2,9,5,6,0,8,8
2013,2,9,5,7,1,35,36
2013,2,9,5,8,3,70,73
2013,2,9,5,9,11,140,151
2013,2,9,5,10,24,170,194
2013,2,9,5,11,28,258,286
2013,2,9,5,12,42,236,278
2013,2,9,5,13,56,261,317
2013,2,9,5,14,56,231,287
2013,2,9,5,15,51,235,286
2013,2,9,5,16,49,257,306
2013,2,9,5,17,44,234,278
2013,2,9,5,18,20,224,244
2013,2,9,5,19,8,140,148
2013,2,9,5,20,10,125,135
2013,2,9,5,21,10,97,107
2013,2,9,5,22,3,74,77
2013,2,9,5,23,5,90,95
2013,2,10,6,0,8,66,74
2013,2,10,6,1,5,51,56
2013,2,10,6,2,2,46,48
2013,2,10,6,3,1,25,26
2013,2,10,6,4,0,6,6
2013,2,10,6,5,1,2,3
2013,2,10,6,6,3,12,15
2013,2,10,6,7,1,22,23
2013,2,10,6,8,2,63,65
2013,2,10,6,9,17,106,123
2013,2,10,6,10,20,209,229
2013,2,10,6,11,35,245,280
2013,2,10,6,12,47,277,324
2013,2,10,6,13,60,268,328
2013,2,10,6,14,75,290,365
2013,2,10,6,15,74,281,355
2013,2,10,6,16,61,273,334
2013,2,10,6,17,43,244,287
2013,2,10,6,18,14,200,214
2013,2,10,6,19,15,143,158
2013,2,10,6,20,5,93,98
2013,2,10,6,21,10,99,109
2013,2,10,6,22,0,54,54
2013,2,10,6,23,2,37,39
2013,2,11,0,0,0,13,13
2013,2,11,0,1,0,9,9
2013,2,11,0,2,1,5,6
2013,2,11,0,3,0,2,2
2013,2,11,0,4,0,1,1
2013,2,11,0,5,0,14,14
2013,2,11,0,6,1,40,41
2013,2,11,0,7,3,191,194
2013,2,11,0,8,5,453,458
2013,2,11,0,9,9,254,263
2013,2,11,0,10,3,116,119
2013,2,11,0,11,10,100,110
2013,2,11,0,12,12,139,151
2013,2,11,0,13,11,137,148
2013,2,11,0,14,7,152,159
2013,2,11,0,15,22,148,170
2013,2,11,0,16,20,300,320
2013,2,11,0,17,11,536,547
2013,2,11,0,18,18,521,539
2013,2,11,0,19,4,384,388
2013,2,11,0,20,5,234,239
2013,2,11,0,21,9,197,206
2013,2,11,0,22,0,119,119
2013,2,11,0,23,0,52,52
2013,2,12,1,0,0,21,21
2013,2,12,1,1,0,5,5
2013,2,12,1,2,1,3,4
2013,2,12,1,3,2,0,2
2013,2,12,1,4,1,5,6
2013,2,12,1,5,0,37,37
2013,2,12,1,6,0,146,146
2013,2,12,1,7,4,407,411
2013,2,12,1,8,13,665,678
2013,2,12,1,9,11,276,287
2013,2,12,1,10,12,133,145
2013,2,12,1,11,15,156,171
2013,2,12,1,12,14,231,245
2013,2,12,1,13,13,220,233
2013,2,12,1,14,22,166,188
2013,2,12,1,15,31,227,258
2013,2,12,1,16,37,346,383
2013,2,12,1,17,37,650,687
2013,2,12,1,18,19,617,636
2013,2,12,1,19,19,379,398
2013,2,12,1,20,10,303,313
2013,2,12,1,21,5,174,179
2013,2,12,1,22,6,128,134
2013,2,12,1,23,9,104,113
2013,2,13,2,0,1,24,25
2013,2,13,2,1,1,17,18
2013,2,13,2,2,0,6,6
2013,2,13,2,3,0,4,4
2013,2,13,2,4,1,7,8
2013,2,13,2,5,1,38,39
2013,2,13,2,6,0,120,120
2013,2,13,2,7,5,357,362
2013,2,13,2,8,15,742,757
2013,2,13,2,9,11,328,339
2013,2,13,2,10,15,135,150
2013,2,13,2,11,3,148,151
2013,2,13,2,12,30,200,230
2013,2,13,2,13,31,170,201
2013,2,13,2,14,16,151,167
2013,2,13,2,15,14,140,154
2013,2,13,2,16,9,145,154
2013,2,13,2,17,6,168,174
2013,2,13,2,18,5,154,159
2013,2,13,2,19,2,108,110
2013,2,13,2,20,0,74,74
2013,2,13,2,21,3,60,63
2013,2,13,2,22,1,54,55
2013,2,13,2,23,1,35,36
2013,2,14,3,0,0,15,15
2013,2,14,3,1,1,15,16
2013,2,14,3,2,0,4,4
2013,2,14,3,3,0,2,2
2013,2,14,3,4,0,3,3
2013,2,14,3,5,2,31,33
2013,2,14,3,6,1,102,103
2013,2,14,3,7,4,342,346
2013,2,14,3,8,8,590,598
2013,2,14,3,9,22,270,292
2013,2,14,3,10,21,136,157
2013,2,14,3,11,20,149,169
2013,2,14,3,12,36,216,252
2013,2,14,3,13,58,228,286
2013,2,14,3,14,30,213,243
2013,2,14,3,15,18,234,252
2013,2,14,3,16,32,354,386
2013,2,14,3,17,44,610,654
2013,2,14,3,18,30,511,541
2013,2,14,3,19,10,333,343
2013,2,14,3,20,3,180,183
2013,2,14,3,21,4,119,123
2013,2,14,3,22,9,100,109
2013,2,14,3,23,2,58,60
2013,2,15,4,0,5,42,47
2013,2,15,4,1,0,13,13
2013,2,15,4,2,2,9,11
2013,2,15,4,3,1,3,4
2013,2,15,4,4,0,6,6
2013,2,15,4,5,1,27,28
2013,2,15,4,6,1,105,106
2013,2,15,4,7,3,305,308
2013,2,15,4,8,18,663,681
2013,2,15,4,9,38,307,345
2013,2,15,4,10,47,159,206
2013,2,15,4,11,72,181,253
2013,2,15,4,12,74,244,318
2013,2,15,4,13,90,264,354
2013,2,15,4,14,67,235,302
2013,2,15,4,15,104,246,350
2013,2,15,4,16,62,367,429
2013,2,15,4,17,38,561,599
2013,2,15,4,18,27,395,422
2013,2,15,4,19,13,259,272
2013,2,15,4,20,9,159,168
2013,2,15,4,21,5,47,52
2013,2,15,4,22,5,40,45
2013,2,15,4,23,1,38,39
2013,2,16,5,0,1,33,34
2013,2,16,5,1,2,22,24
2013,2,16,5,2,3,27,30
2013,2,16,5,3,0,11,11
2013,2,16,5,4,0,4,4
2013,2,16,5,5,0,6,6
2013,2,16,5,6,1,19,20
2013,2,16,5,7,0,31,31
2013,2,16,5,8,4,80,84
2013,2,16,5,9,24,123,147
2013,2,16,5,10,46,189,235
2013,2,16,5,11,62,190,252
2013,2,16,5,12,72,219,291
2013,2,16,5,13,85,215,300
2013,2,16,5,14,79,192,271
2013,2,16,5,15,82,207,289
2013,2,16,5,16,61,185,246
2013,2,16,5,17,60,184,244
2013,2,16,5,18,27,183,210
2013,2,16,5,19,20,138,158
2013,2,16,5,20,19,92,111
2013,2,16,5,21,13,87,100
2013,2,16,5,22,11,71,82
2013,2,16,5,23,7,52,59
2013,2,17,6,0,6,43,49
2013,2,17,6,1,1,60,61
2013,2,17,6,2,5,40,45
2013,2,17,6,3,3,17,20
2013,2,17,6,4,0,5,5
2013,2,17,6,5,0,6,6
2013,2,17,6,6,4,6,10
2013,2,17,6,7,8,24,32
2013,2,17,6,8,10,51,61
2013,2,17,6,9,22,99,121
2013,2,17,6,10,54,143,197
2013,2,17,6,11,65,180,245
2013,2,17,6,12,68,162,230
2013,2,17,6,13,43,170,213
2013,2,17,6,14,36,180,216
2013,2,17,6,15,30,175,205
2013,2,17,6,16,51,145,196
2013,2,17,6,17,27,121,148
2013,2,17,6,18,21,101,122
2013,2,17,6,19,14,106,120
2013,2,17,6,20,0,62,62
2013,2,17,6,21,4,53,57
2013,2,17,6,22,10,34,44
2013,2,17,6,23,1,42,43
2013,2,18,0,0,0,28,28
2013,2,18,0,1,1,13,14
2013,2,18,0,2,4,10,14
2013,2,18,0,3,0,2,2
2013,2,18,0,4,0,2,2
2013,2,18,0,5,0,8,8
2013,2,18,0,6,0,24,24
2013,2,18,0,7,3,64,67
2013,2,18,0,8,4,120,124
2013,2,18,0,9,25,128,153
2013,2,18,0,10,20,127,147
2013,2,18,0,11,34,156,190
2013,2,18,0,12,57,171,228
2013,2,18,0,13,57,209,266
2013,2,18,0,14,70,236,306
2013,2,18,0,15,65,220,285
2013,2,18,0,16,62,241,303
2013,2,18,0,17,79,300,379
2013,2,18,0,18,27,240,267
2013,2,18,0,19,11,178,189
2013,2,18,0,20,10,137,147
2013,2,18,0,21,2,101,103
2013,2,18,0,22,0,71,71
2013,2,18,0,23,4,40,44
2013,2,19,1,0,2,15,17
2013,2,19,1,1,1,11,12
2013,2,19,1,2,1,4,5
2013,2,19,1,3,1,4,5
2013,2,19,1,4,0,8,8
2013,2,19,1,5,1,33,34
2013,2,19,1,6,0,122,122
2013,2,19,1,7,5,350,355
2013,2,19,1,8,15,591,606
2013,2,19,1,9,8,195,203
2013,2,19,1,10,7,63,70
2013,2,19,1,11,2,31,33
2013,2,19,1,12,3,59,62
2013,2,19,1,13,16,77,93
2013,2,19,1,14,11,92,103
2013,2,19,1,15,21,117,138
2013,2,19,1,16,13,221,234
2013,2,19,1,17,15,474,489
2013,2,19,1,18,11,499,510
2013,2,19,1,19,9,337,346
2013,2,19,1,20,5,202,207
2013,2,19,1,21,8,154,162
2013,2,19,1,22,2,79,81
2013,2,19,1,23,6,59,65
2013,2,20,2,0,4,26,30
2013,2,20,2,1,0,8,8
2013,2,20,2,2,0,4,4
2013,2,20,2,3,0,3,3
2013,2,20,2,4,0,6,6
2013,2,20,2,5,0,28,28
2013,2,20,2,6,1,137,138
2013,2,20,2,7,2,308,310
2013,2,20,2,8,11,648,659
2013,2,20,2,9,20,257,277
2013,2,20,2,10,6,99,105
2013,2,20,2,11,15,126,141
2013,2,20,2,12,15,171,186
2013,2,20,2,13,24,154,178
2013,2,20,2,14,25,120,145
2013,2,20,2,15,18,155,173
2013,2,20,2,16,10,228,238
2013,2,20,2,17,14,481,495
2013,2,20,2,18,4,451,455
2013,2,20,2,19,2,285,287
2013,2,20,2,20,10,204,214
2013,2,20,2,21,4,157,161
2013,2,20,2,22,5,92,97
2013,2,20,2,23,1,44,45
2013,2,21,3,0,0,15,15
2013,2,21,3,1,1,8,9
2013,2,21,3,2,0,3,3
2013,2,21,3,3,0,4,4
2013,2,21,3,4,0,4,4
2013,2,21,3,5,1,27,28
2013,2,21,3,6,3,101,104
2013,2,21,3,7,5,303,308
2013,2,21,3,8,15,545,560
2013,2,21,3,9,17,224,241
2013,2,21,3,10,8,101,109
2013,2,21,3,11,17,97,114
2013,2,21,3,12,13,142,155
2013,2,21,3,13,16,156,172
2013,2,21,3,14,13,109,122
2013,2,21,3,15,15,142,157
2013,2,21,3,16,16,276,292
2013,2,21,3,17,17,462,479
2013,2,21,3,18,13,456,469
2013,2,21,3,19,0,251,251
2013,2,21,3,20,8,211,219
2013,2,21,3,21,5,166,171
2013,2,21,3,22,2,99,101
2013,2,21,3,23,2,58,60
2013,2,22,4,0,4,31,35
2013,2,22,4,1,0,19,19
2013,2,22,4,2,1,10,11
2013,2,22,4,3,0,7,7
2013,2,22,4,4,0,7,7
2013,2,22,4,5,0,29,29
2013,2,22,4,6,0,107,107
2013,2,22,4,7,5,279,284
2013,2,22,4,8,11,570,581
2013,2,22,4,9,6,305,311
2013,2,22,4,10,9,125,134
2013,2,22,4,11,11,136,147
2013,2,22,4,12,6,130,136
2013,2,22,4,13,8,79,87
2013,2,22,4,14,4,99,103
2013,2,22,4,15,13,123,136
2013,2,22,4,16,11,191,202
2013,2,22,4,17,11,336,347
2013,2,22,4,18,7,261,268
2013,2,22,4,19,3,189,192
2013,2,22,4,20,5,132,137
2013,2,22,4,21,4,115,119
2013,2,22,4,22,4,96,100
2013,2,22,4,23,0,63,63
2013,2,23,5,0,5,43,48
2013,2,23,5,1,2,42,44
2013,2,23,5,2,2,29,31
2013,2,23,5,3,2,10,12
2013,2,23,5,4,0,6,6
2013,2,23,5,5,0,1,1
2013,2,23,5,6,1,6,7
2013,2,23,5,7,3,32,35
2013,2,23,5,8,3,62,65
2013,2,23,5,9,5,89,94
2013,2,23,5,10,7,108,115
2013,2,23,5,11,12,99,111
2013,2,23,5,12,13,114,127
2013,2,23,5,13,14,138,152
2013,2,23,5,14,10,161,171
2013,2,23,5,15,37,210,247
2013,2,23,5,16,31,215,246
2013,2,23,5,17,13,230,243
2013,2,23,5,18,13,184,197
2013,2,23,5,19,6,171,177
2013,2,23,5,20,14,121,135
2013,2,23,5,21,10,105,115
2013,2,23,5,22,4,108,112
2013,2,23,5,23,4,80,84
2013,2,24,6,0,7,78,85
2013,2,24,6,1,0,80,80
2013,2,24,6,2,7,59,66
2013,2,24,6,3,7,22,29
2013,2,24,6,4,2,6,8
2013,2,24,6,5,1,6,7
2013,2,24,6,6,0,11,11
2013,2,24,6,7,1,36,37
2013,2,24,6,8,5,75,80
2013,2,24,6,9,22,132,154
2013,2,24,6,10,58,212,270
2013,2,24,6,11,53,246,299
2013,2,24,6,12,88,338,426
2013,2,24,6,13,134,338,472
2013,2,24,6,14,126,370,496
2013,2,24,6,15,137,362,499
2013,2,24,6,16,90,321,411
2013,2,24,6,17,56,276,332
2013,2,24,6,18,27,173,200
2013,2,24,6,19,16,141,157
2013,2,24,6,20,5,98,103
2013,2,24,6,21,1,56,57
2013,2,24,6,22,1,69,70
2013,2,24,6,23,4,25,29
2013,2,25,0,0,3,54,57
2013,2,25,0,1,0,8,8
2013,2,25,0,2,0,2,2
2013,2,25,0,4,0,5,5
2013,2,25,0,5,1,26,27
2013,2,25,0,6,0,109,109
2013,2,25,0,7,5,311,316
2013,2,25,0,8,9,608,617
2013,2,25,0,9,17,295,312
2013,2,25,0,10,21,112,133
2013,2,25,0,11,18,109,127
2013,2,25,0,12,26,165,191
2013,2,25,0,13,44,153,197
2013,2,25,0,14,28,178,206
2013,2,25,0,15,32,209,241
2013,2,25,0,16,26,307,333
2013,2,25,0,17,36,603,639
2013,2,25,0,18,15,517,532
2013,2,25,0,19,22,357,379
2013,2,25,0,20,7,247,254
2013,2,25,0,21,11,158,169
2013,2,25,0,22,7,94,101
2013,2,25,0,23,5,42,47
2013,2,26,1,0,1,16,17
2013,2,26,1,1,0,10,10
2013,2,26,1,2,1,2,3
2013,2,26,1,3,0,8,8
2013,2,26,1,4,0,4,4
2013,2,26,1,5,2,31,33
2013,2,26,1,6,3,130,133
2013,2,26,1,7,3,413,416
2013,2,26,1,8,23,623,646
2013,2,26,1,9,22,285,307
2013,2,26,1,10,9,121,130
2013,2,26,1,11,18,82,100
2013,2,26,1,12,8,66,74
2013,2,26,1,13,7,56,63
2013,2,26,1,14,6,37,43
2013,2,26,1,15,11,30,41
2013,2,26,1,16,9,74,83
2013,2,26,1,17,10,258,268
2013,2,26,1,18,8,137,145
2013,2,26,1,19,0,111,111
2013,2,26,1,20,2,49,51
2013,2,26,1,21,4,45,49
2013,2,26,1,22,0,27,27
2013,2,26,1,23,2,20,22
2013,2,27,2,0,0,11,11
2013,2,27,2,1,0,7,7
2013,2,27,2,2,0,4,4
2013,2,27,2,3,0,2,2
2013,2,27,2,4,0,4,4
2013,2,27,2,5,0,36,36
2013,2,27,2,6,2,112,114
2013,2,27,2,7,5,333,338
2013,2,27,2,8,12,632,644
2013,2,27,2,9,21,296,317
2013,2,27,2,10,26,144,170
2013,2,27,2,11,14,153,167
2013,2,27,2,12,30,211,241
2013,2,27,2,13,31,191,222
2013,2,27,2,14,40,168,208
2013,2,27,2,15,29,186,215
2013,2,27,2,16,22,335,357
2013,2,27,2,17,48,609,657
2013,2,27,2,18,25,571,596
2013,2,27,2,19,12,367,379
2013,2,27,2,20,18,286,304
2013,2,27,2,21,13,223,236
2013,2,27,2,22,7,136,143
2013,2,27,2,23,8,60,68
2013,2,28,3,0,0,31,31
2013,2,28,3,1,2,21,23
2013,2,28,3,2,0,10,10
2013,2,28,3,4,0,3,3
2013,2,28,3,5,1,29,30
2013,2,28,3,6,2,128,130
2013,2,28,3,7,8,350,358
2013,2,28,3,8,16,695,711
2013,2,28,3,9,19,301,320
2013,2,28,3,10,25,143,168
2013,2,28,3,11,28,171,199
2013,2,28,3,12,27,206,233
2013,2,28,3,13,20,182,202
2013,2,28,3,14,22,150,172
2013,2,28,3,15,18,181,199
2013,2,28,3,16,21,258,279
2013,2,28,3,17,26,515,541
2013,2,28,3,18,26,526,552
2013,2,28,3,19,13,320,333
2013,2,28,3,20,13,226,239
2013,2,28,3,21,5,184,189
2013,2,28,3,22,2,132,134
2013,2,28,3,23,3,69,72
2013,3,1,4,0,0,29,29
2013,3,1,4,1,1,22,23
2013,3,1,4,2,2,10,12
2013,3,1,4,3,0,7,7
2013,3,1,4,4,2,9,11
2013,3,1,4,5,1,31,32
2013,3,1,4,6,1,125,126
2013,3,1,4,7,4,336,340
2013,3,1,4,8,21,672,693
2013,3,1,4,9,19,302,321
2013,3,1,4,10,21,157,178
2013,3,1,4,11,30,176,206
2013,3,1,4,12,27,200,227
2013,3,1,4,13,23,180,203
2013,3,1,4,14,26,159,185
2013,3,1,4,15,30,203,233
2013,3,1,4,16,24,309,333
2013,3,1,4,17,38,513,551
2013,3,1,4,18,24,411,435
2013,3,1,4,19,10,280,290
2013,3,1,4,20,5,172,177
2013,3,1,4,21,14,120,134
2013,3,1,4,22,3,114,117
2013,3,1,4,23,3,75,78
2013,3,2,5,0,6,60,66
2013,3,2,5,1,7,53,60
2013,3,2,5,2,2,46,48
2013,3,2,5,3,3,19,22
2013,3,2,5,4,2,7,9
2013,3,2,5,5,0,3,3
2013,3,2,5,6,1,13,14
2013,3,2,5,7,5,49,54
2013,3,2,5,8,10,110,120
2013,3,2,5,9,17,158,175
2013,3,2,5,10,30,205,235
2013,3,2,5,11,61,206,267
2013,3,2,5,12,50,299,349
2013,3,2,5,13,47,262,309
2013,3,2,5,14,84,207,291
2013,3,2,5,15,71,241,312
2013,3,2,5,16,73,180,253
2013,3,2,5,17,62,211,273
2013,3,2,5,18,63,191,254
2013,3,2,5,19,26,150,176
2013,3,2,5,20,16,120,136
2013,3,2,5,21,17,108,125
2013,3,2,5,22,18,83,101
2013,3,2,5,23,3,86,89
2013,3,3,6,0,1,54,55
2013,3,3,6,1,4,51,55
2013,3,3,6,2,4,34,38
2013,3,3,6,3,2,22,24
2013,3,3,6,4,2,8,10
2013,3,3,6,5,1,3,4
2013,3,3,6,6,0,11,11
2013,3,3,6,7,3,26,29
2013,3,3,6,8,7,64,71
2013,3,3,6,9,18,103,121
2013,3,3,6,10,39,155,194
2013,3,3,6,11,38,212,250
2013,3,3,6,12,54,216,270
2013,3,3,6,13,52,205,257
2013,3,3,6,14,37,222,259
2013,3,3,6,15,50,231,281
2013,3,3,6,16,45,233,278
2013,3,3,6,17,38,208,246
2013,3,3,6,18,35,193,228
2013,3,3,6,19,12,122,134
2013,3,3,6,20,9,91,100
2013,3,3,6,21,14,80,94
2013,3,3,6,22,4,54,58
2013,3,3,6,23,6,22,28
2013,3,4,0,0,2,7,9
2013,3,4,0,1,0,6,6
2013,3,4,0,2,0,4,4
2013,3,4,0,3,0,1,1
2013,3,4,0,4,0,5,5
2013,3,4,0,5,0,31,31
2013,3,4,0,6,1,99,100
2013,3,4,0,7,7,301,308
2013,3,4,0,8,18,550,568
2013,3,4,0,9,19,232,251
2013,3,4,0,10,17,113,130
2013,3,4,0,11,37,113,150
2013,3,4,0,12,27,152,179
2013,3,4,0,13,25,132,157
2013,3,4,0,14,21,121,142
2013,3,4,0,15,31,147,178
2013,3,4,0,16,25,291,316
2013,3,4,0,17,26,526,552
2013,3,4,0,18,8,465,473
2013,3,4,0,19,7,343,350
2013,3,4,0,20,7,225,232
2013,3,4,0,21,11,136,147
2013,3,4,0,22,19,94,113
2013,3,4,0,23,3,49,52
2013,3,5,1,0,4,32,36
2013,3,5,1,1,1,10,11
2013,3,5,1,2,0,10,10
2013,3,5,1,3,0,1,1
2013,3,5,1,4,0,4,4
2013,3,5,1,5,1,39,40
2013,3,5,1,6,3,119,122
2013,3,5,1,7,31,366,397
2013,3,5,1,8,30,688,718
2013,3,5,1,9,21,274,295
2013,3,5,1,10,22,134,156
2013,3,5,1,11,18,130,148
2013,3,5,1,12,16,195,211
2013,3,5,1,13,36,180,216
2013,3,5,1,14,42,151,193
2013,3,5,1,15,48,168,216
2013,3,5,1,16,43,297,340
2013,3,5,1,17,38,567,605
2013,3,5,1,18,18,541,559
2013,3,5,1,19,23,325,348
2013,3,5,1,20,11,218,229
2013,3,5,1,21,16,172,188
2013,3,5,1,22,19,102,121
2013,3,5,1,23,3,50,53
2013,3,6,2,0,1,17,18
2013,3,6,2,1,3,7,10
2013,3,6,2,2,1,4,5
2013,3,6,2,3,0,1,1
2013,3,6,2,4,0,3,3
2013,3,6,2,5,0,5,5
2013,3,6,2,6,0,10,10
2013,3,6,2,7,5,33,38
2013,3,6,2,8,4,56,60
2013,3,6,2,9,0,47,47
2013,3,6,2,10,1,32,33
2013,3,6,2,11,2,40,42
2013,3,6,2,12,1,32,33
2013,3,6,2,13,6,40,46
2013,3,6,2,14,1,45,46
2013,3,6,2,15,1,27,28
2013,3,6,2,16,3,48,51
2013,3,6,2,17,4,87,91
2013,3,6,2,18,4,111,115
2013,3,6,2,19,14,116,130
2013,3,6,2,20,15,88,103
2013,3,6,2,21,4,97,101
2013,3,6,2,22,5,66,71
2013,3,6,2,23,4,45,49
2013,3,7,3,0,2,16,18
2013,3,7,3,1,3,8,11
2013,3,7,3,2,2,0,2
2013,3,7,3,3,0,2,2
2013,3,7,3,4,0,6,6
2013,3,7,3,5,0,34,34
2013,3,7,3,6,0,111,111
2013,3,7,3,7,13,327,340
2013,3,7,3,8,21,665,686
2013,3,7,3,9,16,269,285
2013,3,7,3,10,20,143,163
2013,3,7,3,11,23,129,152
2013,3,7,3,12,29,193,222
2013,3,7,3,13,21,169,190
2013,3,7,3,14,27,160,187
2013,3,7,3,15,28,183,211
2013,3,7,3,16,22,283,305
2013,3,7,3,17,20,572,592
2013,3,7,3,18,19,536,555
2013,3,7,3,19,14,328,342
2013,3,7,3,20,15,230,245
2013,3,7,3,21,8,189,197
2013,3,7,3,22,6,123,129
2013,3,7,3,23,6,52,58
2013,3,8,4,0,7,38,45
2013,3,8,4,1,5,20,25
2013,3,8,4,2,4,4,8
2013,3,8,4,3,0,2,2
2013,3,8,4,4,1,6,7
2013,3,8,4,5,1,36,37
2013,3,8,4,6,0,110,110
2013,3,8,4,7,7,334,341
2013,3,8,4,8,9,605,614
2013,3,8,4,9,17,272,289
2013,3,8,4,10,21,121,142
2013,3,8,4,11,26,147,173
2013,3,8,4,12,30,190,220
2013,3,8,4,13,44,171,215
2013,3,8,4,14,41,167,208
2013,3,8,4,15,27,206,233
2013,3,8,4,16,47,304,351
2013,3,8,4,17,35,531,566
2013,3,8,4,18,21,419,440
2013,3,8,4,19,22,281,303
2013,3,8,4,20,5,185,190
2013,3,8,4,21,13,145,158
2013,3,8,4,22,15,90,105
2013,3,8,4,23,13,75,88
2013,3,9,5,0,5,73,78
2013,3,9,5,1,5,62,67
2013,3,9,5,2,4,36,40
2013,3,9,5,3,1,9,10
2013,3,9,5,4,2,4,6
2013,3,9,5,5,1,4,5
2013,3,9,5,6,1,16,17
2013,3,9,5,7,5,49,54
2013,3,9,5,8,15,105,120
2013,3,9,5,9,40,196,236
2013,3,9,5,10,80,286,366
2013,3,9,5,11,151,319,470
2013,3,9,5,12,164,367,531
2013,3,9,5,13,254,378,632
2013,3,9,5,14,300,447,747
2013,3,9,5,15,274,440,714
2013,3,9,5,16,296,439,735
2013,3,9,5,17,247,365,612
2013,3,9,5,18,120,281,401
2013,3,9,5,19,83,215,298
2013,3,9,5,20,42,188,230
2013,3,9,5,21,36,136,172
2013,3,9,5,22,26,133,159
2013,3,9,5,23,16,119,135
2013,3,10,6,0,2,92,94
2013,3,10,6,1,10,76,86
2013,3,10,6,3,11,56,67
2013,3,10,6,4,3,28,31
2013,3,10,6,5,1,4,5
2013,3,10,6,6,1,6,7
2013,3,10,6,7,4,35,39
2013,3,10,6,8,11,87,98
2013,3,10,6,9,36,119,155
2013,3,10,6,10,86,253,339
2013,3,10,6,11,133,307,440
2013,3,10,6,12,193,393,586
2013,3,10,6,13,264,425,689
2013,3,10,6,14,298,441,739
2013,3,10,6,15,314,421,735
2013,3,10,6,16,295,444,739
2013,3,10,6,17,276,410,686
2013,3,10,6,18,161,318,479
2013,3,10,6,19,92,224,316
2013,3,10,6,20,66,142,208
2013,3,10,6,21,44,116,160
2013,3,10,6,22,16,63,79
2013,3,10,6,23,11,41,52
2013,3,11,0,0,4,24,28
2013,3,11,0,1,2,6,8
2013,3,11,0,2,2,6,8
2013,3,11,0,3,0,3,3
2013,3,11,0,4,0,6,6
2013,3,11,0,5,4,32,36
2013,3,11,0,6,4,109,113
2013,3,11,0,7,11,329,340
2013,3,11,0,8,22,611,633
2013,3,11,0,9,39,285,324
2013,3,11,0,10,41,113,154
2013,3,11,0,11,84,115,199
2013,3,11,0,12,95,165,260
2013,3,11,0,13,80,174,254
2013,3,11,0,14,82,146,228
2013,3,11,0,15,120,177,297
2013,3,11,0,16,122,291,413
2013,3,11,0,17,131,687,818
2013,3,11,0,18,65,655,720
2013,3,11,0,19,43,433,476
2013,3,11,0,20,30,289,319
2013,3,11,0,21,26,207,233
2013,3,11,0,22,12,125,137
2013,3,11,0,23,8,72,80
2013,3,12,1,0,2,21,23
2013,3,12,1,1,2,11,13
2013,3,12,1,2,4,6,10
2013,3,12,1,3,0,5,5
2013,3,12,1,4,0,5,5
2013,3,12,1,5,0,15,15
2013,3,12,1,6,0,63,63
2013,3,12,1,7,1,58,59
2013,3,12,1,8,10,261,271
2013,3,12,1,9,20,235,255
2013,3,12,1,10,7,26,33
2013,3,12,1,11,1,22,23
2013,3,12,1,12,11,50,61
2013,3,12,1,13,17,129,146
2013,3,12,1,14,40,141,181
2013,3,12,1,15,62,215,277
2013,3,12,1,16,40,313,353
2013,3,12,1,17,61,648,709
2013,3,12,1,18,39,603,642
2013,3,12,1,19,43,383,426
2013,3,12,1,20,30,254,284
2013,3,12,1,21,30,210,240
2013,3,12,1,22,23,104,127
2013,3,12,1,23,6,62,68
2013,3,13,2,0,3,22,25
2013,3,13,2,1,0,11,11
2013,3,13,2,2,0,4,4
2013,3,13,2,3,0,3,3
2013,3,13,2,4,0,8,8
2013,3,13,2,5,2,31,33
2013,3,13,2,6,0,109,109
2013,3,13,2,7,10,359,369
2013,3,13,2,8,14,704,718
2013,3,13,2,9,19,332,351
2013,3,13,2,10,40,137,177
2013,3,13,2,11,86,148,234
2013,3,13,2,12,51,215,266
2013,3,13,2,13,49,189,238
2013,3,13,2,14,71,176,247
2013,3,13,2,15,61,173,234
2013,3,13,2,16,46,292,338
2013,3,13,2,17,58,610,668
2013,3,13,2,18,41,581,622
2013,3,13,2,19,28,406,434
2013,3,13,2,20,24,241,265
2013,3,13,2,21,6,206,212
2013,3,13,2,22,14,99,113
2013,3,13,2,23,3,60,63
2013,3,14,3,0,3,24,27
2013,3,14,3,1,0,12,12
2013,3,14,3,2,1,6,7
2013,3,14,3,3,0,3,3
2013,3,14,3,4,0,5,5
2013,3,14,3,5,1,37,38
2013,3,14,3,6,2,95,97
2013,3,14,3,7,9,305,314
2013,3,14,3,8,19,601,620
2013,3,14,3,9,7,300,307
2013,3,14,3,10,25,115,140
2013,3,14,3,11,21,144,165
2013,3,14,3,12,43,175,218
2013,3,14,3,13,43,191,234
2013,3,14,3,14,46,163,209
2013,3,14,3,15,47,151,198
2013,3,14,3,16,50,250,300
2013,3,14,3,17,31,491,522
2013,3,14,3,18,34,489,523
2013,3,14,3,19,19,315,334
2013,3,14,3,20,17,237,254
2013,3,14,3,21,10,166,176
2013,3,14,3,22,7,94,101
2013,3,14,3,23,5,72,77
2013,3,15,4,0,5,37,42
2013,3,15,4,1,1,16,17
2013,3,15,4,2,1,8,9
2013,3,15,4,3,0,9,9
2013,3,15,4,4,0,9,9
2013,3,15,4,5,0,35,35
2013,3,15,4,6,1,97,98
2013,3,15,4,7,2,277,279
2013,3,15,4,8,15,599,614
2013,3,15,4,9,18,335,353
2013,3,15,4,10,38,150,188
2013,3,15,4,11,68,162,230
2013,3,15,4,12,64,239,303
2013,3,15,4,13,105,223,328
2013,3,15,4,14,152,201,353
2013,3,15,4,15,165,278,443
2013,3,15,4,16,158,348,506
2013,3,15,4,17,145,601,746
2013,3,15,4,18,108,565,673
2013,3,15,4,19,48,345,393
2013,3,15,4,20,33,236,269
2013,3,15,4,21,34,168,202
2013,3,15,4,22,31,139,170
2013,3,15,4,23,9,106,115
2013,3,16,5,0,19,85,104
2013,3,16,5,1,2,57,59
2013,3,16,5,2,4,60,64
2013,3,16,5,3,5,28,33
2013,3,16,5,4,1,4,5
2013,3,16,5,5,2,23,25
2013,3,16,5,6,16,92,108
2013,3,16,5,7,36,96,132
2013,3,16,5,8,45,169,214
2013,3,16,5,9,75,245,320
2013,3,16,5,10,120,322,442
2013,3,16,5,11,161,362,523
2013,3,16,5,12,182,374,556
2013,3,16,5,13,195,364,559
2013,3,16,5,14,184,336,520
2013,3,16,5,15,217,365,582
2013,3,16,5,16,173,259,432
2013,3,16,5,17,121,191,312
2013,3,16,5,18,84,222,306
2013,3,16,5,19,71,217,288
2013,3,16,5,20,32,166,198
2013,3,16,5,21,23,147,170
2013,3,16,5,22,26,141,167
2013,3,16,5,23,19,109,128
2013,3,17,6,0,12,79,91
2013,3,17,6,1,7,78,85
2013,3,17,6,2,6,66,72
2013,3,17,6,3,1,24,25
2013,3,17,6,4,0,5,5
2013,3,17,6,5,1,6,7
2013,3,17,6,6,5,7,12
2013,3,17,6,7,8,24,32
2013,3,17,6,8,18,66,84
2013,3,17,6,9,51,110,161
2013,3,17,6,10,70,204,274
2013,3,17,6,11,110,283,393
2013,3,17,6,12,111,275,386
2013,3,17,6,13,91,245,336
2013,3,17,6,14,89,224,313
2013,3,17,6,15,104,229,333
2013,3,17,6,16,74,257,331
2013,3,17,6,17,85,216,301
2013,3,17,6,18,42,172,214
2013,3,17,6,19,29,140,169
2013,3,17,6,20,39,100,139
2013,3,17,6,21,17,86,103
2013,3,17,6,22,9,73,82
2013,3,17,6,23,3,33,36
2013,3,18,0,0,6,20,26
2013,3,18,0,1,2,7,9
2013,3,18,0,2,0,6,6
2013,3,18,0,3,0,4,4
2013,3,18,0,4,0,7,7
2013,3,18,0,5,2,31,33
2013,3,18,0,6,1,95,96
2013,3,18,0,7,6,259,265
2013,3,18,0,8,9,512,521
2013,3,18,0,9,19,221,240
2013,3,18,0,10,22,94,116
2013,3,18,0,11,16,97,113
2013,3,18,0,12,22,155,177
2013,3,18,0,13,35,103,138
2013,3,18,0,14,22,90,112
2013,3,18,0,15,21,90,111
2013,3,18,0,16,18,99,117
2013,3,18,0,17,13,166,179
2013,3,18,0,18,7,122,129
2013,3,18,0,19,6,115,121
2013,3,18,0,20,7,82,89
2013,3,18,0,21,11,72,83
2013,3,18,0,22,2,44,46
2013,3,18,0,23,1,29,30
2013,3,19,1,0,3,19,22
2013,3,19,1,1,0,7,7
2013,3,19,1,2,1,5,6
2013,3,19,1,3,0,2,2
2013,3,19,1,4,0,8,8
2013,3,19,1,5,0,33,33
2013,3,19,1,6,0,103,103
2013,3,19,1,7,4,335,339
2013,3,19,1,8,11,639,650
2013,3,19,1,9,9,312,321
2013,3,19,1,10,22,137,159
2013,3,19,1,11,42,163,205
2013,3,19,1,12,50,208,258
2013,3,19,1,13,49,222,271
2013,3,19,1,14,83,191,274
2013,3,19,1,15,86,190,276
2013,3,19,1,16,88,330,418
2013,3,19,1,17,78,669,747
2013,3,19,1,18,53,697,750
2013,3,19,1,19,28,418,446
2013,3,19,1,20,24,262,286
2013,3,19,1,21,16,205,221
2013,3,19,1,22,14,117,131
2013,3,19,1,23,13,55,68
2013,3,20,2,0,0,16,16
2013,3,20,2,1,0,6,6
2013,3,20,2,2,0,5,5
2013,3,20,2,3,0,3,3
2013,3,20,2,4,0,4,4
2013,3,20,2,5,1,34,35
2013,3,20,2,6,5,134,139
2013,3,20,2,7,9,369,378
2013,3,20,2,8,19,723,742
2013,3,20,2,9,20,326,346
2013,3,20,2,10,39,150,189
2013,3,20,2,11,35,162,197
2013,3,20,2,12,41,230,271
2013,3,20,2,13,54,187,241
2013,3,20,2,14,49,189,238
2013,3,20,2,15,43,180,223
2013,3,20,2,16,73,298,371
2013,3,20,2,17,52,639,691
2013,3,20,2,18,40,580,620
2013,3,20,2,19,22,400,422
2013,3,20,2,20,21,270,291
2013,3,20,2,21,23,229,252
2013,3,20,2,22,8,129,137
2013,3,20,2,23,2,68,70
2013,3,21,3,0,0,32,32
2013,3,21,3,1,1,13,14
2013,3,21,3,2,1,6,7
2013,3,21,3,3,0,2,2
2013,3,21,3,4,0,8,8
2013,3,21,3,5,0,23,23
2013,3,21,3,6,1,88,89
2013,3,21,3,7,8,300,308
2013,3,21,3,8,15,618,633
2013,3,21,3,9,19,306,325
2013,3,21,3,10,20,146,166
2013,3,21,3,11,36,142,178
2013,3,21,3,12,21,138,159
2013,3,21,3,13,36,184,220
2013,3,21,3,14,13,114,127
2013,3,21,3,15,29,154,183
2013,3,21,3,16,25,232,257
2013,3,21,3,17,29,486,515
2013,3,21,3,18,18,437,455
2013,3,21,3,19,19,285,304
2013,3,21,3,20,12,200,212
2013,3,21,3,21,2,160,162
2013,3,21,3,22,2,112,114
2013,3,21,3,23,1,47,48
2013,3,22,4,0,4,32,36
2013,3,22,4,1,0,13,13
2013,3,22,4,2,3,7,10
2013,3,22,4,3,0,3,3
2013,3,22,4,4,0,8,8
2013,3,22,4,5,0,26,26
2013,3,22,4,6,2,97,99
2013,3,22,4,7,4,244,248
2013,3,22,4,8,26,608,634
2013,3,22,4,9,11,315,326
2013,3,22,4,10,30,144,174
2013,3,22,4,11,49,148,197
2013,3,22,4,12,52,212,264
2013,3,22,4,13,54,200,254
2013,3,22,4,14,63,189,252
2013,3,22,4,15,86,214,300
2013,3,22,4,16,65,329,394
2013,3,22,4,17,74,612,686
2013,3,22,4,18,58,475,533
2013,3,22,4,19,47,341,388
2013,3,22,4,20,20,210,230
2013,3,22,4,21,15,158,173
2013,3,22,4,22,11,108,119
2013,3,22,4,23,8,77,85
2013,3,23,5,0,4,70,74
2013,3,23,5,1,4,57,61
2013,3,23,5,2,7,39,46
2013,3,23,5,3,0,9,9
2013,3,23,5,4,1,7,8
2013,3,23,5,5,0,8,8
2013,3,23,5,6,3,18,21
2013,3,23,5,7,7,58,65
2013,3,23,5,8,14,106,120
2013,3,23,5,9,45,175,220
2013,3,23,5,10,67,244,311
2013,3,23,5,11,160,280,440
2013,3,23,5,12,198,338,536
2013,3,23,5,13,287,332,619
2013,3,23,5,14,308,319,627
2013,3,23,5,15,364,363,727
2013,3,23,5,16,326,314,640
2013,3,23,5,17,263,313,576
2013,3,23,5,18,184,296,480
2013,3,23,5,19,105,231,336
2013,3,23,5,20,48,156,204
2013,3,23,5,21,27,134,161
2013,3,23,5,22,39,113,152
2013,3,23,5,23,12,90,102
2013,3,24,6,0,6,79,85
2013,3,24,6,1,4,63,67
2013,3,24,6,2,1,48,49
2013,3,24,6,3,1,26,27
2013,3,24,6,4,5,6,11
2013,3,24,6,5,1,2,3
2013,3,24,6,6,2,7,9
2013,3,24,6,7,2,21,23
2013,3,24,6,8,14,72,86
2013,3,24,6,9,61,108,169
2013,3,24,6,10,72,185,257
2013,3,24,6,11,79,229,308
2013,3,24,6,12,135,296,431
2013,3,24,6,13,157,274,431
2013,3,24,6,14,166,266,432
2013,3,24,6,15,108,207,315
2013,3,24,6,16,130,203,333
2013,3,24,6,17,58,216,274
2013,3,24,6,18,62,176,238
2013,3,24,6,19,26,124,150
2013,3,24,6,20,8,74,82
2013,3,24,6,21,4,43,47
2013,3,24,6,22,5,37,42
2013,3,24,6,23,2,17,19
2013,3,25,0,0,4,16,20
2013,3,25,0,1,0,9,9
2013,3,25,0,2,0,1,1
2013,3,25,0,3,0,2,2
2013,3,25,0,4,0,5,5
2013,3,25,0,5,0,9,9
2013,3,25,0,6,0,29,29
2013,3,25,0,7,2,81,83
2013,3,25,0,8,3,187,190
2013,3,25,0,9,4,130,134
2013,3,25,0,10,4,55,59
2013,3,25,0,11,0,52,52
2013,3,25,0,12,3,47,50
2013,3,25,0,13,12,58,70
2013,3,25,0,14,11,43,54
2013,3,25,0,15,6,74,80
2013,3,25,0,16,4,139,143
2013,3,25,0,17,9,236,245
2013,3,25,0,18,3,205,208
2013,3,25,0,19,10,158,168
2013,3,25,0,20,1,115,116
2013,3,25,0,21,4,92,96
2013,3,25,0,22,4,59,63
2013,3,25,0,23,0,47,47
2013,3,26,1,0,0,12,12
2013,3,26,1,1,0,9,9
2013,3,26,1,2,0,3,3
2013,3,26,1,3,0,3,3
2013,3,26,1,4,0,10,10
2013,3,26,1,5,1,32,33
2013,3,26,1,6,3,95,98
2013,3,26,1,7,3,299,302
2013,3,26,1,8,11,662,673
2013,3,26,1,9,23,331,354
2013,3,26,1,10,50,119,169
2013,3,26,1,11,42,156,198
2013,3,26,1,12,54,206,260
2013,3,26,1,13,67,189,256
2013,3,26,1,14,62,130,192
2013,3,26,1,15,48,167,215
2013,3,26,1,16,65,313,378
2013,3,26,1,17,75,643,718
2013,3,26,1,18,52,585,637
2013,3,26,1,19,52,397,449
2013,3,26,1,20,27,252,279
2013,3,26,1,21,5,176,181
2013,3,26,1,22,4,120,124
2013,3,26,1,23,3,71,74
2013,3,27,2,0,0,46,46
2013,3,27,2,1,0,13,13
2013,3,27,2,2,0,4,4
2013,3,27,2,3,0,8,8
2013,3,27,2,4,0,7,7
2013,3,27,2,5,0,33,33
2013,3,27,2,6,2,112,114
2013,3,27,2,7,6,337,343
2013,3,27,2,8,21,730,751
2013,3,27,2,9,11,312,323
2013,3,27,2,10,47,150,197
2013,3,27,2,11,53,177,230
2013,3,27,2,12,57,213,270
2013,3,27,2,13,44,179,223
2013,3,27,2,14,88,188,276
2013,3,27,2,15,59,163,222
2013,3,27,2,16,44,313,357
2013,3,27,2,17,65,613,678
2013,3,27,2,18,53,625,678
2013,3,27,2,19,39,379,418
2013,3,27,2,20,24,242,266
2013,3,27,2,21,12,190,202
2013,3,27,2,22,17,110,127
2013,3,27,2,23,4,66,70
2013,3,28,3,0,0,36,36
2013,3,28,3,1,2,10,12
2013,3,28,3,2,1,7,8
2013,3,28,3,3,0,2,2
2013,3,28,3,4,0,6,6
2013,3,28,3,5,0,35,35
2013,3,28,3,6,6,90,96
2013,3,28,3,7,6,347,353
2013,3,28,3,8,26,693,719
2013,3,28,3,9,25,341,366
2013,3,28,3,10,43,128,171
2013,3,28,3,11,63,159,222
2013,3,28,3,12,53,201,254
2013,3,28,3,13,59,176,235
2013,3,28,3,14,61,130,191
2013,3,28,3,15,80,176,256
2013,3,28,3,16,54,270,324
2013,3,28,3,17,58,619,677
2013,3,28,3,18,62,531,593
2013,3,28,3,19,39,330,369
2013,3,28,3,20,30,250,280
2013,3,28,3,21,8,197,205
2013,3,28,3,22,16,126,142
2013,3,28,3,23,7,81,88
2013,3,29,4,0,7,81,88
2013,3,29,4,1,3,20,23
2013,3,29,4,2,2,18,20
2013,3,29,4,3,0,5,5
2013,3,29,4,4,0,7,7
2013,3,29,4,5,0,31,31
2013,3,29,4,6,4,90,94
2013,3,29,4,7,11,267,278
2013,3,29,4,8,20,605,625
2013,3,29,4,9,51,375,426
2013,3,29,4,10,94,192,286
2013,3,29,4,11,113,227,340
2013,3,29,4,12,203,324,527
2013,3,29,4,13,173,297,470
2013,3,29,4,14,182,258,440
2013,3,29,4,15,239,293,532
2013,3,29,4,16,206,388,594
2013,3,29,4,17,195,599,794
2013,3,29,4,18,149,446,595
2013,3,29,4,19,108,360,468
2013,3,29,4,20,84,238,322
2013,3,29,4,21,75,153,228
2013,3,29,4,22,30,137,167
2013,3,29,4,23,20,63,83
2013,3,30,5,0,20,86,106
2013,3,30,5,1,9,58,67
2013,3,30,5,2,10,45,55
2013,3,30,5,3,5,16,21
2013,3,30,5,4,0,3,3
2013,3,30,5,5,1,4,5
2013,3,30,5,6,3,16,19
2013,3,30,5,7,7,48,55
2013,3,30,5,8,28,115,143
2013,3,30,5,9,93,180,273
2013,3,30,5,10,279,255,534
2013,3,30,5,11,399,373,772
2013,3,30,5,12,490,403,893
2013,3,30,5,13,549,460,1009
2013,3,30,5,14,549,376,925
2013,3,30,5,15,565,393,958
2013,3,30,5,16,498,394,892
2013,3,30,5,17,472,350,822
2013,3,30,5,18,367,321,688
2013,3,30,5,19,284,248,532
2013,3,30,5,20,173,140,313
2013,3,30,5,21,77,137,214
2013,3,30,5,22,80,132,212
2013,3,30,5,23,50,103,153
2013,3,31,6,0,27,86,113
2013,3,31,6,1,20,58,78
2013,3,31,6,2,14,49,63
2013,3,31,6,3,10,29,39
2013,3,31,6,4,8,8,16
2013,3,31,6,5,6,6,12
2013,3,31,6,6,12,14,26
2013,3,31,6,7,16,34,50
2013,3,31,6,8,41,96,137
2013,3,31,6,9,85,129,214
2013,3,31,6,10,147,206,353
2013,3,31,6,11,178,268,446
2013,3,31,6,12,191,173,364
2013,3,31,6,13,86,164,250
2013,3,31,6,14,97,102,199
2013,3,31,6,15,64,124,188
2013,3,31,6,16,89,144,233
2013,3,31,6,17,74,148,222
2013,3,31,6,18,64,119,183
2013,3,31,6,19,73,142,215
2013,3,31,6,20,34,121,155
2013,3,31,6,21,29,80,109
2013,3,31,6,22,27,79,106
2013,3,31,6,23,9,41,50
2013,4,1,0,0,3,17,20
2013,4,1,0,1,2,4,6
2013,4,1,0,2,0,9,9
2013,4,1,0,3,0,4,4
2013,4,1,0,4,2,12,14
2013,4,1,0,5,2,33,35
2013,4,1,0,6,7,116,123
2013,4,1,0,7,16,326,342
2013,4,1,0,8,25,652,677
2013,4,1,0,9,59,306,365
2013,4,1,0,10,106,159,265
2013,4,1,0,11,161,203,364
2013,4,1,0,12,160,240,400
2013,4,1,0,13,143,222,365
2013,4,1,0,14,129,172,301
2013,4,1,0,15,109,245,354
2013,4,1,0,16,101,339,440
2013,4,1,0,17,83,653,736
2013,4,1,0,18,56,536,592
2013,4,1,0,19,42,391,433
2013,4,1,0,20,46,197,243
2013,4,1,0,21,31,143,174
2013,4,1,0,22,15,85,100
2013,4,1,0,23,6,52,58
2013,4,2,1,0,1,20,21
2013,4,2,1,1,0,7,7
2013,4,2,1,2,0,5,5
2013,4,2,1,3,0,3,3
2013,4,2,1,4,1,3,4
2013,4,2,1,5,1,26,27
2013,4,2,1,6,3,113,116
2013,4,2,1,7,9,364,373
2013,4,2,1,8,22,700,722
2013,4,2,1,9,27,328,355
2013,4,2,1,10,56,138,194
2013,4,2,1,11,83,148,231
2013,4,2,1,12,56,204,260
2013,4,2,1,13,60,211,271
2013,4,2,1,14,74,182,256
2013,4,2,1,15,57,167,224
2013,4,2,1,16,95,337,432
2013,4,2,1,17,61,657,718
2013,4,2,1,18,58,574,632
2013,4,2,1,19,35,400,435
2013,4,2,1,20,20,278,298
2013,4,2,1,21,9,193,202
2013,4,2,1,22,7,106,113
2013,4,2,1,23,3,44,47
2013,4,3,2,0,1,25,26
2013,4,3,2,1,1,18,19
2013,4,3,2,2,0,3,3
2013,4,3,2,3,0,2,2
2013,4,3,2,4,0,4,4
2013,4,3,2,5,0,39,39
2013,4,3,2,6,2,136,138
2013,4,3,2,7,16,339,355
2013,4,3,2,8,29,737,766
2013,4,3,2,9,39,309,348
2013,4,3,2,10,61,148,209
2013,4,3,2,11,62,157,219
2013,4,3,2,12,64,230,294
2013,4,3,2,13,107,220,327
2013,4,3,2,14,74,178,252
2013,4,3,2,15,111,185,296
2013,4,3,2,16,113,353,466
2013,4,3,2,17,108,676,784
2013,4,3,2,18,50,595,645
2013,4,3,2,19,46,407,453
2013,4,3,2,20,15,209,224
2013,4,3,2,21,18,191,209
2013,4,3,2,22,11,126,137
2013,4,3,2,23,1,71,72
2013,4,4,3,0,3,22,25
2013,4,4,3,1,1,18,19
2013,4,4,3,2,2,2,4
2013,4,4,3,3,0,4,4
2013,4,4,3,4,1,7,8
2013,4,4,3,5,1,24,25
2013,4,4,3,6,2,97,99
2013,4,4,3,7,20,328,348
2013,4,4,3,8,23,664,687
2013,4,4,3,9,38,316,354
2013,4,4,3,10,73,140,213
2013,4,4,3,11,67,151,218
2013,4,4,3,12,81,216,297
2013,4,4,3,13,95,198,293
2013,4,4,3,14,133,189,322
2013,4,4,3,15,91,191,282
2013,4,4,3,16,56,307,363
2013,4,4,3,17,92,583,675
2013,4,4,3,18,63,613,676
2013,4,4,3,19,30,377,407
2013,4,4,3,20,13,236,249
2013,4,4,3,21,13,193,206
2013,4,4,3,22,3,61,64
2013,4,4,3,23,3,31,34
2013,4,5,4,0,0,21,21
2013,4,5,4,1,1,9,10
2013,4,5,4,2,0,8,8
2013,4,5,4,3,0,1,1
2013,4,5,4,4,1,7,8
2013,4,5,4,5,3,18,21
2013,4,5,4,6,5,83,88
2013,4,5,4,7,5,226,231
2013,4,5,4,8,11,696,707
2013,4,5,4,9,31,378,409
2013,4,5,4,10,50,182,232
2013,4,5,4,11,110,220,330
2013,4,5,4,12,131,322,453
2013,4,5,4,13,147,262,409
2013,4,5,4,14,187,261,448
2013,4,5,4,15,161,271,432
2013,4,5,4,16,165,487,652
2013,4,5,4,17,162,725,887
2013,4,5,4,18,139,660,799
2013,4,5,4,19,83,504,587
2013,4,5,4,20,56,296,352
2013,4,5,4,21,61,216,277
2013,4,5,4,22,30,153,183
2013,4,5,4,23,20,114,134
2013,4,6,5,0,6,91,97
2013,4,6,5,1,14,58,72
2013,4,6,5,2,7,40,47
2013,4,6,5,3,9,12,21
2013,4,6,5,4,2,9,11
2013,4,6,5,5,6,6,12
2013,4,6,5,6,3,23,26
2013,4,6,5,7,34,71,105
2013,4,6,5,8,45,172,217
2013,4,6,5,9,67,233,300
2013,4,6,5,10,186,326,512
2013,4,6,5,11,363,379,742
2013,4,6,5,12,427,507,934
2013,4,6,5,13,496,394,890
2013,4,6,5,14,443,399,842
2013,4,6,5,15,479,483,962
2013,4,6,5,16,493,408,901
2013,4,6,5,17,436,432,868
2013,4,6,5,18,274,401,675
2013,4,6,5,19,144,277,421
2013,4,6,5,20,64,169,233
2013,4,6,5,21,52,149,201
2013,4,6,5,22,32,125,157
2013,4,6,5,23,17,83,100
2013,4,7,6,0,15,80,95
2013,4,7,6,1,9,64,73
2013,4,7,6,2,4,44,48
2013,4,7,6,3,5,20,25
2013,4,7,6,4,2,7,9
2013,4,7,6,5,2,14,16
2013,4,7,6,6,24,124,148
2013,4,7,6,7,23,90,113
2013,4,7,6,8,75,126,201
2013,4,7,6,9,144,241,385
2013,4,7,6,10,242,369,611
2013,4,7,6,11,401,422,823
2013,4,7,6,12,419,420,839
2013,4,7,6,13,490,426,916
2013,4,7,6,14,539,424,963
2013,4,7,6,15,513,484,997
2013,4,7,6,16,464,403,867
2013,4,7,6,17,366,457,823
2013,4,7,6,18,299,359,658
2013,4,7,6,19,211,344,555
2013,4,7,6,20,72,196,268
2013,4,7,6,21,63,147,210
2013,4,7,6,22,36,101,137
2013,4,7,6,23,10,40,50
2013,4,8,0,0,8,28,36
2013,4,8,0,1,4,9,13
2013,4,8,0,2,5,10,15
2013,4,8,0,3,3,7,10
2013,4,8,0,4,4,7,11
2013,4,8,0,5,5,43,48
2013,4,8,0,6,13,157,170
2013,4,8,0,7,35,506,541
2013,4,8,0,8,63,721,784
2013,4,8,0,9,70,320,390
2013,4,8,0,10,124,125,249
2013,4,8,0,11,166,168,334
2013,4,8,0,12,168,242,410
2013,4,8,0,13,140,235,375
2013,4,8,0,14,148,192,340
2013,4,8,0,15,150,250,400
2013,4,8,0,16,155,437,592
2013,4,8,0,17,203,855,1058
2013,4,8,0,18,212,839,1051
2013,4,8,0,19,121,579,700
2013,4,8,0,20,71,392,463
2013,4,8,0,21,32,224,256
2013,4,8,0,22,34,151,185
2013,4,8,0,23,17,102,119
2013,4,9,1,0,8,49,57
2013,4,9,1,1,6,17,23
2013,4,9,1,2,10,5,15
2013,4,9,1,3,4,5,9
2013,4,9,1,4,0,11,11
2013,4,9,1,5,2,43,45
2013,4,9,1,6,13,191,204
2013,4,9,1,7,28,588,616
2013,4,9,1,8,71,779,850
2013,4,9,1,9,68,389,457
2013,4,9,1,10,93,174,267
2013,4,9,1,11,121,240,361
2013,4,9,1,12,144,294,438
2013,4,9,1,13,143,289,432
2013,4,9,1,14,148,225,373
2013,4,9,1,15,171,281,452
2013,4,9,1,16,209,435,644
2013,4,9,1,17,208,926,1134
2013,4,9,1,18,234,912,1146
2013,4,9,1,19,172,663,835
2013,4,9,1,20,109,423,532
2013,4,9,1,21,86,337,423
2013,4,9,1,22,58,263,321
2013,4,9,1,23,32,161,193
2013,4,10,2,0,4,59,63
2013,4,10,2,1,3,20,23
2013,4,10,2,2,7,11,18
2013,4,10,2,3,1,3,4
2013,4,10,2,4,4,11,15
2013,4,10,2,5,4,58,62
2013,4,10,2,6,18,226,244
2013,4,10,2,7,53,587,640
2013,4,10,2,8,56,815,871
2013,4,10,2,9,65,354,419
2013,4,10,2,10,76,158,234
2013,4,10,2,11,111,184,295
2013,4,10,2,12,112,299,411
2013,4,10,2,13,154,255,409
2013,4,10,2,14,140,242,382
2013,4,10,2,15,134,246,380
2013,4,10,2,16,154,433,587
2013,4,10,2,17,208,914,1122
2013,4,10,2,18,210,929,1139
2013,4,10,2,19,206,677,883
2013,4,10,2,20,85,425,510
2013,4,10,2,21,77,348,425
2013,4,10,2,22,51,275,326
2013,4,10,2,23,32,145,177
2013,4,11,3,0,14,51,65
2013,4,11,3,1,2,23,25
2013,4,11,3,2,1,10,11
2013,4,11,3,3,2,4,6
2013,4,11,3,4,0,7,7
2013,4,11,3,5,1,43,44
2013,4,11,3,6,22,197,219
2013,4,11,3,7,46,581,627
2013,4,11,3,8,60,804,864
2013,4,11,3,9,68,363,431
2013,4,11,3,10,107,186,293
2013,4,11,3,11,125,209,334
2013,4,11,3,12,107,283,390
2013,4,11,3,13,137,300,437
2013,4,11,3,14,168,234,402
2013,4,11,3,15,147,246,393
2013,4,11,3,16,135,415,550
2013,4,11,3,17,170,849,1019
2013,4,11,3,18,194,904,1098
2013,4,11,3,19,169,585,754
2013,4,11,3,20,76,360,436
2013,4,11,3,21,56,307,363
2013,4,11,3,22,54,209,263
2013,4,11,3,23,25,110,135
2013,4,12,4,0,10,47,57
2013,4,12,4,1,1,21,22
2013,4,12,4,2,7,11,18
2013,4,12,4,3,0,3,3
2013,4,12,4,4,0,9,9
2013,4,12,4,5,2,22,24
2013,4,12,4,6,4,87,91
2013,4,12,4,7,2,53,55
2013,4,12,4,8,7,121,128
2013,4,12,4,9,8,126,134
2013,4,12,4,10,20,80,100
2013,4,12,4,11,40,138,178
2013,4,12,4,12,56,207,263
2013,4,12,4,13,78,250,328
2013,4,12,4,14,90,240,330
2013,4,12,4,15,131,301,432
2013,4,12,4,16,126,448,574
2013,4,12,4,17,151,782,933
2013,4,12,4,18,141,653,794
2013,4,12,4,19,106,425,531
2013,4,12,4,20,55,292,347
2013,4,12,4,21,58,215,273
2013,4,12,4,22,37,206,243
2013,4,12,4,23,43,154,197
2013,4,13,5,0,31,88,119
2013,4,13,5,1,15,64,79
2013,4,13,5,2,3,43,46
2013,4,13,5,3,3,24,27
2013,4,13,5,4,0,4,4
2013,4,13,5,5,5,9,14
2013,4,13,5,6,11,27,38
2013,4,13,5,7,23,76,99
2013,4,13,5,8,68,182,250
2013,4,13,5,9,180,310,490
2013,4,13,5,10,274,378,652
2013,4,13,5,11,370,498,868
2013,4,13,5,12,497,478,975
2013,4,13,5,13,500,462,962
2013,4,13,5,14,583,466,1049
2013,4,13,5,15,692,449,1141
2013,4,13,5,16,584,435,1019
2013,4,13,5,17,483,448,931
2013,4,13,5,18,372,447,819
2013,4,13,5,19,263,331,594
2013,4,13,5,20,170,244,414
2013,4,13,5,21,131,221,352
2013,4,13,5,22,69,193,262
2013,4,13,5,23,49,116,165
2013,4,14,6,0,57,125,182
2013,4,14,6,1,23,95,118
2013,4,14,6,2,14,73,87
2013,4,14,6,3,10,28,38
2013,4,14,6,4,6,9,15
2013,4,14,6,5,1,6,7
2013,4,14,6,6,14,11,25
2013,4,14,6,7,26,68,94
2013,4,14,6,8,87,124,211
2013,4,14,6,9,189,242,431
2013,4,14,6,10,280,336,616
2013,4,14,6,11,334,390,724
2013,4,14,6,12,441,444,885
2013,4,14,6,13,466,437,903
2013,4,14,6,14,541,378,919
2013,4,14,6,15,536,450,986
2013,4,14,6,16,418,474,892
2013,4,14,6,17,345,439,784
2013,4,14,6,18,199,342,541
2013,4,14,6,19,169,298,467
2013,4,14,6,20,88,216,304
2013,4,14,6,21,59,145,204
2013,4,14,6,22,42,112,154
2013,4,14,6,23,28,80,108
2013,4,15,0,0,9,28,37
2013,4,15,0,1,4,7,11
2013,4,15,0,2,1,4,5
2013,4,15,0,3,2,3,5
2013,4,15,0,4,1,6,7
2013,4,15,0,5,1,42,43
2013,4,15,0,6,11,98,109
2013,4,15,0,7,10,316,326
2013,4,15,0,8,28,651,679
2013,4,15,0,9,53,329,382
2013,4,15,0,10,61,148,209
2013,4,15,0,11,100,163,263
2013,4,15,0,12,102,232,334
2013,4,15,0,13,85,220,305
2013,4,15,0,14,144,195,339
2013,4,15,0,15,118,210,328
2013,4,15,0,16,134,376,510
2013,4,15,0,17,108,762,870
2013,4,15,0,18,85,684,769
2013,4,15,0,19,66,498,564
2013,4,15,0,20,48,291,339
2013,4,15,0,21,67,234,301
2013,4,15,0,22,31,128,159
2013,4,15,0,23,20,65,85
2013,4,16,1,0,2,32,34
2013,4,16,1,1,2,5,7
2013,4,16,1,2,4,5,9
2013,4,16,1,3,0,5,5
2013,4,16,1,4,3,7,10
2013,4,16,1,5,1,34,35
2013,4,16,1,6,3,181,184
2013,4,16,1,7,34,489,523
2013,4,16,1,8,27,759,786
2013,4,16,1,9,51,305,356
2013,4,16,1,10,50,174,224
2013,4,16,1,11,101,172,273
2013,4,16,1,12,106,274,380
2013,4,16,1,13,117,296,413
2013,4,16,1,14,151,219,370
2013,4,16,1,15,143,258,401
2013,4,16,1,16,142,415,557
2013,4,16,1,17,159,823,982
2013,4,16,1,18,140,811,951
2013,4,16,1,19,99,553,652
2013,4,16,1,20,65,362,427
2013,4,16,1,21,50,311,361
2013,4,16,1,22,41,211,252
2013,4,16,1,23,28,95,123
2013,4,17,2,0,1,29,30
2013,4,17,2,1,0,24,24
2013,4,17,2,2,1,11,12
2013,4,17,2,3,3,3,6
2013,4,17,2,4,1,3,4
2013,4,17,2,5,5,55,60
2013,4,17,2,6,10,167,177
2013,4,17,2,7,38,561,599
2013,4,17,2,8,37,834,871
2013,4,17,2,9,58,376,434
2013,4,17,2,10,80,166,246
2013,4,17,2,11,108,197,305
2013,4,17,2,12,87,288,375
2013,4,17,2,13,99,252,351
2013,4,17,2,14,120,221,341
2013,4,17,2,15,114,241,355
2013,4,17,2,16,108,426,534
2013,4,17,2,17,126,902,1028
2013,4,17,2,18,125,855,980
2013,4,17,2,19,102,584,686
2013,4,17,2,20,56,382,438
2013,4,17,2,21,38,296,334
2013,4,17,2,22,30,198,228
2013,4,17,2,23,16,129,145
2013,4,18,3,0,5,48,53
2013,4,18,3,1,2,15,17
2013,4,18,3,2,6,5,11
2013,4,18,3,3,3,7,10
2013,4,18,3,4,0,8,8
2013,4,18,3,5,1,46,47
2013,4,18,3,6,7,162,169
2013,4,18,3,7,27,366,393
2013,4,18,3,8,34,681,715
2013,4,18,3,9,25,265,290
2013,4,18,3,10,47,138,185
2013,4,18,3,11,47,144,191
2013,4,18,3,12,77,221,298
2013,4,18,3,13,91,223,314
2013,4,18,3,14,87,225,312
2013,4,18,3,15,98,260,358
2013,4,18,3,16,109,419,528
2013,4,18,3,17,107,872,979
2013,4,18,3,18,116,826,942
2013,4,18,3,19,106,528,634
2013,4,18,3,20,71,419,490
2013,4,18,3,21,55,316,371
2013,4,18,3,22,50,222,272
2013,4,18,3,23,24,150,174
2013,4,19,4,0,14,73,87
2013,4,19,4,1,1,27,28
2013,4,19,4,2,1,15,16
2013,4,19,4,3,0,10,10
2013,4,19,4,4,0,5,5
2013,4,19,4,5,1,48,49
2013,4,19,4,6,7,117,124
2013,4,19,4,7,15,316,331
2013,4,19,4,8,40,793,833
2013,4,19,4,9,48,402,450
2013,4,19,4,10,71,197,268
2013,4,19,4,11,113,217,330
2013,4,19,4,12,101,302,403
2013,4,19,4,13,107,288,395
2013,4,19,4,14,122,230,352
2013,4,19,4,15,108,291,399
2013,4,19,4,16,118,412,530
2013,4,19,4,17,113,646,759
2013,4,19,4,18,76,488,564
2013,4,19,4,19,8,89,97
2013,4,19,4,20,17,66,83
2013,4,19,4,21,1,22,23
2013,4,19,4,22,1,26,27
2013,4,19,4,23,0,15,15
2013,4,20,5,0,0,49,49
2013,4,20,5,1,4,34,38
2013,4,20,5,2,2,33,35
2013,4,20,5,3,0,11,11
2013,4,20,5,4,1,8,9
2013,4,20,5,5,1,13,14
2013,4,20,5,6,10,23,33
2013,4,20,5,7,20,77,97
2013,4,20,5,8,36,186,222
2013,4,20,5,9,67,240,307
2013,4,20,5,10,190,321,511
2013,4,20,5,11,192,395,587
2013,4,20,5,12,276,439,715
2013,4,20,5,13,336,442,778
2013,4,20,5,14,421,436,857
2013,4,20,5,15,425,495,920
2013,4,20,5,16,349,456,805
2013,4,20,5,17,387,413,800
2013,4,20,5,18,277,393,670
2013,4,20,5,19,170,304,474
2013,4,20,5,20,114,254,368
2013,4,20,5,21,54,195,249
2013,4,20,5,22,50,137,187
2013,4,20,5,23,30,116,146
2013,4,21,6,0,12,97,109
2013,4,21,6,1,19,87,106
2013,4,21,6,2,20,58,78
2013,4,21,6,3,11,29,40
2013,4,21,6,4,3,5,8
2013,4,21,6,5,0,10,10
2013,4,21,6,6,4,13,17
2013,4,21,6,7,5,41,46
2013,4,21,6,8,33,114,147
2013,4,21,6,9,88,183,271
2013,4,21,6,10,165,272,437
2013,4,21,6,11,198,346,544
2013,4,21,6,12,272,394,666
2013,4,21,6,13,240,408,648
2013,4,21,6,14,289,454,743
2013,4,21,6,15,319,449,768
2013,4,21,6,16,265,428,693
2013,4,21,6,17,207,381,588
2013,4,21,6,18,150,356,506
2013,4,21,6,19,98,287,385
2013,4,21,6,20,52,187,239
2013,4,21,6,21,26,126,152
2013,4,21,6,22,23,105,128
2013,4,21,6,23,13,59,72
2013,4,22,0,0,7,23,30
2013,4,22,0,1,2,10,12
2013,4,22,0,2,0,7,7
2013,4,22,0,3,1,2,3
2013,4,22,0,4,0,3,3
2013,4,22,0,5,1,34,35
2013,4,22,0,6,0,130,130
2013,4,22,0,7,13,420,433
2013,4,22,0,8,40,791,831
2013,4,22,0,9,36,301,337
2013,4,22,0,10,62,143,205
2013,4,22,0,11,61,154,215
2013,4,22,0,12,71,230,301
2013,4,22,0,13,78,203,281
2013,4,22,0,14,69,183,252
2013,4,22,0,15,62,218,280
2013,4,22,0,16,45,423,468
2013,4,22,0,17,56,807,863
2013,4,22,0,18,65,792,857
2013,4,22,0,19,38,441,479
2013,4,22,0,20,24,294,318
2013,4,22,0,21,20,210,230
2013,4,22,0,22,19,144,163
2013,4,22,0,23,10,51,61
2013,4,23,1,0,3,20,23
2013,4,23,1,1,0,8,8
2013,4,23,1,2,0,3,3
2013,4,23,1,3,0,4,4
2013,4,23,1,4,0,9,9
2013,4,23,1,5,2,34,36
2013,4,23,1,6,3,142,145
2013,4,23,1,7,13,497,510
2013,4,23,1,8,29,784,813
2013,4,23,1,9,24,312,336
2013,4,23,1,10,35,145,180
2013,4,23,1,11,51,166,217
2013,4,23,1,12,60,231,291
2013,4,23,1,13,53,257,310
2013,4,23,1,14,90,208,298
2013,4,23,1,15,92,229,321
2013,4,23,1,16,69,421,490
2013,4,23,1,17,110,827,937
2013,4,23,1,18,116,826,942
2013,4,23,1,19,84,524,608
2013,4,23,1,20,43,362,405
2013,4,23,1,21,45,269,314
2013,4,23,1,22,21,202,223
2013,4,23,1,23,5,81,86
2013,4,24,2,0,7,42,49
2013,4,24,2,1,2,12,14
2013,4,24,2,2,3,4,7
2013,4,24,2,3,1,6,7
2013,4,24,2,4,1,4,5
2013,4,24,2,5,2,45,47
2013,4,24,2,6,2,166,168
2013,4,24,2,7,25,528,553
2013,4,24,2,8,37,850,887
2013,4,24,2,9,49,381,430
2013,4,24,2,10,86,170,256
2013,4,24,2,11,71,213,284
2013,4,24,2,12,100,293,393
2013,4,24,2,13,110,301,411
2013,4,24,2,14,120,249,369
2013,4,24,2,15,125,249,374
2013,4,24,2,16,120,446,566
2013,4,24,2,17,102,872,974
2013,4,24,2,18,107,818,925
2013,4,24,2,19,82,574,656
2013,4,24,2,20,70,400,470
2013,4,24,2,21,38,271,309
2013,4,24,2,22,38,219,257
2013,4,24,2,23,8,133,141
2013,4,25,3,0,6,40,46
2013,4,25,3,1,1,22,23
2013,4,25,3,2,1,5,6
2013,4,25,3,3,3,6,9
2013,4,25,3,4,3,3,6
2013,4,25,3,5,2,37,39
2013,4,25,3,6,5,155,160
2013,4,25,3,7,20,486,506
2013,4,25,3,8,45,781,826
2013,4,25,3,9,61,320,381
2013,4,25,3,10,67,175,242
2013,4,25,3,11,79,189,268
2013,4,25,3,12,76,305,381
2013,4,25,3,13,78,270,348
2013,4,25,3,14,115,234,349
2013,4,25,3,15,102,290,392
2013,4,25,3,16,96,424,520
2013,4,25,3,17,179,873,1052
2013,4,25,3,18,140,820,960
2013,4,25,3,19,84,535,619
2013,4,25,3,20,66,349,415
2013,4,25,3,21,47,340,387
2013,4,25,3,22,46,204,250
2013,4,25,3,23,28,119,147
2013,4,26,4,0,23,55,78
2013,4,26,4,1,8,34,42
2013,4,26,4,2,8,21,29
2013,4,26,4,3,0,11,11
2013,4,26,4,4,1,10,11
2013,4,26,4,5,3,36,39
2013,4,26,4,6,2,148,150
2013,4,26,4,7,20,464,484
2013,4,26,4,8,36,754,790
2013,4,26,4,9,52,387,439
2013,4,26,4,10,69,168,237
2013,4,26,4,11,107,260,367
2013,4,26,4,12,122,341,463
2013,4,26,4,13,182,345,527
2013,4,26,4,14,162,322,484
2013,4,26,4,15,185,384,569
2013,4,26,4,16,181,522,703
2013,4,26,4,17,180,856,1036
2013,4,26,4,18,143,742,885
2013,4,26,4,19,109,448,557
2013,4,26,4,20,86,287,373
2013,4,26,4,21,81,283,364
2013,4,26,4,22,50,199,249
2013,4,26,4,23,34,153,187
2013,4,27,5,0,20,115,135
2013,4,27,5,1,22,96,118
2013,4,27,5,2,17,53,70
2013,4,27,5,3,10,23,33
2013,4,27,5,4,2,8,10
2013,4,27,5,5,6,2,8
2013,4,27,5,6,19,29,48
2013,4,27,5,7,27,84,111
2013,4,27,5,8,39,172,211
2013,4,27,5,9,151,285,436
2013,4,27,5,10,294,363,657
2013,4,27,5,11,402,422,824
2013,4,27,5,12,459,509,968
2013,4,27,5,13,510,458,968
2013,4,27,5,14,519,425,944
2013,4,27,5,15,483,424,907
2013,4,27,5,16,523,455,978
2013,4,27,5,17,421,399,820
2013,4,27,5,18,351,446,797
2013,4,27,5,19,270,360,630
2013,4,27,5,20,139,259,398
2013,4,27,5,21,115,221,336
2013,4,27,5,22,79,199,278
2013,4,27,5,23,69,150,219
2013,4,28,6,0,38,120,158
2013,4,28,6,1,21,84,105
2013,4,28,6,2,14,82,96
2013,4,28,6,3,6,28,34
2013,4,28,6,4,5,11,16
2013,4,28,6,5,13,10,23
2013,4,28,6,6,63,26,89
2013,4,28,6,7,147,81,228
2013,4,28,6,8,146,199,345
2013,4,28,6,9,158,210,368
2013,4,28,6,10,266,349,615
2013,4,28,6,11,341,363,704
2013,4,28,6,12,441,436,877
2013,4,28,6,13,344,393,737
2013,4,28,6,14,297,375,672
2013,4,28,6,15,152,243,395
2013,4,28,6,16,203,278,481
2013,4,28,6,17,210,343,553
2013,4,28,6,18,158,310,468
2013,4,28,6,19,128,226,354
2013,4,28,6,20,68,147,215
2013,4,28,6,21,67,133,200
2013,4,28,6,22,34,87,121
2013,4,28,6,23,16,51,67
2013,4,29,0,0,7,28,35
2013,4,29,0,1,2,15,17
2013,4,29,0,2,0,6,6
2013,4,29,0,3,0,2,2
2013,4,29,0,4,2,3,5
2013,4,29,0,5,0,20,20
2013,4,29,0,6,1,61,62
2013,4,29,0,7,2,148,150
2013,4,29,0,8,20,216,236
2013,4,29,0,9,27,209,236
2013,4,29,0,10,19,58,77
2013,4,29,0,11,18,47,65
2013,4,29,0,12,16,98,114
2013,4,29,0,13,20,102,122
2013,4,29,0,14,28,92,120
2013,4,29,0,15,25,141,166
2013,4,29,0,16,48,280,328
2013,4,29,0,17,59,580,639
2013,4,29,0,18,67,602,669
2013,4,29,0,19,44,459,503
2013,4,29,0,20,26,299,325
2013,4,29,0,21,25,197,222
2013,4,29,0,22,11,115,126
2013,4,29,0,23,13,75,88
2013,4,30,1,0,2,31,33
2013,4,30,1,1,0,6,6
2013,4,30,1,2,0,5,5
2013,4,30,1,3,2,0,2
2013,4,30,1,4,2,5,7
2013,4,30,1,5,2,34,36
2013,4,30,1,6,2,136,138
2013,4,30,1,7,7,303,310
2013,4,30,1,8,34,598,632
2013,4,30,1,9,45,284,329
2013,4,30,1,10,31,115,146
2013,4,30,1,11,36,150,186
2013,4,30,1,12,25,101,126
2013,4,30,1,13,57,106,163
2013,4,30,1,14,47,127,174
2013,4,30,1,15,38,166,204
2013,4,30,1,16,30,237,267
2013,4,30,1,17,61,465,526
2013,4,30,1,18,41,597,638
2013,4,30,1,19,54,469,523
2013,4,30,1,20,37,356,393
2013,4,30,1,21,31,249,280
2013,4,30,1,22,10,189,199
2013,4,30,1,23,10,72,82
2013,5,1,2,0,7,44,51
2013,5,1,2,1,5,20,25
2013,5,1,2,2,0,4,4
2013,5,1,2,3,0,5,5
2013,5,1,2,4,1,8,9
2013,5,1,2,5,4,40,44
2013,5,1,2,6,6,171,177
2013,5,1,2,7,23,558,581
2013,5,1,2,8,31,875,906
2013,5,1,2,9,39,369,408
2013,5,1,2,10,69,181,250
2013,5,1,2,11,84,214,298
2013,5,1,2,12,76,336,412
2013,5,1,2,13,86,275,361
2013,5,1,2,14,74,226,300
2013,5,1,2,15,108,261,369
2013,5,1,2,16,86,422,508
2013,5,1,2,17,123,981,1104
2013,5,1,2,18,133,845,978
2013,5,1,2,19,104,631,735
2013,5,1,2,20,50,404,454
2013,5,1,2,21,48,314,362
2013,5,1,2,22,22,186,208
2013,5,1,2,23,18,124,142
2013,5,2,3,0,6,45,51
2013,5,2,3,1,2,14,16
2013,5,2,3,2,2,10,12
2013,5,2,3,3,0,2,2
2013,5,2,3,4,1,7,8
2013,5,2,3,5,6,40,46
2013,5,2,3,6,10,158,168
2013,5,2,3,7,21,511,532
2013,5,2,3,8,34,759,793
2013,5,2,3,9,41,353,394
2013,5,2,3,10,69,181,250
2013,5,2,3,11,70,232,302
2013,5,2,3,12,106,291,397
2013,5,2,3,13,92,256,348
2013,5,2,3,14,112,228,340
2013,5,2,3,15,115,244,359
2013,5,2,3,16,103,441,544
2013,5,2,3,17,144,985,1129
2013,5,2,3,18,137,858,995
2013,5,2,3,19,87,557,644
2013,5,2,3,20,56,370,426
2013,5,2,3,21,48,312,360
2013,5,2,3,22,44,243,287
2013,5,2,3,23,17,172,189
2013,5,3,4,0,21,60,81
2013,5,3,4,1,3,30,33
2013,5,3,4,2,8,8,16
2013,5,3,4,3,0,6,6
2013,5,3,4,4,2,4,6
2013,5,3,4,5,7,45,52
2013,5,3,4,6,6,161,167
2013,5,3,4,7,26,441,467
2013,5,3,4,8,29,831,860
2013,5,3,4,9,62,385,447
2013,5,3,4,10,78,212,290
2013,5,3,4,11,152,234,386
2013,5,3,4,12,133,312,445
2013,5,3,4,13,127,323,450
2013,5,3,4,14,172,263,435
2013,5,3,4,15,159,311,470
2013,5,3,4,16,166,516,682
2013,5,3,4,17,193,858,1051
2013,5,3,4,18,168,709,877
2013,5,3,4,19,110,440,550
2013,5,3,4,20,53,293,346
2013,5,3,4,21,35,223,258
2013,5,3,4,22,35,175,210
2013,5,3,4,23,29,127,156
2013,5,4,5,0,24,114,138
2013,5,4,5,1,7,81,88
2013,5,4,5,2,7,41,48
2013,5,4,5,3,8,15,23
2013,5,4,5,4,1,3,4
2013,5,4,5,5,3,11,14
2013,5,4,5,6,12,21,33
2013,5,4,5,7,18,89,107
2013,5,4,5,8,44,176,220
2013,5,4,5,9,115,313,428
2013,5,4,5,10,213,371,584
2013,5,4,5,11,230,446,676
2013,5,4,5,12,312,535,847
2013,5,4,5,13,373,505,878
2013,5,4,5,14,362,415,777
2013,5,4,5,15,384,477,861
2013,5,4,5,16,353,468,821
2013,5,4,5,17,384,444,828
2013,5,4,5,18,237,353,590
2013,5,4,5,19,243,332,575
2013,5,4,5,20,117,223,340
2013,5,4,5,21,93,198,291
2013,5,4,5,22,61,166,227
2013,5,4,5,23,50,138,188
2013,5,5,6,0,14,142,156
2013,5,5,6,1,14,90,104
2013,5,5,6,2,4,56,60
2013,5,5,6,3,6,31,37
2013,5,5,6,4,5,7,12
2013,5,5,6,5,4,5,9
2013,5,5,6,6,11,23,34
2013,5,5,6,7,20,48,68
2013,5,5,6,8,47,118,165
2013,5,5,6,9,78,195,273
2013,5,5,6,10,195,298,493
2013,5,5,6,11,212,352,564
2013,5,5,6,12,280,398,678
2013,5,5,6,13,280,438,718
2013,5,5,6,14,359,415,774
2013,5,5,6,15,279,430,709
2013,5,5,6,16,323,446,769
2013,5,5,6,17,241,467,708
2013,5,5,6,18,205,373,578
2013,5,5,6,19,125,291,416
2013,5,5,6,20,89,215,304
2013,5,5,6,21,74,144,218
2013,5,5,6,22,37,104,141
2013,5,5,6,23,32,60,92
2013,5,6,0,0,4,32,36
2013,5,6,0,1,2,17,19
2013,5,6,0,2,0,6,6
2013,5,6,0,3,1,5,6
2013,5,6,0,4,5,6,11
2013,5,6,0,5,5,40,45
2013,5,6,0,6,9,142,151
2013,5,6,0,7,22,446,468
2013,5,6,0,8,37,693,730
2013,5,6,0,9,36,284,320
2013,5,6,0,10,51,121,172
2013,5,6,0,11,72,157,229
2013,5,6,0,12,94,206,300
2013,5,6,0,13,97,199,296
2013,5,6,0,14,80,174,254
2013,5,6,0,15,96,199,295
2013,5,6,0,16,88,405,493
2013,5,6,0,17,113,748,861
2013,5,6,0,18,76,540,616
2013,5,6,0,19,53,399,452
2013,5,6,0,20,43,293,336
2013,5,6,0,21,34,191,225
2013,5,6,0,22,25,128,153
2013,5,6,0,23,22,69,91
2013,5,7,1,0,10,41,51
2013,5,7,1,1,4,9,13
2013,5,7,1,2,1,14,15
2013,5,7,1,3,1,3,4
2013,5,7,1,4,3,3,6
2013,5,7,1,5,3,31,34
2013,5,7,1,6,5,132,137
2013,5,7,1,7,13,422,435
2013,5,7,1,8,17,485,502
2013,5,7,1,9,10,101,111
2013,5,7,1,10,6,40,46
2013,5,7,1,11,9,39,48
2013,5,7,1,12,14,67,81
2013,5,7,1,13,22,99,121
2013,5,7,1,14,16,68,84
2013,5,7,1,15,21,80,101
2013,5,7,1,16,11,216,227
2013,5,7,1,17,36,583,619
2013,5,7,1,18,45,595,640
2013,5,7,1,19,43,408,451
2013,5,7,1,20,16,296,312
2013,5,7,1,21,17,199,216
2013,5,7,1,22,14,104,118
2013,5,7,1,23,7,83,90
2013,5,8,2,0,4,37,41
2013,5,8,2,1,4,18,22
2013,5,8,2,2,6,9,15
2013,5,8,2,3,1,3,4
2013,5,8,2,4,3,6,9
2013,5,8,2,5,5,51,56
2013,5,8,2,6,12,161,173
2013,5,8,2,7,17,496,513
2013,5,8,2,8,33,843,876
2013,5,8,2,9,37,359,396
2013,5,8,2,10,59,163,222
2013,5,8,2,11,44,189,233
2013,5,8,2,12,90,301,391
2013,5,8,2,13,67,252,319
2013,5,8,2,14,96,234,330
2013,5,8,2,15,89,294,383
2013,5,8,2,16,37,291,328
2013,5,8,2,17,49,420,469
2013,5,8,2,18,37,444,481
2013,5,8,2,19,33,349,382
2013,5,8,2,20,29,341,370
2013,5,8,2,21,21,254,275
2013,5,8,2,22,30,214,244
2013,5,8,2,23,18,119,137
2013,5,9,3,0,5,38,43
2013,5,9,3,1,7,27,34
2013,5,9,3,2,4,10,14
2013,5,9,3,3,2,5,7
2013,5,9,3,4,0,8,8
2013,5,9,3,5,5,38,43
2013,5,9,3,6,11,172,183
2013,5,9,3,7,33,527,560
2013,5,9,3,8,28,854,882
2013,5,9,3,9,33,375,408
2013,5,9,3,10,50,174,224
2013,5,9,3,11,57,202,259
2013,5,9,3,12,78,261,339
2013,5,9,3,13,108,272,380
2013,5,9,3,14,89,222,311
2013,5,9,3,15,88,302,390
2013,5,9,3,16,95,327,422
2013,5,9,3,17,97,745,842
2013,5,9,3,18,114,864,978
2013,5,9,3,19,109,535,644
2013,5,9,3,20,39,239,278
2013,5,9,3,21,35,238,273
2013,5,9,3,22,17,181,198
2013,5,9,3,23,18,132,150
2013,5,10,4,0,10,75,85
2013,5,10,4,1,6,39,45
2013,5,10,4,2,7,24,31
2013,5,10,4,3,4,7,11
2013,5,10,4,4,1,6,7
2013,5,10,4,5,3,49,52
2013,5,10,4,6,10,160,170
2013,5,10,4,7,18,456,474
2013,5,10,4,8,33,742,775
2013,5,10,4,9,81,437,518
2013,5,10,4,10,97,203,300
2013,5,10,4,11,168,242,410
2013,5,10,4,12,168,322,490
2013,5,10,4,13,184,320,504
2013,5,10,4,14,127,273,400
2013,5,10,4,15,184,319,503
2013,5,10,4,16,192,521,713
2013,5,10,4,17,187,811,998
2013,5,10,4,18,161,730,891
2013,5,10,4,19,135,455,590
2013,5,10,4,20,88,310,398
2013,5,10,4,21,91,261,352
2013,5,10,4,22,17,144,161
2013,5,10,4,23,7,72,79
2013,5,11,5,0,15,74,89
2013,5,11,5,1,10,59,69
2013,5,11,5,2,7,51,58
2013,5,11,5,3,2,23,25
2013,5,11,5,4,1,3,4
2013,5,11,5,5,2,8,10
2013,5,11,5,6,5,29,34
2013,5,11,5,7,12,86,98
2013,5,11,5,8,34,164,198
2013,5,11,5,9,59,204,263
2013,5,11,5,10,91,272,363
2013,5,11,5,11,152,362,514
2013,5,11,5,12,230,429,659
2013,5,11,5,13,262,325,587
2013,5,11,5,14,238,438,676
2013,5,11,5,15,146,265,411
2013,5,11,5,16,192,338,530
2013,5,11,5,17,199,350,549
2013,5,11,5,18,168,289,457
2013,5,11,5,19,171,238,409
2013,5,11,5,20,38,95,133
2013,5,11,5,21,7,59,66
2013,5,11,5,22,30,141,171
2013,5,11,5,23,28,130,158
2013,5,12,6,0,21,104,125
2013,5,12,6,1,14,84,98
2013,5,12,6,2,16,52,68
2013,5,12,6,3,11,23,34
2013,5,12,6,4,7,10,17
2013,5,12,6,5,4,6,10
2013,5,12,6,6,5,14,19
2013,5,12,6,7,32,46,78
2013,5,12,6,8,48,130,178
2013,5,12,6,9,94,224,318
2013,5,12,6,10,197,294,491
2013,5,12,6,11,244,418,662
2013,5,12,6,12,331,400,731
2013,5,12,6,13,286,477,763
2013,5,12,6,14,298,425,723
2013,5,12,6,15,345,385,730
2013,5,12,6,16,326,395,721
2013,5,12,6,17,258,411,669
2013,5,12,6,18,214,379,593
2013,5,12,6,19,154,250,404
2013,5,12,6,20,75,207,282
2013,5,12,6,21,57,122,179
2013,5,12,6,22,28,98,126
2013,5,12,6,23,19,65,84
2013,5,13,0,0,11,38,49
2013,5,13,0,1,6,11,17
2013,5,13,0,2,0,7,7
2013,5,13,0,3,0,7,7
2013,5,13,0,4,0,3,3
2013,5,13,0,5,2,45,47
2013,5,13,0,6,6,144,150
2013,5,13,0,7,11,475,486
2013,5,13,0,8,26,793,819
2013,5,13,0,9,49,313,362
2013,5,13,0,10,62,142,204
2013,5,13,0,11,79,159,238
2013,5,13,0,12,89,251,340
2013,5,13,0,13,84,225,309
2013,5,13,0,14,84,182,266
2013,5,13,0,15,106,231,337
2013,5,13,0,16,111,398,509
2013,5,13,0,17,76,854,930
2013,5,13,0,18,87,774,861
2013,5,13,0,19,73,502,575
2013,5,13,0,20,51,301,352
2013,5,13,0,21,25,260,285
2013,5,13,0,22,18,178,196
2013,5,13,0,23,8,84,92
2013,5,14,1,0,8,37,45
2013,5,14,1,1,3,14,17
2013,5,14,1,2,3,5,8
2013,5,14,1,3,0,4,4
2013,5,14,1,4,0,6,6
2013,5,14,1,5,2,38,40
2013,5,14,1,6,7,169,176
2013,5,14,1,7,16,503,519
2013,5,14,1,8,39,872,911
2013,5,14,1,9,52,348,400
2013,5,14,1,10,52,176,228
2013,5,14,1,11,72,194,266
2013,5,14,1,12,100,266,366
2013,5,14,1,13,65,283,348
2013,5,14,1,14,99,235,334
2013,5,14,1,15,98,250,348
2013,5,14,1,16,131,413,544
2013,5,14,1,17,163,862,1025
2013,5,14,1,18,138,785,923
2013,5,14,1,19,67,504,571
2013,5,14,1,20,62,390,452
2013,5,14,1,21,31,259,290
2013,5,14,1,22,39,154,193
2013,5,14,1,23,17,91,108
2013,5,15,2,0,14,46,60
2013,5,15,2,1,3,20,23
2013,5,15,2,2,1,8,9
2013,5,15,2,3,3,2,5
2013,5,15,2,4,0,9,9
2013,5,15,2,5,3,39,42
2013,5,15,2,6,15,187,202
2013,5,15,2,7,15,542,557
2013,5,15,2,8,32,878,910
2013,5,15,2,9,35,322,357
2013,5,15,2,10,64,151,215
2013,5,15,2,11,67,201,268
2013,5,15,2,12,76,282,358
2013,5,15,2,13,87,284,371
2013,5,15,2,14,119,256,375
2013,5,15,2,15,100,267,367
2013,5,15,2,16,116,434,550
2013,5,15,2,17,131,929,1060
2013,5,15,2,18,151,862,1013
2013,5,15,2,19,94,604,698
2013,5,15,2,20,76,425,501
2013,5,15,2,21,51,363,414
2013,5,15,2,22,40,252,292
2013,5,15,2,23,28,142,170
2013,5,16,3,0,19,66,85
2013,5,16,3,1,7,49,56
2013,5,16,3,2,16,22,38
2013,5,16,3,3,0,5,5
2013,5,16,3,4,2,6,8
2013,5,16,3,5,2,43,45
2013,5,16,3,6,14,193,207
2013,5,16,3,7,23,564,587
2013,5,16,3,8,49,798,847
2013,5,16,3,9,51,360,411
2013,5,16,3,10,57,151,208
2013,5,16,3,11,96,205,301
2013,5,16,3,12,106,284,390
2013,5,16,3,13,91,243,334
2013,5,16,3,14,150,241,391
2013,5,16,3,15,111,272,383
2013,5,16,3,16,119,403,522
2013,5,16,3,17,143,876,1019
2013,5,16,3,18,164,903,1067
2013,5,16,3,19,112,550,662
2013,5,16,3,20,77,473,550
2013,5,16,3,21,56,334,390
2013,5,16,3,22,37,245,282
2013,5,16,3,23,22,162,184
2013,5,17,4,0,32,94,126
2013,5,17,4,1,13,54,67
2013,5,17,4,2,2,22,24
2013,5,17,4,3,0,10,10
2013,5,17,4,4,4,10,14
2013,5,17,4,5,8,45,53
2013,5,17,4,6,16,193,209
2013,5,17,4,7,56,637,693
2013,5,17,4,8,57,814,871
2013,5,17,4,9,104,348,452
2013,5,17,4,10,146,194,340
2013,5,17,4,11,153,255,408
2013,5,17,4,12,198,312,510
2013,5,17,4,13,207,321,528
2013,5,17,4,14,205,323,528
2013,5,17,4,15,220,392,612
2013,5,17,4,16,231,530,761
2013,5,17,4,17,201,853,1054
2013,5,17,4,18,156,706,862
2013,5,17,4,19,156,462,618
2013,5,17,4,20,136,321,457
2013,5,17,4,21,95,274,369
2013,5,17,4,22,95,260,355
2013,5,17,4,23,53,181,234
2013,5,18,5,0,38,154,192
2013,5,18,5,1,19,124,143
2013,5,18,5,2,15,65,80
2013,5,18,5,3,11,31,42
2013,5,18,5,4,5,11,16
2013,5,18,5,5,8,9,17
2013,5,18,5,6,10,43,53
2013,5,18,5,7,17,87,104
2013,5,18,5,8,55,144,199
2013,5,18,5,9,73,237,310
2013,5,18,5,10,167,324,491
2013,5,18,5,11,130,276,406
2013,5,18,5,12,55,166,221
2013,5,18,5,13,174,275,449
2013,5,18,5,14,197,272,469
2013,5,18,5,15,151,285,436
2013,5,18,5,16,174,315,489
2013,5,18,5,17,145,337,482
2013,5,18,5,18,124,341,465
2013,5,18,5,19,104,268,372
2013,5,18,5,20,68,234,302
2013,5,18,5,21,75,178,253
2013,5,18,5,22,58,134,192
2013,5,18,5,23,53,169,222
2013,5,19,6,0,26,113,139
2013,5,19,6,1,17,99,116
2013,5,19,6,2,10,54,64
2013,5,19,6,3,8,22,30
2013,5,19,6,4,2,13,15
2013,5,19,6,5,9,4,13
2013,5,19,6,6,6,26,32
2013,5,19,6,7,8,62,70
2013,5,19,6,8,30,115,145
2013,5,19,6,9,33,132,165
2013,5,19,6,10,93,187,280
2013,5,19,6,11,120,286,406
2013,5,19,6,12,154,354,508
2013,5,19,6,13,178,388,566
2013,5,19,6,14,163,396,559
2013,5,19,6,15,216,430,646
2013,5,19,6,16,231,410,641
2013,5,19,6,17,243,366,609
2013,5,19,6,18,210,383,593
2013,5,19,6,19,123,293,416
2013,5,19,6,20,67,171,238
2013,5,19,6,21,52,154,206
2013,5,19,6,22,55,113,168
2013,5,19,6,23,26,83,109
2013,5,20,0,0,11,33,44
2013,5,20,0,1,5,8,13
2013,5,20,0,2,3,6,9
2013,5,20,0,3,2,5,7
2013,5,20,0,4,1,6,7
2013,5,20,0,5,1,44,45
2013,5,20,0,6,8,177,185
2013,5,20,0,7,25,508,533
2013,5,20,0,8,46,755,801
2013,5,20,0,9,48,313,361
2013,5,20,0,10,82,155,237
2013,5,20,0,11,105,193,298
2013,5,20,0,12,115,250,365
2013,5,20,0,13,134,224,358
2013,5,20,0,14,153,173,326
2013,5,20,0,15,110,223,333
2013,5,20,0,16,139,378,517
2013,5,20,0,17,158,925,1083
2013,5,20,0,18,134,829,963
2013,5,20,0,19,124,621,745
2013,5,20,0,20,101,452,553
2013,5,20,0,21,60,286,346
2013,5,20,0,22,33,182,215
2013,5,20,0,23,27,83,110
2013,5,21,1,0,29,34,63
2013,5,21,1,1,6,20,26
2013,5,21,1,2,6,5,11
2013,5,21,1,3,4,8,12
2013,5,21,1,4,6,11,17
2013,5,21,1,5,4,48,52
2013,5,21,1,6,10,192,202
2013,5,21,1,7,28,609,637
2013,5,21,1,8,47,802,849
2013,5,21,1,9,51,344,395
2013,5,21,1,10,86,153,239
2013,5,21,1,11,104,199,303
2013,5,21,1,12,95,240,335
2013,5,21,1,13,104,249,353
2013,5,21,1,14,135,237,372
2013,5,21,1,15,125,261,386
2013,5,21,1,16,106,424,530
2013,5,21,1,17,182,905,1087
2013,5,21,1,18,160,917,1077
2013,5,21,1,19,121,643,764
2013,5,21,1,20,104,483,587
2013,5,21,1,21,67,327,394
2013,5,21,1,22,44,231,275
2013,5,21,1,23,24,113,137
2013,5,22,2,0,11,51,62
2013,5,22,2,1,4,36,40
2013,5,22,2,2,1,11,12
2013,5,22,2,3,5,5,10
2013,5,22,2,4,3,8,11
2013,5,22,2,5,0,57,57
2013,5,22,2,6,17,192,209
2013,5,22,2,7,36,580,616
2013,5,22,2,8,36,779,815
2013,5,22,2,9,43,408,451
2013,5,22,2,10,74,154,228
2013,5,22,2,11,83,201,284
2013,5,22,2,12,75,296,371
2013,5,22,2,13,107,249,356
2013,5,22,2,14,98,225,323
2013,5,22,2,15,134,283,417
2013,5,22,2,16,120,444,564
2013,5,22,2,17,142,908,1050
2013,5,22,2,18,122,906,1028
2013,5,22,2,19,98,630,728
2013,5,22,2,20,79,481,560
2013,5,22,2,21,53,298,351
2013,5,22,2,22,48,262,310
2013,5,22,2,23,12,122,134
2013,5,23,3,0,14,61,75
2013,5,23,3,1,6,21,27
2013,5,23,3,2,16,10,26
2013,5,23,3,3,2,9,11
2013,5,23,3,4,2,7,9
2013,5,23,3,5,2,36,38
2013,5,23,3,6,7,157,164
2013,5,23,3,7,32,543,575
2013,5,23,3,8,36,836,872
2013,5,23,3,9,54,371,425
2013,5,23,3,10,62,149,211
2013,5,23,3,11,87,188,275
2013,5,23,3,12,86,245,331
2013,5,23,3,13,102,253,355
2013,5,23,3,14,106,211,317
2013,5,23,3,15,104,288,392
2013,5,23,3,16,105,444,549
2013,5,23,3,17,128,825,953
2013,5,23,3,18,119,797,916
2013,5,23,3,19,65,533,598
2013,5,23,3,20,81,394,475
2013,5,23,3,21,42,274,316
2013,5,23,3,22,20,150,170
2013,5,23,3,23,10,46,56
2013,5,24,4,0,8,32,40
2013,5,24,4,1,2,30,32
2013,5,24,4,2,3,15,18
2013,5,24,4,3,4,6,10
2013,5,24,4,4,4,4,8
2013,5,24,4,5,3,37,40
2013,5,24,4,6,5,104,109
2013,5,24,4,7,10,305,315
2013,5,24,4,8,26,707,733
2013,5,24,4,9,35,364,399
2013,5,24,4,10,60,142,202
2013,5,24,4,11,67,187,254
2013,5,24,4,12,71,297,368
2013,5,24,4,13,89,273,362
2013,5,24,4,14,93,326,419
2013,5,24,4,15,91,410,501
2013,5,24,4,16,127,466,593
2013,5,24,4,17,71,581,652
2013,5,24,4,18,61,452,513
2013,5,24,4,19,62,329,391
2013,5,24,4,20,46,223,269
2013,5,24,4,21,30,169,199
2013,5,24,4,22,18,126,144
2013,5,24,4,23,18,109,127
2013,5,25,5,0,12,76,88
2013,5,25,5,1,13,61,74
2013,5,25,5,2,16,31,47
2013,5,25,5,3,8,17,25
2013,5,25,5,4,5,9,14
2013,5,25,5,5,7,13,20
2013,5,25,5,6,7,32,39
2013,5,25,5,7,14,56,70
2013,5,25,5,8,22,117,139
2013,5,25,5,9,94,191,285
2013,5,25,5,10,186,250,436
2013,5,25,5,11,271,288,559
2013,5,25,5,12,276,315,591
2013,5,25,5,13,378,378,756
2013,5,25,5,14,366,352,718
2013,5,25,5,15,374,326,700
2013,5,25,5,16,343,323,666
2013,5,25,5,17,402,354,756
2013,5,25,5,18,264,301,565
2013,5,25,5,19,204,267,471
2013,5,25,5,20,140,169,309
2013,5,25,5,21,102,183,285
2013,5,25,5,22,68,182,250
2013,5,25,5,23,49,127,176
2013,5,26,6,0,28,80,108
2013,5,26,6,1,18,60,78
2013,5,26,6,2,8,53,61
2013,5,26,6,3,6,15,21
2013,5,26,6,4,1,5,6
2013,5,26,6,5,7,6,13
2013,5,26,6,6,8,20,28
2013,5,26,6,7,15,43,58
2013,5,26,6,8,44,86,130
2013,5,26,6,9,125,142,267
2013,5,26,6,10,262,228,490
2013,5,26,6,11,407,314,721
2013,5,26,6,12,414,357,771
2013,5,26,6,13,507,324,831
2013,5,26,6,14,569,353,922
2013,5,26,6,15,601,377,978
2013,5,26,6,16,582,311,893
2013,5,26,6,17,521,333,854
2013,5,26,6,18,422,285,707
2013,5,26,6,19,428,243,671
2013,5,26,6,20,260,213,473
2013,5,26,6,21,189,200,389
2013,5,26,6,22,121,161,282
2013,5,26,6,23,111,97,208
2013,5,27,0,0,47,69,116
2013,5,27,0,1,17,49,66
2013,5,27,0,2,20,35,55
2013,5,27,0,3,14,13,27
2013,5,27,0,4,4,4,8
2013,5,27,0,5,6,7,13
2013,5,27,0,6,2,18,20
2013,5,27,0,7,27,42,69
2013,5,27,0,8,68,95,163
2013,5,27,0,9,146,167,313
2013,5,27,0,10,313,251,564
2013,5,27,0,11,405,351,756
2013,5,27,0,12,463,403,866
2013,5,27,0,13,464,383,847
2013,5,27,0,14,408,356,764
2013,5,27,0,15,433,390,823
2013,5,27,0,16,423,404,827
2013,5,27,0,17,343,366,709
2013,5,27,0,18,256,319,575
2013,5,27,0,19,199,286,485
2013,5,27,0,20,162,230,392
2013,5,27,0,21,96,174,270
2013,5,27,0,22,73,125,198
2013,5,27,0,23,64,77,141
2013,5,28,1,0,53,18,71
2013,5,28,1,1,12,8,20
2013,5,28,1,2,8,8,16
2013,5,28,1,3,6,4,10
2013,5,28,1,4,1,4,5
2013,5,28,1,5,5,33,38
2013,5,28,1,6,7,180,187
2013,5,28,1,7,31,517,548
2013,5,28,1,8,30,702,732
2013,5,28,1,9,42,313,355
2013,5,28,1,10,96,169,265
2013,5,28,1,11,104,204,308
2013,5,28,1,12,168,281,449
2013,5,28,1,13,120,255,375
2013,5,28,1,14,171,249,420
2013,5,28,1,15,133,251,384
2013,5,28,1,16,170,432,602
2013,5,28,1,17,163,876,1039
2013,5,28,1,18,94,524,618
2013,5,28,1,19,46,242,288
2013,5,28,1,20,49,288,337
2013,5,28,1,21,35,189,224
2013,5,28,1,22,30,146,176
2013,5,28,1,23,14,124,138
2013,5,29,2,0,14,37,51
2013,5,29,2,1,21,17,38
2013,5,29,2,2,7,6,13
2013,5,29,2,3,13,2,15
2013,5,29,2,4,0,5,5
2013,5,29,2,5,2,51,53
2013,5,29,2,6,4,193,197
2013,5,29,2,7,23,589,612
2013,5,29,2,8,38,852,890
2013,5,29,2,9,65,355,420
2013,5,29,2,10,112,165,277
2013,5,29,2,11,119,195,314
2013,5,29,2,12,132,271,403
2013,5,29,2,13,117,245,362
2013,5,29,2,14,125,240,365
2013,5,29,2,15,138,237,375
2013,5,29,2,16,110,438,548
2013,5,29,2,17,124,926,1050
2013,5,29,2,18,162,935,1097
2013,5,29,2,19,147,652,799
2013,5,29,2,20,95,461,556
2013,5,29,2,21,77,390,467
2013,5,29,2,22,53,229,282
2013,5,29,2,23,38,130,168
2013,5,30,3,0,23,63,86
2013,5,30,3,1,6,26,32
2013,5,30,3,2,0,13,13
2013,5,30,3,3,3,4,7
2013,5,30,3,4,1,2,3
2013,5,30,3,5,4,46,50
2013,5,30,3,6,8,202,210
2013,5,30,3,7,30,592,622
2013,5,30,3,8,37,830,867
2013,5,30,3,9,74,328,402
2013,5,30,3,10,68,153,221
2013,5,30,3,11,88,204,292
2013,5,30,3,12,83,255,338
2013,5,30,3,13,72,254,326
2013,5,30,3,14,94,200,294
2013,5,30,3,15,92,271,363
2013,5,30,3,16,67,395,462
2013,5,30,3,17,116,929,1045
2013,5,30,3,18,109,887,996
2013,5,30,3,19,143,595,738
2013,5,30,3,20,89,471,560
2013,5,30,3,21,77,307,384
2013,5,30,3,22,47,263,310
2013,5,30,3,23,39,165,204
2013,5,31,4,0,26,81,107
2013,5,31,4,1,15,31,46
2013,5,31,4,2,7,9,16
2013,5,31,4,3,2,5,7
2013,5,31,4,4,1,8,9
2013,5,31,4,5,1,63,64
2013,5,31,4,6,6,183,189
2013,5,31,4,7,23,521,544
2013,5,31,4,8,51,767,818
2013,5,31,4,9,77,408,485
2013,5,31,4,10,89,183,272
2013,5,31,4,11,97,262,359
2013,5,31,4,12,128,300,428
2013,5,31,4,13,126,317,443
2013,5,31,4,14,129,261,390
2013,5,31,4,15,156,278,434
2013,5,31,4,16,130,463,593
2013,5,31,4,17,161,770,931
2013,5,31,4,18,172,725,897
2013,5,31,4,19,127,538,665
2013,5,31,4,20,89,390,479
2013,5,31,4,21,89,340,429
2013,5,31,4,22,74,250,324
2013,5,31,4,23,59,202,261
2013,6,1,5,0,38,148,186
2013,6,1,5,1,22,105,127
2013,6,1,5,2,14,62,76
2013,6,1,5,3,10,28,38
2013,6,1,5,4,5,9,14
2013,6,1,5,5,7,15,22
2013,6,1,5,6,11,31,42
2013,6,1,5,7,24,94,118
2013,6,1,5,8,61,192,253
2013,6,1,5,9,108,325,433
2013,6,1,5,10,177,377,554
2013,6,1,5,11,274,435,709
2013,6,1,5,12,293,465,758
2013,6,1,5,13,303,418,721
2013,6,1,5,14,326,386,712
2013,6,1,5,15,295,361,656
2013,6,1,5,16,332,376,708
2013,6,1,5,17,308,387,695
2013,6,1,5,18,245,388,633
2013,6,1,5,19,272,384,656
2013,6,1,5,20,178,303,481
2013,6,1,5,21,144,251,395
2013,6,1,5,22,112,186,298
2013,6,1,5,23,98,185,283
2013,6,2,6,0,55,162,217
2013,6,2,6,1,30,91,121
2013,6,2,6,2,42,74,116
2013,6,2,6,3,21,52,73
2013,6,2,6,4,8,14,22
2013,6,2,6,5,10,7,17
2013,6,2,6,6,6,33,39
2013,6,2,6,7,19,49,68
2013,6,2,6,8,51,141,192
2013,6,2,6,9,155,249,404
2013,6,2,6,10,245,322,567
2013,6,2,6,11,354,430,784
2013,6,2,6,12,294,400,694
2013,6,2,6,13,292,415,707
2013,6,2,6,14,262,298,560
2013,6,2,6,15,233,377,610
2013,6,2,6,16,275,406,681
2013,6,2,6,17,281,413,694
2013,6,2,6,18,115,186,301
2013,6,2,6,19,66,149,215
2013,6,2,6,20,71,159,230
2013,6,2,6,21,52,147,199
2013,6,2,6,22,45,117,162
2013,6,2,6,23,16,57,73
2013,6,3,0,0,12,34,46
2013,6,3,0,1,2,11,13
2013,6,3,0,2,0,6,6
2013,6,3,0,3,1,7,8
2013,6,3,0,4,3,0,3
2013,6,3,0,5,0,20,20
2013,6,3,0,6,2,52,54
2013,6,3,0,7,6,158,164
2013,6,3,0,8,20,458,478
2013,6,3,0,9,36,370,406
2013,6,3,0,10,60,156,216
2013,6,3,0,11,94,187,281
2013,6,3,0,12,108,257,365
2013,6,3,0,13,135,278,413
2013,6,3,0,14,112,228,340
2013,6,3,0,15,135,197,332
2013,6,3,0,16,72,308,380
2013,6,3,0,17,123,825,948
2013,6,3,0,18,125,831,956
2013,6,3,0,19,103,589,692
2013,6,3,0,20,97,449,546
2013,6,3,0,21,70,309,379
2013,6,3,0,22,84,195,279
2013,6,3,0,23,42,108,150
2013,6,4,1,0,20,43,63
2013,6,4,1,1,11,15,26
2013,6,4,1,2,5,8,13
2013,6,4,1,3,1,5,6
2013,6,4,1,4,1,2,3
2013,6,4,1,5,3,64,67
2013,6,4,1,6,11,217,228
2013,6,4,1,7,29,627,656
2013,6,4,1,8,71,882,953
2013,6,4,1,9,72,350,422
2013,6,4,1,10,99,187,286
2013,6,4,1,11,134,223,357
2013,6,4,1,12,128,314,442
2013,6,4,1,13,128,277,405
2013,6,4,1,14,153,285,438
2013,6,4,1,15,151,304,455
2013,6,4,1,16,126,480,606
2013,6,4,1,17,148,1022,1170
2013,6,4,1,18,152,994,1146
2013,6,4,1,19,162,625,787
2013,6,4,1,20,102,456,558
2013,6,4,1,21,65,415,480
2013,6,4,1,22,55,259,314
2013,6,4,1,23,25,126,151
2013,6,5,2,0,12,50,62
2013,6,5,2,1,3,30,33
2013,6,5,2,2,1,10,11
2013,6,5,2,3,3,5,8
2013,6,5,2,4,1,5,6
2013,6,5,2,5,2,55,57
2013,6,5,2,6,16,228,244
2013,6,5,2,7,39,639,678
2013,6,5,2,8,85,787,872
2013,6,5,2,9,66,413,479
2013,6,5,2,10,92,165,257
2013,6,5,2,11,99,208,307
2013,6,5,2,12,130,289,419
2013,6,5,2,13,128,298,426
2013,6,5,2,14,138,255,393
2013,6,5,2,15,141,283,424
2013,6,5,2,16,173,441,614
2013,6,5,2,17,187,1036,1223
2013,6,5,2,18,150,926,1076
2013,6,5,2,19,157,633,790
2013,6,5,2,20,113,543,656
2013,6,5,2,21,82,430,512
2013,6,5,2,22,70,299,369
2013,6,5,2,23,22,137,159
2013,6,6,3,0,10,73,83
2013,6,6,3,1,7,22,29
2013,6,6,3,2,9,8,17
2013,6,6,3,3,2,4,6
2013,6,6,3,4,1,2,3
2013,6,6,3,5,3,50,53
2013,6,6,3,6,23,224,247
2013,6,6,3,7,33,586,619
2013,6,6,3,8,50,897,947
2013,6,6,3,9,64,383,447
2013,6,6,3,10,86,165,251
2013,6,6,3,11,104,203,307
2013,6,6,3,12,97,253,350
2013,6,6,3,13,100,252,352
2013,6,6,3,14,114,235,349
2013,6,6,3,15,135,279,414
2013,6,6,3,16,127,409,536
2013,6,6,3,17,140,734,874
2013,6,6,3,18,70,369,439
2013,6,6,3,19,15,154,169
2013,6,6,3,20,3,80,83
2013,6,6,3,21,9,132,141
2013,6,6,3,22,9,118,127
2013,6,6,3,23,12,70,82
2013,6,7,4,0,2,13,15
2013,6,7,4,1,1,5,6
2013,6,7,4,2,0,11,11
2013,6,7,4,3,0,6,6
2013,6,7,4,4,0,3,3
2013,6,7,4,5,2,23,25
2013,6,7,4,6,3,52,55
2013,6,7,4,7,7,132,139
2013,6,7,4,8,11,181,192
2013,6,7,4,9,11,107,118
2013,6,7,4,10,5,42,47
2013,6,7,4,11,6,45,51
2013,6,7,4,12,10,39,49
2013,6,7,4,13,9,42,51
2013,6,7,4,14,13,52,65
2013,6,7,4,15,16,71,87
2013,6,7,4,16,16,106,122
2013,6,7,4,17,22,259,281
2013,6,7,4,18,10,229,239
2013,6,7,4,19,24,206,230
2013,6,7,4,20,19,208,227
2013,6,7,4,21,17,158,175
2013,6,7,4,22,12,141,153
2013,6,7,4,23,26,136,162
2013,6,8,5,0,17,112,129
2013,6,8,5,1,9,89,98
2013,6,8,5,2,21,80,101
2013,6,8,5,3,6,34,40
2013,6,8,5,4,3,8,11
2013,6,8,5,5,3,12,15
2013,6,8,5,6,15,55,70
2013,6,8,5,7,9,97,106
2013,6,8,5,8,28,196,224
2013,6,8,5,9,99,268,367
2013,6,8,5,10,131,340,471
2013,6,8,5,11,175,386,561
2013,6,8,5,12,254,427,681
2013,6,8,5,13,318,482,800
2013,6,8,5,14,356,468,824
2013,6,8,5,15,369,517,886
2013,6,8,5,16,362,424,786
2013,6,8,5,17,320,358,678
2013,6,8,5,18,264,402,666
2013,6,8,5,19,262,421,683
2013,6,8,5,20,200,370,570
2013,6,8,5,21,150,282,432
2013,6,8,5,22,115,260,375
2013,6,8,5,23,89,200,289
2013,6,9,6,0,56,145,201
2013,6,9,6,1,34,145,179
2013,6,9,6,2,23,88,111
2013,6,9,6,3,14,48,62
2013,6,9,6,4,3,20,23
2013,6,9,6,5,3,22,25
2013,6,9,6,6,9,25,34
2013,6,9,6,7,18,53,71
2013,6,9,6,8,51,116,167
2013,6,9,6,9,125,236,361
2013,6,9,6,10,205,371,576
2013,6,9,6,11,287,419,706
2013,6,9,6,12,306,501,807
2013,6,9,6,13,338,444,782
2013,6,9,6,14,347,440,787
2013,6,9,6,15,336,399,735
2013,6,9,6,16,336,450,786
2013,6,9,6,17,286,508,794
2013,6,9,6,18,238,420,658
2013,6,9,6,19,166,381,547
2013,6,9,6,20,127,247,374
2013,6,9,6,21,62,172,234
2013,6,9,6,22,41,171,212
2013,6,9,6,23,23,86,109
2013,6,10,0,0,21,43,64
2013,6,10,0,1,9,30,39
2013,6,10,0,2,7,5,12
2013,6,10,0,3,1,1,2
2013,6,10,0,4,1,3,4
2013,6,10,0,5,1,34,35
2013,6,10,0,6,3,142,145
2013,6,10,0,7,16,217,233
2013,6,10,0,8,29,473,502
2013,6,10,0,9,45,255,300
2013,6,10,0,10,49,101,150
2013,6,10,0,11,62,129,191
2013,6,10,0,12,91,169,260
2013,6,10,0,13,67,165,232
2013,6,10,0,14,20,56,76
2013,6,10,0,15,22,64,86
2013,6,10,0,16,76,284,360
2013,6,10,0,17,71,603,674
2013,6,10,0,18,53,419,472
2013,6,10,0,19,45,247,292
2013,6,10,0,20,4,59,63
2013,6,10,0,21,9,81,90
2013,6,10,0,22,6,89,95
2013,6,10,0,23,6,46,52
2013,6,11,1,0,5,18,23
2013,6,11,1,1,2,10,12
2013,6,11,1,2,1,9,10
2013,6,11,1,3,3,4,7
2013,6,11,1,4,3,0,3
2013,6,11,1,5,0,42,42
2013,6,11,1,6,10,191,201
2013,6,11,1,7,24,573,597
2013,6,11,1,8,34,850,884
2013,6,11,1,9,72,311,383
2013,6,11,1,10,86,156,242
2013,6,11,1,11,79,212,291
2013,6,11,1,12,123,277,400
2013,6,11,1,13,112,269,381
2013,6,11,1,14,140,244,384
2013,6,11,1,15,138,273,411
2013,6,11,1,16,159,462,621
2013,6,11,1,17,170,939,1109
2013,6,11,1,18,156,903,1059
2013,6,11,1,19,129,577,706
2013,6,11,1,20,111,479,590
2013,6,11,1,21,89,358,447
2013,6,11,1,22,67,241,308
2013,6,11,1,23,26,134,160
2013,6,12,2,0,5,60,65
2013,6,12,2,1,13,19,32
2013,6,12,2,2,4,14,18
2013,6,12,2,3,5,2,7
2013,6,12,2,4,3,4,7
2013,6,12,2,5,2,54,56
2013,6,12,2,6,11,208,219
2013,6,12,2,7,28,620,648
2013,6,12,2,8,47,821,868
2013,6,12,2,9,71,327,398
2013,6,12,2,10,76,185,261
2013,6,12,2,11,84,214,298
2013,6,12,2,12,108,259,367
2013,6,12,2,13,95,249,344
2013,6,12,2,14,106,245,351
2013,6,12,2,15,144,277,421
2013,6,12,2,16,86,399,485
2013,6,12,2,17,145,887,1032
2013,6,12,2,18,123,956,1079
2013,6,12,2,19,145,638,783
2013,6,12,2,20,106,487,593
2013,6,12,2,21,66,357,423
2013,6,12,2,22,61,255,316
2013,6,12,2,23,52,146,198
2013,6,13,3,0,19,66,85
2013,6,13,3,1,9,29,38
2013,6,13,3,2,3,11,14
2013,6,13,3,3,3,5,8
2013,6,13,3,4,0,1,1
2013,6,13,3,5,3,35,38
2013,6,13,3,6,11,194,205
2013,6,13,3,7,21,583,604
2013,6,13,3,8,39,763,802
2013,6,13,3,9,20,166,186
2013,6,13,3,10,61,128,189
2013,6,13,3,11,66,176,242
2013,6,13,3,12,58,227,285
2013,6,13,3,13,97,209,306
2013,6,13,3,14,87,226,313
2013,6,13,3,15,94,296,390
2013,6,13,3,16,69,308,377
2013,6,13,3,17,131,584,715
2013,6,13,3,18,91,687,778
2013,6,13,3,19,109,466,575
2013,6,13,3,20,76,363,439
2013,6,13,3,21,41,279,320
2013,6,13,3,22,28,213,241
2013,6,13,3,23,30,159,189
2013,6,14,4,0,17,81,98
2013,6,14,4,1,5,34,39
2013,6,14,4,2,7,17,24
2013,6,14,4,3,1,11,12
2013,6,14,4,4,0,2,2
2013,6,14,4,5,3,43,46
2013,6,14,4,6,6,107,113
2013,6,14,4,7,20,369,389
2013,6,14,4,8,42,813,855
2013,6,14,4,9,66,405,471
2013,6,14,4,10,88,207,295
2013,6,14,4,11,153,261,414
2013,6,14,4,12,150,360,510
2013,6,14,4,13,166,356,522
2013,6,14,4,14,192,319,511
2013,6,14,4,15,177,388,565
2013,6,14,4,16,171,534,705
2013,6,14,4,17,200,832,1032
2013,6,14,4,18,189,721,910
2013,6,14,4,19,191,517,708
2013,6,14,4,20,137,446,583
2013,6,14,4,21,90,361,451
2013,6,14,4,22,77,270,347
2013,6,14,4,23,66,232,298
2013,6,15,5,0,24,136,160
2013,6,15,5,1,16,122,138
2013,6,15,5,2,7,79,86
2013,6,15,5,3,2,36,38
2013,6,15,5,4,3,8,11
2013,6,15,5,5,2,19,21
2013,6,15,5,6,13,42,55
2013,6,15,5,7,17,100,117
2013,6,15,5,8,50,224,274
2013,6,15,5,9,154,289,443
2013,6,15,5,10,201,391,592
2013,6,15,5,11,249,448,697
2013,6,15,5,12,342,534,876
2013,6,15,5,13,380,522,902
2013,6,15,5,14,431,453,884
2013,6,15,5,15,389,408,797
2013,6,15,5,16,373,388,761
2013,6,15,5,17,345,423,768
2013,6,15,5,18,311,417,728
2013,6,15,5,19,269,362,631
2013,6,15,5,20,251,327,578
2013,6,15,5,21,171,251,422
2013,6,15,5,22,128,215,343
2013,6,15,5,23,74,150,224
2013,6,16,6,0,71,162,233
2013,6,16,6,1,36,137,173
2013,6,16,6,2,32,100,132
2013,6,16,6,3,12,36,48
2013,6,16,6,4,1,7,8
2013,6,16,6,5,3,13,16
2013,6,16,6,6,3,20,23
2013,6,16,6,7,29,60,89
2013,6,16,6,8,38,148,186
2013,6,16,6,9,106,208,314
2013,6,16,6,10,256,344,600
2013,6,16,6,11,331,377,708
2013,6,16,6,12,321,417,738
2013,6,16,6,13,355,398,753
2013,6,16,6,14,377,415,792
2013,6,16,6,15,338,354,692
2013,6,16,6,16,288,381,669
2013,6,16,6,17,262,346,608
2013,6,16,6,18,184,339,523
2013,6,16,6,19,173,334,507
2013,6,16,6,20,140,246,386
2013,6,16,6,21,83,192,275
2013,6,16,6,22,63,151,214
2013,6,16,6,23,32,97,129
2013,6,17,0,0,17,35,52
2013,6,17,0,1,7,15,22
2013,6,17,0,2,0,15,15
2013,6,17,0,3,0,4,4
2013,6,17,0,4,0,2,2
2013,6,17,0,5,2,48,50
2013,6,17,0,6,4,189,193
2013,6,17,0,7,31,553,584
2013,6,17,0,8,70,785,855
2013,6,17,0,9,73,324,397
2013,6,17,0,10,142,142,284
2013,6,17,0,11,149,157,306
2013,6,17,0,12,129,247,376
2013,6,17,0,13,118,236,354
2013,6,17,0,14,112,205,317
2013,6,17,0,15,122,245,367
2013,6,17,0,16,125,386,511
2013,6,17,0,17,136,780,916
2013,6,17,0,18,122,823,945
2013,6,17,0,19,134,672,806
2013,6,17,0,20,89,455,544
2013,6,17,0,21,64,330,394
2013,6,17,0,22,53,216,269
2013,6,17,0,23,31,109,140
2013,6,18,1,0,14,46,60
2013,6,18,1,1,3,14,17
2013,6,18,1,2,0,3,3
2013,6,18,1,3,0,6,6
2013,6,18,1,4,0,2,2
2013,6,18,1,5,2,64,66
2013,6,18,1,6,8,241,249
2013,6,18,1,7,27,631,658
2013,6,18,1,8,42,923,965
2013,6,18,1,9,58,341,399
2013,6,18,1,10,46,121,167
2013,6,18,1,11,89,172,261
2013,6,18,1,12,82,201,283
2013,6,18,1,13,39,83,122
2013,6,18,1,14,17,42,59
2013,6,18,1,15,21,97,118
2013,6,18,1,16,53,184,237
2013,6,18,1,17,51,647,698
2013,6,18,1,18,72,743,815
2013,6,18,1,19,67,569,636
2013,6,18,1,20,101,469,570
2013,6,18,1,21,59,349,408
2013,6,18,1,22,53,215,268
2013,6,18,1,23,36,105,141
2013,6,19,2,0,19,109,128
2013,6,19,2,1,2,23,25
2013,6,19,2,2,3,8,11
2013,6,19,2,3,0,10,10
2013,6,19,2,4,2,13,15
2013,6,19,2,5,3,61,64
2013,6,19,2,6,14,241,255
2013,6,19,2,7,44,624,668
2013,6,19,2,8,56,916,972
2013,6,19,2,9,60,377,437
2013,6,19,2,10,107,206,313
2013,6,19,2,11,123,229,352
2013,6,19,2,12,113,288,401
2013,6,19,2,13,106,253,359
2013,6,19,2,14,132,231,363
2013,6,19,2,15,162,266,428
2013,6,19,2,16,113,445,558
2013,6,19,2,17,185,984,1169
2013,6,19,2,18,132,946,1078
2013,6,19,2,19,143,693,836
2013,6,19,2,20,115,562,677
2013,6,19,2,21,85,417,502
2013,6,19,2,22,57,272,329
2013,6,19,2,23,26,160,186
2013,6,20,3,0,19,48,67
2013,6,20,3,1,15,20,35
2013,6,20,3,2,8,10,18
2013,6,20,3,3,2,6,8
2013,6,20,3,4,0,4,4
2013,6,20,3,5,3,58,61
2013,6,20,3,6,16,208,224
2013,6,20,3,7,29,607,636
2013,6,20,3,8,59,956,1015
2013,6,20,3,9,59,392,451
2013,6,20,3,10,86,213,299
2013,6,20,3,11,103,217,320
2013,6,20,3,12,138,298,436
2013,6,20,3,13,132,305,437
2013,6,20,3,14,112,263,375
2013,6,20,3,15,126,277,403
2013,6,20,3,16,125,443,568
2013,6,20,3,17,187,1009,1196
2013,6,20,3,18,182,951,1133
2013,6,20,3,19,121,662,783
2013,6,20,3,20,90,619,709
2013,6,20,3,21,87,403,490
2013,6,20,3,22,62,298,360
2013,6,20,3,23,34,205,239
2013,6,21,4,0,37,155,192
2013,6,21,4,1,29,46,75
2013,6,21,4,2,3,20,23
2013,6,21,4,3,4,12,16
2013,6,21,4,4,0,4,4
2013,6,21,4,5,9,41,50
2013,6,21,4,6,9,180,189
2013,6,21,4,7,25,531,556
2013,6,21,4,8,69,873,942
2013,6,21,4,9,61,383,444
2013,6,21,4,10,118,215,333
2013,6,21,4,11,123,249,372
2013,6,21,4,12,105,334,439
2013,6,21,4,13,157,354,511
2013,6,21,4,14,195,286,481
2013,6,21,4,15,143,312,455
2013,6,21,4,16,201,519,720
2013,6,21,4,17,239,927,1166
2013,6,21,4,18,189,744,933
2013,6,21,4,19,185,532,717
2013,6,21,4,20,163,434,597
2013,6,21,4,21,125,369,494
2013,6,21,4,22,96,303,399
2013,6,21,4,23,82,232,314
2013,6,22,5,0,48,191,239
2013,6,22,5,1,28,104,132
2013,6,22,5,2,17,60,77
2013,6,22,5,3,9,29,38
2013,6,22,5,4,6,10,16
2013,6,22,5,5,6,12,18
2013,6,22,5,6,7,35,42
2013,6,22,5,7,22,93,115
2013,6,22,5,8,76,198,274
2013,6,22,5,9,148,308,456
2013,6,22,5,10,204,392,596
2013,6,22,5,11,344,482,826
2013,6,22,5,12,357,501,858
2013,6,22,5,13,389,475,864
2013,6,22,5,14,452,446,898
2013,6,22,5,15,375,443,818
2013,6,22,5,16,386,432,818
2013,6,22,5,17,300,466,766
2013,6,22,5,18,322,417,739
2013,6,22,5,19,259,376,635
2013,6,22,5,20,223,312,535
2013,6,22,5,21,197,271,468
2013,6,22,5,22,130,248,378
2013,6,22,5,23,98,209,307
2013,6,23,6,0,61,149,210
2013,6,23,6,1,55,138,193
2013,6,23,6,2,37,108,145
2013,6,23,6,3,15,42,57
2013,6,23,6,4,9,15,24
2013,6,23,6,5,5,19,24
2013,6,23,6,6,5,16,21
2013,6,23,6,7,19,43,62
2013,6,23,6,8,12,58,70
2013,6,23,6,9,7,31,38
2013,6,23,6,10,37,82,119
2013,6,23,6,11,93,238,331
2013,6,23,6,12,162,348,510
2013,6,23,6,13,168,330,498
2013,6,23,6,14,248,377,625
2013,6,23,6,15,241,371,612
2013,6,23,6,16,243,455,698
2013,6,23,6,17,224,419,643
2013,6,23,6,18,214,441,655
2013,6,23,6,19,174,370,544
2013,6,23,6,20,180,303,483
2013,6,23,6,21,100,243,343
2013,6,23,6,22,60,164,224
2013,6,23,6,23,36,111,147
2013,6,24,0,0,6,44,50
2013,6,24,0,1,6,23,29
2013,6,24,0,2,3,11,14
2013,6,24,0,3,3,7,10
2013,6,24,0,4,3,10,13
2013,6,24,0,5,1,44,45
2013,6,24,0,6,11,196,207
2013,6,24,0,7,40,514,554
2013,6,24,0,8,55,810,865
2013,6,24,0,9,73,297,370
2013,6,24,0,10,113,146,259
2013,6,24,0,11,118,179,297
2013,6,24,0,12,132,229,361
2013,6,24,0,13,90,198,288
2013,6,24,0,14,107,216,323
2013,6,24,0,15,96,235,331
2013,6,24,0,16,77,336,413
2013,6,24,0,17,99,656,755
2013,6,24,0,18,100,785,885
2013,6,24,0,19,94,617,711
2013,6,24,0,20,81,451,532
2013,6,24,0,21,85,336,421
2013,6,24,0,22,46,191,237
2013,6,24,0,23,31,133,164
2013,6,25,1,0,13,41,54
2013,6,25,1,1,9,15,24
2013,6,25,1,2,4,17,21
2013,6,25,1,3,1,11,12
2013,6,25,1,4,0,5,5
2013,6,25,1,5,5,65,70
2013,6,25,1,6,14,232,246
2013,6,25,1,7,40,592,632
2013,6,25,1,8,58,868,926
2013,6,25,1,9,64,326,390
2013,6,25,1,10,76,188,264
2013,6,25,1,11,110,198,308
2013,6,25,1,12,102,328,430
2013,6,25,1,13,84,288,372
2013,6,25,1,14,87,263,350
2013,6,25,1,15,107,293,400
2013,6,25,1,16,106,411,517
2013,6,25,1,17,159,905,1064
2013,6,25,1,18,110,831,941
2013,6,25,1,19,128,646,774
2013,6,25,1,20,101,433,534
2013,6,25,1,21,80,392,472
2013,6,25,1,22,78,262,340
2013,6,25,1,23,23,107,130
2013,6,26,2,0,6,49,55
2013,6,26,2,1,7,26,33
2013,6,26,2,2,3,11,14
2013,6,26,2,3,0,4,4
2013,6,26,2,4,1,5,6
2013,6,26,2,5,5,57,62
2013,6,26,2,6,23,231,254
2013,6,26,2,7,31,621,652
2013,6,26,2,8,52,829,881
2013,6,26,2,9,64,370,434
2013,6,26,2,10,62,206,268
2013,6,26,2,11,90,227,317
2013,6,26,2,12,99,267,366
2013,6,26,2,13,105,230,335
2013,6,26,2,14,77,239,316
2013,6,26,2,15,100,237,337
2013,6,26,2,16,95,360,455
2013,6,26,2,17,125,842,967
2013,6,26,2,18,130,842,972
2013,6,26,2,19,83,548,631
2013,6,26,2,20,56,318,374
2013,6,26,2,21,50,371,421
2013,6,26,2,22,36,261,297
2013,6,26,2,23,12,148,160
2013,6,27,3,0,18,56,74
2013,6,27,3,1,19,27,46
2013,6,27,3,2,1,12,13
2013,6,27,3,3,0,6,6
2013,6,27,3,4,1,5,6
2013,6,27,3,5,8,53,61
2013,6,27,3,6,9,220,229
2013,6,27,3,7,28,589,617
2013,6,27,3,8,47,874,921
2013,6,27,3,9,52,367,419
2013,6,27,3,10,83,233,316
2013,6,27,3,11,74,269,343
2013,6,27,3,12,100,312,412
2013,6,27,3,13,63,276,339
2013,6,27,3,14,76,256,332
2013,6,27,3,15,66,160,226
2013,6,27,3,16,64,247,311
2013,6,27,3,17,98,838,936
2013,6,27,3,18,118,884,1002
2013,6,27,3,19,108,650,758
2013,6,27,3,20,112,486,598
2013,6,27,3,21,72,373,445
2013,6,27,3,22,48,209,257
2013,6,27,3,23,37,185,222
2013,6,28,4,0,32,90,122
2013,6,28,4,1,12,33,45
2013,6,28,4,2,5,13,18
2013,6,28,4,3,2,8,10
2013,6,28,4,4,0,5,5
2013,6,28,4,5,3,50,53
2013,6,28,4,6,7,182,189
2013,6,28,4,7,23,520,543
2013,6,28,4,8,55,818,873
2013,6,28,4,9,67,367,434
2013,6,28,4,10,76,223,299
2013,6,28,4,11,94,236,330
2013,6,28,4,12,109,363,472
2013,6,28,4,13,91,329,420
2013,6,28,4,14,137,304,441
2013,6,28,4,15,33,104,137
2013,6,28,4,16,68,237,305
2013,6,28,4,17,53,281,334
2013,6,28,4,18,15,109,124
2013,6,28,4,19,31,250,281
2013,6,28,4,20,42,273,315
2013,6,28,4,21,46,216,262
2013,6,28,4,22,24,155,179
2013,6,28,4,23,36,150,186
2013,6,29,5,0,35,121,156
2013,6,29,5,1,30,98,128
2013,6,29,5,2,34,86,120
2013,6,29,5,3,18,37,55
2013,6,29,5,4,4,16,20
2013,6,29,5,5,3,10,13
2013,6,29,5,6,15,49,64
2013,6,29,5,7,23,100,123
2013,6,29,5,8,57,173,230
2013,6,29,5,9,114,294,408
2013,6,29,5,10,201,412,613
2013,6,29,5,11,321,539,860
2013,6,29,5,12,321,487,808
2013,6,29,5,13,307,478,785
2013,6,29,5,14,335,449,784
2013,6,29,5,15,316,459,775
2013,6,29,5,16,298,468,766
2013,6,29,5,17,342,485,827
2013,6,29,5,18,283,414,697
2013,6,29,5,19,230,398,628
2013,6,29,5,20,257,350,607
2013,6,29,5,21,177,306,483
2013,6,29,5,22,131,211,342
2013,6,29,5,23,121,207,328
2013,6,30,6,0,50,192,242
2013,6,30,6,1,43,134,177
2013,6,30,6,2,27,94,121
2013,6,30,6,3,13,52,65
2013,6,30,6,4,1,9,10
2013,6,30,6,5,4,12,16
2013,6,30,6,6,13,19,32
2013,6,30,6,7,24,57,81
2013,6,30,6,8,43,124,167
2013,6,30,6,9,104,225,329
2013,6,30,6,10,101,213,314
2013,6,30,6,11,78,193,271
2013,6,30,6,12,198,380,578
2013,6,30,6,13,241,428,669
2013,6,30,6,14,313,460,773
2013,6,30,6,15,237,393,630
2013,6,30,6,16,218,412,630
2013,6,30,6,17,170,355,525
2013,6,30,6,18,130,223,353
2013,6,30,6,19,94,205,299
2013,6,30,6,20,120,228,348
2013,6,30,6,21,91,186,277
2013,6,30,6,22,67,122,189
2013,6,30,6,23,25,60,85
2013,7,1,0,0,8,47,55
2013,7,1,0,1,6,21,27
2013,7,1,0,2,0,16,16
2013,7,1,0,3,4,9,13
2013,7,1,0,4,2,10,12
2013,7,1,0,5,1,49,50
2013,7,1,0,6,12,196,208
2013,7,1,0,7,19,555,574
2013,7,1,0,8,43,823,866
2013,7,1,0,9,85,286,371
2013,7,1,0,10,37,40,77
2013,7,1,0,11,42,84,126
2013,7,1,0,12,65,74,139
2013,7,1,0,13,80,160,240
2013,7,1,0,14,133,209,342
2013,7,1,0,15,116,224,340
2013,7,1,0,16,159,374,533
2013,7,1,0,17,129,908,1037
2013,7,1,0,18,111,854,965
2013,7,1,0,19,70,553,623
2013,7,1,0,20,89,444,533
2013,7,1,0,21,81,302,383
2013,7,1,0,22,51,223,274
2013,7,1,0,23,31,109,140
2013,7,2,1,0,17,48,65
2013,7,2,1,1,11,22,33
2013,7,2,1,2,2,7,9
2013,7,2,1,3,1,11,12
2013,7,2,1,4,2,6,8
2013,7,2,1,5,7,53,60
2013,7,2,1,6,8,181,189
2013,7,2,1,7,23,471,494
2013,7,2,1,8,30,856,886
2013,7,2,1,9,42,352,394
2013,7,2,1,10,93,169,262
2013,7,2,1,11,114,184,298
2013,7,2,1,12,119,276,395
2013,7,2,1,13,100,249,349
2013,7,2,1,14,87,129,216
2013,7,2,1,15,89,150,239
2013,7,2,1,16,92,278,370
2013,7,2,1,17,105,833,938
2013,7,2,1,18,99,740,839
2013,7,2,1,19,80,512,592
2013,7,2,1,20,57,444,501
2013,7,2,1,21,50,313,363
2013,7,2,1,22,38,258,296
2013,7,2,1,23,20,125,145
2013,7,3,2,0,13,84,97
2013,7,3,2,1,5,27,32
2013,7,3,2,2,1,14,15
2013,7,3,2,3,1,4,5
2013,7,3,2,4,0,7,7
2013,7,3,2,5,1,32,33
2013,7,3,2,6,6,140,146
2013,7,3,2,7,10,408,418
2013,7,3,2,8,12,147,159
2013,7,3,2,9,28,289,317
2013,7,3,2,10,44,142,186
2013,7,3,2,11,87,183,270
2013,7,3,2,12,126,260,386
2013,7,3,2,13,124,284,408
2013,7,3,2,14,121,351,472
2013,7,3,2,15,131,451,582
2013,7,3,2,16,155,518,673
2013,7,3,2,17,130,689,819
2013,7,3,2,18,111,579,690
2013,7,3,2,19,148,438,586
2013,7,3,2,20,134,389,523
2013,7,3,2,21,79,324,403
2013,7,3,2,22,79,258,337
2013,7,3,2,23,57,197,254
2013,7,4,3,0,33,149,182
2013,7,4,3,1,20,123,143
2013,7,4,3,2,20,82,102
2013,7,4,3,3,5,24,29
2013,7,4,3,4,3,7,10
2013,7,4,3,5,6,12,18
2013,7,4,3,6,9,33,42
2013,7,4,3,7,22,60,82
2013,7,4,3,8,59,120,179
2013,7,4,3,9,117,202,319
2013,7,4,3,10,213,303,516
2013,7,4,3,11,263,340,603
2013,7,4,3,12,333,347,680
2013,7,4,3,13,380,379,759
2013,7,4,3,14,454,411,865
2013,7,4,3,15,399,386,785
2013,7,4,3,16,487,347,834
2013,7,4,3,17,427,315,742
2013,7,4,3,18,410,368,778
2013,7,4,3,19,378,302,680
2013,7,4,3,20,369,337,706
2013,7,4,3,21,354,383,737
2013,7,4,3,22,318,343,661
2013,7,4,3,23,143,237,380
2013,7,5,4,0,50,114,164
2013,7,5,4,1,26,60,86
2013,7,5,4,2,11,29,40
2013,7,5,4,3,5,11,16
2013,7,5,4,4,5,9,14
2013,7,5,4,5,3,24,27
2013,7,5,4,6,10,81,91
2013,7,5,4,7,21,207,228
2013,7,5,4,8,62,409,471
2013,7,5,4,9,154,306,460
2013,7,5,4,10,275,223,498
2013,7,5,4,11,379,275,654
2013,7,5,4,12,415,335,750
2013,7,5,4,13,370,338,708
2013,7,5,4,14,368,314,682
2013,7,5,4,15,377,372,749
2013,7,5,4,16,434,441,875
2013,7,5,4,17,390,514,904
2013,7,5,4,18,317,454,771
2013,7,5,4,19,317,374,691
2013,7,5,4,20,266,311,577
2013,7,5,4,21,239,235,474
2013,7,5,4,22,180,230,410
2013,7,5,4,23,111,201,312
2013,7,6,5,0,87,114,201
2013,7,6,5,1,28,94,122
2013,7,6,5,2,24,59,83
2013,7,6,5,3,20,31,51
2013,7,6,5,4,1,7,8
2013,7,6,5,5,12,12,24
2013,7,6,5,6,19,40,59
2013,7,6,5,7,21,72,93
2013,7,6,5,8,89,162,251
2013,7,6,5,9,136,210,346
2013,7,6,5,10,226,259,485
2013,7,6,5,11,352,338,690
2013,7,6,5,12,377,323,700
2013,7,6,5,13,393,322,715
2013,7,6,5,14,363,339,702
2013,7,6,5,15,301,283,584
2013,7,6,5,16,328,249,577
2013,7,6,5,17,333,278,611
2013,7,6,5,18,269,295,564
2013,7,6,5,19,275,308,583
2013,7,6,5,20,224,285,509
2013,7,6,5,21,172,254,426
2013,7,6,5,22,146,189,335
2013,7,6,5,23,99,163,262
2013,7,7,6,0,86,141,227
2013,7,7,6,1,43,95,138
2013,7,7,6,2,22,74,96
2013,7,7,6,3,11,35,46
2013,7,7,6,4,4,8,12
2013,7,7,6,5,6,14,20
2013,7,7,6,6,16,27,43
2013,7,7,6,7,29,55,84
2013,7,7,6,8,63,132,195
2013,7,7,6,9,129,204,333
2013,7,7,6,10,177,297,474
2013,7,7,6,11,201,356,557
2013,7,7,6,12,243,370,613
2013,7,7,6,13,251,367,618
2013,7,7,6,14,193,325,518
2013,7,7,6,15,221,316,537
2013,7,7,6,16,170,350,520
2013,7,7,6,17,196,365,561
2013,7,7,6,18,136,320,456
2013,7,7,6,19,113,185,298
2013,7,7,6,20,76,128,204
2013,7,7,6,21,44,123,167
2013,7,7,6,22,38,109,147
2013,7,7,6,23,22,63,85
2013,7,8,0,0,6,31,37
2013,7,8,0,1,1,15,16
2013,7,8,0,2,0,5,5
2013,7,8,0,3,0,4,4
2013,7,8,0,4,0,9,9
2013,7,8,0,5,0,50,50
2013,7,8,0,6,12,168,180
2013,7,8,0,7,19,460,479
2013,7,8,0,8,66,815,881
2013,7,8,0,9,78,308,386
2013,7,8,0,10,57,156,213
2013,7,8,0,11,108,180,288
2013,7,8,0,12,90,234,324
2013,7,8,0,13,50,155,205
2013,7,8,0,14,79,151,230
2013,7,8,0,15,98,211,309
2013,7,8,0,16,101,408,509
2013,7,8,0,17,134,865,999
2013,7,8,0,18,126,854,980
2013,7,8,0,19,106,651,757
2013,7,8,0,20,89,479,568
2013,7,8,0,21,50,334,384
2013,7,8,0,22,29,196,225
2013,7,8,0,23,24,110,134
2013,7,9,1,0,23,45,68
2013,7,9,1,1,5,14,19
2013,7,9,1,2,0,7,7
2013,7,9,1,3,0,6,6
2013,7,9,1,4,1,5,6
2013,7,9,1,5,4,75,79
2013,7,9,1,6,7,214,221
2013,7,9,1,7,23,593,616
2013,7,9,1,8,43,875,918
2013,7,9,1,9,46,333,379
2013,7,9,1,10,58,183,241
2013,7,9,1,11,61,196,257
2013,7,9,1,12,86,257,343
2013,7,9,1,13,77,271,348
2013,7,9,1,14,74,184,258
2013,7,9,1,15,78,215,293
2013,7,9,1,16,72,419,491
2013,7,9,1,17,106,992,1098
2013,7,9,1,18,118,920,1038
2013,7,9,1,19,103,647,750
2013,7,9,1,20,89,485,574
2013,7,9,1,21,61,357,418
2013,7,9,1,22,38,243,281
2013,7,9,1,23,24,115,139
2013,7,10,2,0,10,61,71
2013,7,10,2,1,0,25,25
2013,7,10,2,2,2,8,10
2013,7,10,2,3,0,5,5
2013,7,10,2,4,1,4,5
2013,7,10,2,5,1,70,71
2013,7,10,2,6,6,240,246
2013,7,10,2,7,28,601,629
2013,7,10,2,8,47,831,878
2013,7,10,2,9,32,208,240
2013,7,10,2,10,45,137,182
2013,7,10,2,11,94,194,288
2013,7,10,2,12,72,217,289
2013,7,10,2,13,59,236,295
2013,7,10,2,14,64,224,288
2013,7,10,2,15,86,238,324
2013,7,10,2,16,86,442,528
2013,7,10,2,17,95,935,1030
2013,7,10,2,18,164,967,1131
2013,7,10,2,19,103,650,753
2013,7,10,2,20,37,170,207
2013,7,10,2,21,38,270,308
2013,7,10,2,22,31,230,261
2013,7,10,2,23,17,128,145
2013,7,11,3,0,17,48,65
2013,7,11,3,1,3,23,26
2013,7,11,3,2,2,12,14
2013,7,11,3,3,3,6,9
2013,7,11,3,4,0,5,5
2013,7,11,3,5,2,61,63
2013,7,11,3,6,11,193,204
2013,7,11,3,7,15,584,599
2013,7,11,3,8,39,701,740
2013,7,11,3,9,51,332,383
2013,7,11,3,10,68,145,213
2013,7,11,3,11,65,191,256
2013,7,11,3,12,86,227,313
2013,7,11,3,13,110,263,373
2013,7,11,3,14,101,241,342
2013,7,11,3,15,109,259,368
2013,7,11,3,16,118,473,591
2013,7,11,3,17,125,943,1068
2013,7,11,3,18,109,940,1049
2013,7,11,3,19,113,635,748
2013,7,11,3,20,62,483,545
2013,7,11,3,21,71,365,436
2013,7,11,3,22,73,250,323
2013,7,11,3,23,31,178,209
2013,7,12,4,0,16,101,117
2013,7,12,4,1,10,19,29
2013,7,12,4,2,1,9,10
2013,7,12,4,3,1,1,2
2013,7,12,4,5,0,34,34
2013,7,12,4,6,1,70,71
2013,7,12,4,7,10,80,90
2013,7,12,4,8,10,207,217
2013,7,12,4,9,29,194,223
2013,7,12,4,10,47,144,191
2013,7,12,4,11,40,180,220
2013,7,12,4,12,85,241,326
2013,7,12,4,13,75,219,294
2013,7,12,4,14,70,161,231
2013,7,12,4,15,83,274,357
2013,7,12,4,16,98,455,553
2013,7,12,4,17,64,436,500
2013,7,12,4,18,69,502,571
2013,7,12,4,19,97,482,579
2013,7,12,4,20,55,321,376
2013,7,12,4,21,49,259,308
2013,7,12,4,22,46,204,250
2013,7,12,4,23,50,193,243
2013,7,13,5,0,43,227,270
2013,7,13,5,1,23,100,123
2013,7,13,5,2,22,79,101
2013,7,13,5,3,16,23,39
2013,7,13,5,4,1,7,8
2013,7,13,5,5,4,14,18
2013,7,13,5,6,8,33,41
2013,7,13,5,7,12,91,103
2013,7,13,5,8,41,177,218
2013,7,13,5,9,44,250,294
2013,7,13,5,10,116,397,513
2013,7,13,5,11,222,447,669
2013,7,13,5,12,292,489,781
2013,7,13,5,13,342,460,802
2013,7,13,5,14,309,423,732
2013,7,13,5,15,316,446,762
2013,7,13,5,16,351,416,767
2013,7,13,5,17,294,414,708
2013,7,13,5,18,242,425,667
2013,7,13,5,19,166,316,482
2013,7,13,5,20,160,281,441
2013,7,13,5,21,92,247,339
2013,7,13,5,22,62,204,266
2013,7,13,5,23,46,182,228
2013,7,14,6,0,26,191,217
2013,7,14,6,1,33,144,177
2013,7,14,6,2,34,130,164
2013,7,14,6,3,19,53,72
2013,7,14,6,4,5,17,22
2013,7,14,6,5,2,7,9
2013,7,14,6,6,6,20,26
2013,7,14,6,7,18,45,63
2013,7,14,6,8,46,119,165
2013,7,14,6,9,81,220,301
2013,7,14,6,10,186,355,541
2013,7,14,6,11,222,372,594
2013,7,14,6,12,213,415,628
2013,7,14,6,13,303,444,747
2013,7,14,6,14,285,378,663
2013,7,14,6,15,263,399,662
2013,7,14,6,16,255,408,663
2013,7,14,6,17,168,381,549
2013,7,14,6,18,147,429,576
2013,7,14,6,19,138,362,500
2013,7,14,6,20,158,300,458
2013,7,14,6,21,125,254,379
2013,7,14,6,22,58,154,212
2013,7,14,6,23,7,102,109
2013,7,15,0,0,11,42,53
2013,7,15,0,1,5,20,25
2013,7,15,0,2,2,5,7
2013,7,15,0,3,1,3,4
2013,7,15,0,4,0,5,5
2013,7,15,0,5,1,51,52
2013,7,15,0,6,10,192,202
2013,7,15,0,7,24,533,557
2013,7,15,0,8,57,791,848
2013,7,15,0,9,55,288,343
2013,7,15,0,10,87,136,223
2013,7,15,0,11,91,159,250
2013,7,15,0,12,85,243,328
2013,7,15,0,13,69,205,274
2013,7,15,0,14,101,165,266
2013,7,15,0,15,77,186,263
2013,7,15,0,16,88,382,470
2013,7,15,0,17,84,868,952
2013,7,15,0,18,135,842,977
2013,7,15,0,19,118,597,715
2013,7,15,0,20,106,444,550
2013,7,15,0,21,67,310,377
2013,7,15,0,22,48,211,259
2013,7,15,0,23,21,87,108
2013,7,16,1,0,12,39,51
2013,7,16,1,1,6,22,28
2013,7,16,1,2,1,9,10
2013,7,16,1,3,2,4,6
2013,7,16,1,4,0,6,6
2013,7,16,1,5,0,51,51
2013,7,16,1,6,8,218,226
2013,7,16,1,7,31,596,627
2013,7,16,1,8,51,872,923
2013,7,16,1,9,58,290,348
2013,7,16,1,10,74,152,226
2013,7,16,1,11,73,158,231
2013,7,16,1,12,82,223,305
2013,7,16,1,13,67,198,265
2013,7,16,1,14,64,182,246
2013,7,16,1,15,98,250,348
2013,7,16,1,16,72,400,472
2013,7,16,1,17,88,856,944
2013,7,16,1,18,112,782,894
2013,7,16,1,19,119,607,726
2013,7,16,1,20,128,508,636
2013,7,16,1,21,83,369,452
2013,7,16,1,22,52,291,343
2013,7,16,1,23,23,128,151
2013,7,17,2,0,12,71,83
2013,7,17,2,1,7,16,23
2013,7,17,2,2,1,12,13
2013,7,17,2,3,0,7,7
2013,7,17,2,4,0,5,5
2013,7,17,2,5,1,56,57
2013,7,17,2,6,9,225,234
2013,7,17,2,7,36,568,604
2013,7,17,2,8,36,858,894
2013,7,17,2,9,56,342,398
2013,7,17,2,10,69,147,216
2013,7,17,2,11,74,175,249
2013,7,17,2,12,62,225,287
2013,7,17,2,13,73,218,291
2013,7,17,2,14,64,191,255
2013,7,17,2,15,79,248,327
2013,7,17,2,16,80,378,458
2013,7,17,2,17,113,868,981
2013,7,17,2,18,138,878,1016
2013,7,17,2,19,138,616,754
2013,7,17,2,20,129,505,634
2013,7,17,2,21,78,350,428
2013,7,17,2,22,58,267,325
2013,7,17,2,23,28,153,181
2013,7,18,3,0,19,73,92
2013,7,18,3,1,7,23,30
2013,7,18,3,2,2,16,18
2013,7,18,3,3,3,13,16
2013,7,18,3,4,2,9,11
2013,7,18,3,5,2,56,58
2013,7,18,3,6,8,198,206
2013,7,18,3,7,19,555,574
2013,7,18,3,8,25,781,806
2013,7,18,3,9,24,361,385
2013,7,18,3,10,34,160,194
2013,7,18,3,11,69,154,223
2013,7,18,3,12,74,223,297
2013,7,18,3,13,85,198,283
2013,7,18,3,14,81,162,243
2013,7,18,3,15,78,206,284
2013,7,18,3,16,61,354,415
2013,7,18,3,17,75,793,868
2013,7,18,3,18,111,796,907
2013,7,18,3,19,98,490,588
2013,7,18,3,20,74,367,441
2013,7,18,3,21,82,341,423
2013,7,18,3,22,53,297,350
2013,7,18,3,23,35,155,190
2013,7,19,4,0,15,78,93
2013,7,19,4,1,16,39,55
2013,7,19,4,2,5,24,29
2013,7,19,4,3,4,9,13
2013,7,19,4,4,0,10,10
2013,7,19,4,5,4,45,49
2013,7,19,4,6,14,154,168
2013,7,19,4,7,29,466,495
2013,7,19,4,8,44,711,755
2013,7,19,4,9,48,330,378
2013,7,19,4,10,88,176,264
2013,7,19,4,11,98,192,290
2013,7,19,4,12,77,260,337
2013,7,19,4,13,94,260,354
2013,7,19,4,14,116,217,333
2013,7,19,4,15,87,253,340
2013,7,19,4,16,105,418,523
2013,7,19,4,17,129,715,844
2013,7,19,4,18,126,627,753
2013,7,19,4,19,111,454,565
2013,7,19,4,20,115,395,510
2013,7,19,4,21,81,258,339
2013,7,19,4,22,65,274,339
2013,7,19,4,23,41,210,251
2013,7,20,5,0,67,171,238
2013,7,20,5,1,39,117,156
2013,7,20,5,2,17,72,89
2013,7,20,5,3,10,37,47
2013,7,20,5,4,9,14,23
2013,7,20,5,5,10,12,22
2013,7,20,5,6,13,26,39
2013,7,20,5,7,12,73,85
2013,7,20,5,8,49,197,246
2013,7,20,5,9,111,256,367
2013,7,20,5,10,202,337,539
2013,7,20,5,11,190,387,577
2013,7,20,5,12,207,390,597
2013,7,20,5,13,255,394,649
2013,7,20,5,14,284,402,686
2013,7,20,5,15,327,369,696
2013,7,20,5,16,224,348,572
2013,7,20,5,17,269,380,649
2013,7,20,5,18,219,348,567
2013,7,20,5,19,156,336,492
2013,7,20,5,20,152,282,434
2013,7,20,5,21,127,231,358
2013,7,20,5,22,93,221,314
2013,7,20,5,23,87,177,264
2013,7,21,6,0,43,175,218
2013,7,21,6,1,42,142,184
2013,7,21,6,2,27,99,126
2013,7,21,6,3,24,53,77
2013,7,21,6,4,9,12,21
2013,7,21,6,5,4,8,12
2013,7,21,6,6,16,26,42
2013,7,21,6,7,26,44,70
2013,7,21,6,8,54,134,188
2013,7,21,6,9,108,211,319
2013,7,21,6,10,211,393,604
2013,7,21,6,11,219,350,569
2013,7,21,6,12,260,403,663
2013,7,21,6,13,280,379,659
2013,7,21,6,14,268,368,636
2013,7,21,6,15,271,388,659
2013,7,21,6,16,277,389,666
2013,7,21,6,17,216,319,535
2013,7,21,6,18,166,358,524
2013,7,21,6,19,189,367,556
2013,7,21,6,20,165,271,436
2013,7,21,6,21,121,241,362
2013,7,21,6,22,94,174,268
2013,7,21,6,23,42,102,144
2013,7,22,0,0,25,43,68
2013,7,22,0,1,2,13,15
2013,7,22,0,2,1,4,5
2013,7,22,0,3,0,4,4
2013,7,22,0,4,0,5,5
2013,7,22,0,5,2,50,52
2013,7,22,0,6,6,203,209
2013,7,22,0,7,43,534,577
2013,7,22,0,8,69,725,794
2013,7,22,0,9,54,329,383
2013,7,22,0,10,93,185,278
2013,7,22,0,11,110,170,280
2013,7,22,0,12,104,241,345
2013,7,22,0,13,123,227,350
2013,7,22,0,14,144,193,337
2013,7,22,0,15,93,251,344
2013,7,22,0,16,128,447,575
2013,7,22,0,17,117,897,1014
2013,7,22,0,18,127,895,1022
2013,7,22,0,19,121,688,809
2013,7,22,0,20,97,469,566
2013,7,22,0,21,74,326,400
2013,7,22,0,22,22,194,216
2013,7,22,0,23,23,125,148
2013,7,23,1,0,9,34,43
2013,7,23,1,1,1,13,14
2013,7,23,1,2,4,8,12
2013,7,23,1,3,0,4,4
2013,7,23,1,4,1,4,5
2013,7,23,1,5,6,52,58
2013,7,23,1,6,8,237,245
2013,7,23,1,7,26,631,657
2013,7,23,1,8,34,834,868
2013,7,23,1,9,71,343,414
2013,7,23,1,10,51,191,242
2013,7,23,1,11,110,192,302
2013,7,23,1,12,93,283,376
2013,7,23,1,13,94,272,366
2013,7,23,1,14,115,210,325
2013,7,23,1,15,88,256,344
2013,7,23,1,16,100,410,510
2013,7,23,1,17,164,977,1141
2013,7,23,1,18,110,877,987
2013,7,23,1,19,136,655,791
2013,7,23,1,20,130,540,670
2013,7,23,1,21,87,381,468
2013,7,23,1,22,50,276,326
2013,7,23,1,23,25,142,167
2013,7,24,2,0,18,55,73
2013,7,24,2,1,15,22,37
2013,7,24,2,2,9,4,13
2013,7,24,2,3,2,4,6
2013,7,24,2,4,1,9,10
2013,7,24,2,5,5,58,63
2013,7,24,2,6,13,232,245
2013,7,24,2,7,33,654,687
2013,7,24,2,8,59,845,904
2013,7,24,2,9,66,377,443
2013,7,24,2,10,82,222,304
2013,7,24,2,11,108,216,324
2013,7,24,2,12,103,278,381
2013,7,24,2,13,116,276,392
2013,7,24,2,14,103,226,329
2013,7,24,2,15,129,274,403
2013,7,24,2,16,115,427,542
2013,7,24,2,17,143,994,1137
2013,7,24,2,18,158,970,1128
2013,7,24,2,19,168,643,811
2013,7,24,2,20,90,515,605
2013,7,24,2,21,99,382,481
2013,7,24,2,22,51,305,356
2013,7,24,2,23,21,161,182
2013,7,25,3,0,9,73,82
2013,7,25,3,1,4,44,48
2013,7,25,3,2,6,10,16
2013,7,25,3,3,1,8,9
2013,7,25,3,4,5,6,11
2013,7,25,3,5,3,39,42
2013,7,25,3,6,10,193,203
2013,7,25,3,7,43,596,639
2013,7,25,3,8,54,914,968
2013,7,25,3,9,63,353,416
2013,7,25,3,10,127,189,316
2013,7,25,3,11,134,201,335
2013,7,25,3,12,137,283,420
2013,7,25,3,13,125,307,432
2013,7,25,3,14,137,253,390
2013,7,25,3,15,136,317,453
2013,7,25,3,16,156,479,635
2013,7,25,3,17,194,1030,1224
2013,7,25,3,18,160,1006,1166
2013,7,25,3,19,137,639,776
2013,7,25,3,20,89,505,594
2013,7,25,3,21,76,381,457
2013,7,25,3,22,52,312,364
2013,7,25,3,23,50,182,232
2013,7,26,4,0,27,79,106
2013,7,26,4,1,10,37,47
2013,7,26,4,2,8,25,33
2013,7,26,4,3,3,6,9
2013,7,26,4,4,0,8,8
2013,7,26,4,5,3,45,48
2013,7,26,4,6,10,193,203
2013,7,26,4,7,37,552,589
2013,7,26,4,8,57,878,935
2013,7,26,4,9,80,386,466
2013,7,26,4,10,97,233,330
2013,7,26,4,11,123,239,362
2013,7,26,4,12,145,351,496
2013,7,26,4,13,133,366,499
2013,7,26,4,14,218,323,541
2013,7,26,4,15,170,361,531
2013,7,26,4,16,173,574,747
2013,7,26,4,17,203,928,1131
2013,7,26,4,18,165,777,942
2013,7,26,4,19,169,518,687
2013,7,26,4,20,123,405,528
2013,7,26,4,21,100,342,442
2013,7,26,4,22,122,285,407
2013,7,26,4,23,68,215,283
2013,7,27,5,0,40,179,219
2013,7,27,5,1,23,112,135
2013,7,27,5,2,23,71,94
2013,7,27,5,3,16,27,43
2013,7,27,5,4,9,14,23
2013,7,27,5,5,8,9,17
2013,7,27,5,6,17,42,59
2013,7,27,5,7,21,78,99
2013,7,27,5,8,57,190,247
2013,7,27,5,9,103,291,394
2013,7,27,5,10,220,357,577
2013,7,27,5,11,256,442,698
2013,7,27,5,12,303,434,737
2013,7,27,5,13,314,456,770
2013,7,27,5,14,348,417,765
2013,7,27,5,15,301,388,689
2013,7,27,5,16,304,378,682
2013,7,27,5,17,104,161,265
2013,7,27,5,18,151,248,399
2013,7,27,5,19,182,282,464
2013,7,27,5,20,128,226,354
2013,7,27,5,21,110,226,336
2013,7,27,5,22,73,188,261
2013,7,27,5,23,64,83,147
2013,7,28,6,0,23,102,125
2013,7,28,6,1,30,127,157
2013,7,28,6,2,12,79,91
2013,7,28,6,3,5,24,29
2013,7,28,6,4,2,10,12
2013,7,28,6,5,4,16,20
2013,7,28,6,6,16,16,32
2013,7,28,6,7,20,50,70
2013,7,28,6,8,35,111,146
2013,7,28,6,9,98,228,326
2013,7,28,6,10,174,342,516
2013,7,28,6,11,233,382,615
2013,7,28,6,12,285,439,724
2013,7,28,6,13,333,415,748
2013,7,28,6,14,290,411,701
2013,7,28,6,15,280,451,731
2013,7,28,6,16,203,400,603
2013,7,28,6,17,182,356,538
2013,7,28,6,18,195,362,557
2013,7,28,6,19,146,335,481
2013,7,28,6,20,140,285,425
2013,7,28,6,21,69,191,260
2013,7,28,6,22,57,153,210
2013,7,28,6,23,31,94,125
2013,7,29,0,0,11,33,44
2013,7,29,0,1,5,22,27
2013,7,29,0,2,1,9,10
2013,7,29,0,3,0,5,5
2013,7,29,0,4,2,4,6
2013,7,29,0,5,2,48,50
2013,7,29,0,6,3,211,214
2013,7,29,0,7,23,586,609
2013,7,29,0,8,55,811,866
2013,7,29,0,9,68,323,391
2013,7,29,0,10,93,167,260
2013,7,29,0,11,131,170,301
2013,7,29,0,12,151,313,464
2013,7,29,0,13,145,260,405
2013,7,29,0,14,140,185,325
2013,7,29,0,15,132,239,371
2013,7,29,0,16,175,411,586
2013,7,29,0,17,173,914,1087
2013,7,29,0,18,156,850,1006
2013,7,29,0,19,149,671,820
2013,7,29,0,20,106,475,581
2013,7,29,0,21,86,341,427
2013,7,29,0,22,67,227,294
2013,7,29,0,23,41,138,179
2013,7,30,1,0,16,44,60
2013,7,30,1,1,4,13,17
2013,7,30,1,2,6,14,20
2013,7,30,1,3,0,5,5
2013,7,30,1,4,0,4,4
2013,7,30,1,5,3,51,54
2013,7,30,1,6,14,238,252
2013,7,30,1,7,30,661,691
2013,7,30,1,8,45,842,887
2013,7,30,1,9,77,332,409
2013,7,30,1,10,135,182,317
2013,7,30,1,11,149,243,392
2013,7,30,1,12,151,278,429
2013,7,30,1,13,129,276,405
2013,7,30,1,14,127,242,369
2013,7,30,1,15,137,294,431
2013,7,30,1,16,160,426,586
2013,7,30,1,17,172,971,1143
2013,7,30,1,18,193,951,1144
2013,7,30,1,19,134,692,826
2013,7,30,1,20,103,499,602
2013,7,30,1,21,77,368,445
2013,7,30,1,22,60,247,307
2013,7,30,1,23,33,152,185
2013,7,31,2,0,8,58,66
2013,7,31,2,1,7,24,31
2013,7,31,2,2,3,12,15
2013,7,31,2,3,0,5,5
2013,7,31,2,4,1,5,6
2013,7,31,2,5,2,51,53
2013,7,31,2,6,7,236,243
2013,7,31,2,7,31,600,631
2013,7,31,2,8,37,866,903
2013,7,31,2,9,91,362,453
2013,7,31,2,10,99,160,259
2013,7,31,2,11,103,194,297
2013,7,31,2,12,102,278,380
2013,7,31,2,13,120,235,355
2013,7,31,2,14,118,213,331
2013,7,31,2,15,110,290,400
2013,7,31,2,16,117,438,555
2013,7,31,2,17,152,909,1061
2013,7,31,2,18,135,904,1039
2013,7,31,2,19,96,582,678
2013,7,31,2,20,42,325,367
2013,7,31,2,21,23,220,243
2013,7,31,2,22,40,212,252
2013,7,31,2,23,24,126,150
2013,8,1,3,0,8,36,44
2013,8,1,3,1,1,16,17
2013,8,1,3,2,2,9,11
2013,8,1,3,3,1,3,4
2013,8,1,3,4,0,3,3
2013,8,1,3,5,2,31,33
2013,8,1,3,6,9,129,138
2013,8,1,3,7,17,403,420
2013,8,1,3,8,31,809,840
2013,8,1,3,9,32,301,333
2013,8,1,3,10,42,115,157
2013,8,1,3,11,52,155,207
2013,8,1,3,12,69,228,297
2013,8,1,3,13,94,237,331
2013,8,1,3,14,94,209,303
2013,8,1,3,15,63,239,302
2013,8,1,3,16,105,404,509
2013,8,1,3,17,105,826,931
2013,8,1,3,18,92,788,880
2013,8,1,3,19,106,598,704
2013,8,1,3,20,85,444,529
2013,8,1,3,21,77,288,365
2013,8,1,3,22,53,242,295
2013,8,1,3,23,38,153,191
2013,8,2,4,0,13,85,98
2013,8,2,4,1,11,41,52
2013,8,2,4,2,1,15,16
2013,8,2,4,3,1,5,6
2013,8,2,4,4,0,9,9
2013,8,2,4,5,3,60,63
2013,8,2,4,6,7,166,173
2013,8,2,4,7,34,467,501
2013,8,2,4,8,64,831,895
2013,8,2,4,9,63,348,411
2013,8,2,4,10,91,224,315
2013,8,2,4,11,158,260,418
2013,8,2,4,12,185,351,536
2013,8,2,4,13,180,334,514
2013,8,2,4,14,200,309,509
2013,8,2,4,15,196,359,555
2013,8,2,4,16,215,532,747
2013,8,2,4,17,223,846,1069
2013,8,2,4,18,142,699,841
2013,8,2,4,19,157,502,659
2013,8,2,4,20,137,366,503
2013,8,2,4,21,135,284,419
2013,8,2,4,22,97,281,378
2013,8,2,4,23,46,207,253
2013,8,3,5,0,40,176,216
2013,8,3,5,1,33,133,166
2013,8,3,5,2,30,81,111
2013,8,3,5,3,19,41,60
2013,8,3,5,4,2,10,12
2013,8,3,5,5,3,14,17
2013,8,3,5,6,10,45,55
2013,8,3,5,7,16,72,88
2013,8,3,5,8,34,136,170
2013,8,3,5,9,64,174,238
2013,8,3,5,10,173,362,535
2013,8,3,5,11,203,387,590
2013,8,3,5,12,280,383,663
2013,8,3,5,13,342,387,729
2013,8,3,5,14,348,403,751
2013,8,3,5,15,402,420,822
2013,8,3,5,16,316,329,645
2013,8,3,5,17,313,365,678
2013,8,3,5,18,232,332,564
2013,8,3,5,19,164,331,495
2013,8,3,5,20,162,271,433
2013,8,3,5,21,42,85,127
2013,8,3,5,22,60,122,182
2013,8,3,5,23,28,157,185
2013,8,4,6,0,53,127,180
2013,8,4,6,1,26,98,124
2013,8,4,6,2,47,97,144
2013,8,4,6,3,21,57,78
2013,8,4,6,4,4,15,19
2013,8,4,6,5,11,16,27
2013,8,4,6,6,9,24,33
2013,8,4,6,7,9,56,65
2013,8,4,6,8,57,137,194
2013,8,4,6,9,121,258,379
2013,8,4,6,10,247,375,622
2013,8,4,6,11,370,430,800
2013,8,4,6,12,383,491,874
2013,8,4,6,13,402,475,877
2013,8,4,6,14,422,472,894
2013,8,4,6,15,383,468,851
2013,8,4,6,16,391,478,869
2013,8,4,6,17,348,453,801
2013,8,4,6,18,301,449,750
2013,8,4,6,19,272,397,669
2013,8,4,6,20,209,337,546
2013,8,4,6,21,133,231,364
2013,8,4,6,22,68,170,238
2013,8,4,6,23,30,83,113
2013,8,5,0,0,6,28,34
2013,8,5,0,1,5,12,17
2013,8,5,0,2,5,4,9
2013,8,5,0,3,9,3,12
2013,8,5,0,4,5,6,11
2013,8,5,0,5,3,53,56
2013,8,5,0,6,9,199,208
2013,8,5,0,7,27,549,576
2013,8,5,0,8,55,726,781
2013,8,5,0,9,72,365,437
2013,8,5,0,10,124,196,320
2013,8,5,0,11,176,200,376
2013,8,5,0,12,167,299,466
2013,8,5,0,13,188,277,465
2013,8,5,0,14,208,239,447
2013,8,5,0,15,189,248,437
2013,8,5,0,16,203,452,655
2013,8,5,0,17,202,1026,1228
2013,8,5,0,18,161,998,1159
2013,8,5,0,19,166,684,850
2013,8,5,0,20,158,472,630
2013,8,5,0,21,83,303,386
2013,8,5,0,22,91,351,442
2013,8,5,0,23,33,127,160
2013,8,6,1,0,16,48,64
2013,8,6,1,1,11,14,25
2013,8,6,1,2,3,6,9
2013,8,6,1,3,0,5,5
2013,8,6,1,4,1,7,8
2013,8,6,1,5,2,52,54
2013,8,6,1,6,9,219,228
2013,8,6,1,7,11,372,383
2013,8,6,1,8,36,733,769
2013,8,6,1,9,37,267,304
2013,8,6,1,10,69,128,197
2013,8,6,1,11,113,144,257
2013,8,6,1,12,97,235,332
2013,8,6,1,13,117,266,383
2013,8,6,1,14,110,220,330
2013,8,6,1,15,152,273,425
2013,8,6,1,16,148,414,562
2013,8,6,1,17,159,853,1012
2013,8,6,1,18,122,937,1059
2013,8,6,1,19,110,605,715
2013,8,6,1,20,92,403,495
2013,8,6,1,21,57,318,375
2013,8,6,1,22,58,279,337
2013,8,6,1,23,17,124,141
2013,8,7,2,0,19,48,67
2013,8,7,2,1,6,30,36
2013,8,7,2,2,4,6,10
2013,8,7,2,3,1,6,7
2013,8,7,2,4,1,8,9
2013,8,7,2,5,1,53,54
2013,8,7,2,6,13,208,221
2013,8,7,2,7,16,546,562
2013,8,7,2,8,56,910,966
2013,8,7,2,9,67,382,449
2013,8,7,2,10,101,171,272
2013,8,7,2,11,121,215,336
2013,8,7,2,12,145,240,385
2013,8,7,2,13,166,273,439
2013,8,7,2,14,177,212,389
2013,8,7,2,15,179,267,446
2013,8,7,2,16,149,495,644
2013,8,7,2,17,207,1011,1218
2013,8,7,2,18,180,964,1144
2013,8,7,2,19,125,666,791
2013,8,7,2,20,77,460,537
2013,8,7,2,21,38,344,382
2013,8,7,2,22,50,249,299
2013,8,7,2,23,32,132,164
2013,8,8,3,0,10,57,67
2013,8,8,3,1,12,19,31
2013,8,8,3,2,7,14,21
2013,8,8,3,3,1,10,11
2013,8,8,3,4,0,4,4
2013,8,8,3,5,3,54,57
2013,8,8,3,6,5,196,201
2013,8,8,3,7,22,571,593
2013,8,8,3,8,37,871,908
2013,8,8,3,9,49,380,429
2013,8,8,3,10,101,190,291
2013,8,8,3,11,119,189,308
2013,8,8,3,12,102,285,387
2013,8,8,3,13,118,287,405
2013,8,8,3,14,111,244,355
2013,8,8,3,15,98,275,373
2013,8,8,3,16,147,429,576
2013,8,8,3,17,165,821,986
2013,8,8,3,18,143,863,1006
2013,8,8,3,19,90,608,698
2013,8,8,3,20,73,418,491
2013,8,8,3,21,61,290,351
2013,8,8,3,22,48,212,260
2013,8,8,3,23,16,147,163
2013,8,9,4,0,13,96,109
2013,8,9,4,1,5,43,48
2013,8,9,4,2,7,24,31
2013,8,9,4,3,1,8,9
2013,8,9,4,4,0,6,6
2013,8,9,4,5,2,49,51
2013,8,9,4,6,9,153,162
2013,8,9,4,7,29,473,502
2013,8,9,4,8,47,790,837
2013,8,9,4,9,108,405,513
2013,8,9,4,10,132,209,341
2013,8,9,4,11,123,237,360
2013,8,9,4,12,150,303,453
2013,8,9,4,13,144,332,476
2013,8,9,4,14,202,290,492
2013,8,9,4,15,160,324,484
2013,8,9,4,16,186,523,709
2013,8,9,4,17,160,762,922
2013,8,9,4,18,156,689,845
2013,8,9,4,19,141,502,643
2013,8,9,4,20,154,431,585
2013,8,9,4,21,111,306,417
2013,8,9,4,22,58,239,297
2013,8,9,4,23,54,199,253
2013,8,10,5,0,31,151,182
2013,8,10,5,1,19,118,137
2013,8,10,5,2,15,84,99
2013,8,10,5,3,10,32,42
2013,8,10,5,4,4,12,16
2013,8,10,5,5,5,10,15
2013,8,10,5,6,6,35,41
2013,8,10,5,7,12,82,94
2013,8,10,5,8,48,162,210
2013,8,10,5,9,140,310,450
2013,8,10,5,10,192,357,549
2013,8,10,5,11,263,407,670
2013,8,10,5,12,287,408,695
2013,8,10,5,13,357,441,798
2013,8,10,5,14,443,449,892
2013,8,10,5,15,367,394,761
2013,8,10,5,16,369,415,784
2013,8,10,5,17,433,416,849
2013,8,10,5,18,303,433,736
2013,8,10,5,19,271,395,666
2013,8,10,5,20,232,267,499
2013,8,10,5,21,118,223,341
2013,8,10,5,22,126,263,389
2013,8,10,5,23,80,167,247
2013,8,11,6,0,45,165,210
2013,8,11,6,1,36,142,178
2013,8,11,6,2,10,103,113
2013,8,11,6,3,17,51,68
2013,8,11,6,4,4,10,14
2013,8,11,6,5,2,14,16
2013,8,11,6,6,7,38,45
2013,8,11,6,7,16,53,69
2013,8,11,6,8,70,119,189
2013,8,11,6,9,132,223,355
2013,8,11,6,10,251,314,565
2013,8,11,6,11,320,395,715
2013,8,11,6,12,323,409,732
2013,8,11,6,13,378,392,770
2013,8,11,6,14,401,452,853
2013,8,11,6,15,320,401,721
2013,8,11,6,16,371,426,797
2013,8,11,6,17,319,435,754
2013,8,11,6,18,261,439,700
2013,8,11,6,19,217,393,610
2013,8,11,6,20,144,304,448
2013,8,11,6,21,122,220,342
2013,8,11,6,22,67,145,212
2013,8,11,6,23,43,77,120
2013,8,12,0,0,21,46,67
2013,8,12,0,1,7,22,29
2013,8,12,0,2,2,14,16
2013,8,12,0,3,3,7,10
2013,8,12,0,4,1,3,4
2013,8,12,0,5,8,55,63
2013,8,12,0,6,9,198,207
2013,8,12,0,7,28,519,547
2013,8,12,0,8,56,792,848
2013,8,12,0,9,98,318,416
2013,8,12,0,10,138,159,297
2013,8,12,0,11,147,187,334
2013,8,12,0,12,163,258,421
2013,8,12,0,13,141,263,404
2013,8,12,0,14,178,211,389
2013,8,12,0,15,137,254,391
2013,8,12,0,16,164,442,606
2013,8,12,0,17,184,982,1166
2013,8,12,0,18,190,881,1071
2013,8,12,0,19,165,705,870
2013,8,12,0,20,139,487,626
2013,8,12,0,21,98,308,406
2013,8,12,0,22,48,235,283
2013,8,12,0,23,29,113,142
2013,8,13,1,0,21,40,61
2013,8,13,1,1,11,12,23
2013,8,13,1,2,1,11,12
2013,8,13,1,3,4,4,8
2013,8,13,1,4,1,7,8
2013,8,13,1,5,3,62,65
2013,8,13,1,6,10,161,171
2013,8,13,1,7,12,467,479
2013,8,13,1,8,20,490,510
2013,8,13,1,9,49,360,409
2013,8,13,1,10,93,172,265
2013,8,13,1,11,91,193,284
2013,8,13,1,12,115,256,371
2013,8,13,1,13,105,278,383
2013,8,13,1,14,120,219,339
2013,8,13,1,15,139,262,401
2013,8,13,1,16,158,425,583
2013,8,13,1,17,148,975,1123
2013,8,13,1,18,169,872,1041
2013,8,13,1,19,136,654,790
2013,8,13,1,20,63,269,332
2013,8,13,1,21,51,266,317
2013,8,13,1,22,41,210,251
2013,8,13,1,23,30,139,169
2013,8,14,2,0,12,65,77
2013,8,14,2,1,2,21,23
2013,8,14,2,2,1,7,8
2013,8,14,2,3,0,4,4
2013,8,14,2,4,2,9,11
2013,8,14,2,5,4,45,49
2013,8,14,2,6,12,195,207
2013,8,14,2,7,24,619,643
2013,8,14,2,8,47,859,906
2013,8,14,2,9,80,401,481
2013,8,14,2,10,99,200,299
2013,8,14,2,11,120,216,336
2013,8,14,2,12,123,296,419
2013,8,14,2,13,145,300,445
2013,8,14,2,14,113,283,396
2013,8,14,2,15,152,314,466
2013,8,14,2,16,166,482,648
2013,8,14,2,17,211,1037,1248
2013,8,14,2,18,195,1019,1214
2013,8,14,2,19,182,712,894
2013,8,14,2,20,114,521,635
2013,8,14,2,21,90,386,476
2013,8,14,2,22,70,324,394
2013,8,14,2,23,35,183,218
2013,8,15,3,0,10,64,74
2013,8,15,3,1,4,25,29
2013,8,15,3,2,2,10,12
2013,8,15,3,3,0,4,4
2013,8,15,3,4,1,7,8
2013,8,15,3,5,4,52,56
2013,8,15,3,6,11,208,219
2013,8,15,3,7,27,606,633
2013,8,15,3,8,64,931,995
2013,8,15,3,9,67,374,441
2013,8,15,3,10,121,229,350
2013,8,15,3,11,127,282,409
2013,8,15,3,12,160,339,499
2013,8,15,3,13,150,322,472
2013,8,15,3,14,193,296,489
2013,8,15,3,15,194,373,567
2013,8,15,3,16,191,506,697
2013,8,15,3,17,204,985,1189
2013,8,15,3,18,169,930,1099
2013,8,15,3,19,172,731,903
2013,8,15,3,20,121,534,655
2013,8,15,3,21,91,371,462
2013,8,15,3,22,66,238,304
2013,8,15,3,23,43,191,234
2013,8,16,4,0,41,71,112
2013,8,16,4,1,6,44,50
2013,8,16,4,2,5,14,19
2013,8,16,4,3,0,8,8
2013,8,16,4,4,1,8,9
2013,8,16,4,5,2,50,52
2013,8,16,4,6,22,164,186
2013,8,16,4,7,30,455,485
2013,8,16,4,8,54,894,948
2013,8,16,4,9,74,407,481
2013,8,16,4,10,147,243,390
2013,8,16,4,11,206,320,526
2013,8,16,4,12,193,408,601
2013,8,16,4,13,242,369,611
2013,8,16,4,14,225,323,548
2013,8,16,4,15,271,369,640
2013,8,16,4,16,280,546,826
2013,8,16,4,17,240,845,1085
2013,8,16,4,18,204,769,973
2013,8,16,4,19,156,565,721
2013,8,16,4,20,173,439,612
2013,8,16,4,21,104,311,415
2013,8,16,4,22,73,239,312
2013,8,16,4,23,47,232,279
2013,8,17,5,0,34,146,180
2013,8,17,5,1,26,122,148
2013,8,17,5,2,19,62,81
2013,8,17,5,3,13,34,47
2013,8,17,5,4,5,8,13
2013,8,17,5,5,5,18,23
2013,8,17,5,6,7,29,36
2013,8,17,5,7,15,98,113
2013,8,17,5,8,37,190,227
2013,8,17,5,9,149,294,443
2013,8,17,5,10,241,396,637
2013,8,17,5,11,312,424,736
2013,8,17,5,12,411,460,871
2013,8,17,5,13,406,512,918
2013,8,17,5,14,454,511,965
2013,8,17,5,15,508,459,967
2013,8,17,5,16,459,433,892
2013,8,17,5,17,451,448,899
2013,8,17,5,18,356,423,779
2013,8,17,5,19,260,425,685
2013,8,17,5,20,191,288,479
2013,8,17,5,21,187,277,464
2013,8,17,5,22,135,202,337
2013,8,17,5,23,59,169,228
2013,8,18,6,0,61,154,215
2013,8,18,6,1,18,116,134
2013,8,18,6,2,17,81,98
2013,8,18,6,3,4,31,35
2013,8,18,6,4,1,7,8
2013,8,18,6,5,5,9,14
2013,8,18,6,6,5,13,18
2013,8,18,6,7,9,23,32
2013,8,18,6,8,25,65,90
2013,8,18,6,9,28,80,108
2013,8,18,6,10,65,172,237
2013,8,18,6,11,87,246,333
2013,8,18,6,12,110,237,347
2013,8,18,6,13,56,174,230
2013,8,18,6,14,100,227,327
2013,8,18,6,15,172,298,470
2013,8,18,6,16,209,362,571
2013,8,18,6,17,198,380,578
2013,8,18,6,18,172,368,540
2013,8,18,6,19,154,373,527
2013,8,18,6,20,89,263,352
2013,8,18,6,21,76,169,245
2013,8,18,6,22,61,134,195
2013,8,18,6,23,28,103,131
2013,8,19,0,0,18,38,56
2013,8,19,0,1,10,13,23
2013,8,19,0,2,2,18,20
2013,8,19,0,3,1,2,3
2013,8,19,0,4,0,4,4
2013,8,19,0,5,2,46,48
2013,8,19,0,6,12,202,214
2013,8,19,0,7,17,547,564
2013,8,19,0,8,49,748,797
2013,8,19,0,9,54,292,346
2013,8,19,0,10,110,168,278
2013,8,19,0,11,126,186,312
2013,8,19,0,12,125,225,350
2013,8,19,0,13,150,263,413
2013,8,19,0,14,150,205,355
2013,8,19,0,15,169,277,446
2013,8,19,0,16,199,485,684
2013,8,19,0,17,148,958,1106
2013,8,19,0,18,155,864,1019
2013,8,19,0,19,123,635,758
2013,8,19,0,20,71,420,491
2013,8,19,0,21,69,309,378
2013,8,19,0,22,53,185,238
2013,8,19,0,23,34,129,163
2013,8,20,1,0,20,35,55
2013,8,20,1,1,2,22,24
2013,8,20,1,2,18,11,29
2013,8,20,1,3,2,1,3
2013,8,20,1,4,0,5,5
2013,8,20,1,5,1,43,44
2013,8,20,1,6,10,219,229
2013,8,20,1,7,36,624,660
2013,8,20,1,8,39,881,920
2013,8,20,1,9,55,395,450
2013,8,20,1,10,86,199,285
2013,8,20,1,11,129,209,338
2013,8,20,1,12,130,288,418
2013,8,20,1,13,150,258,408
2013,8,20,1,14,138,220,358
2013,8,20,1,15,144,265,409
2013,8,20,1,16,139,477,616
2013,8,20,1,17,165,961,1126
2013,8,20,1,18,124,994,1118
2013,8,20,1,19,137,692,829
2013,8,20,1,20,71,485,556
2013,8,20,1,21,77,331,408
2013,8,20,1,22,34,230,264
2013,8,20,1,23,19,121,140
2013,8,21,2,0,13,53,66
2013,8,21,2,1,6,24,30
2013,8,21,2,2,3,5,8
2013,8,21,2,3,0,4,4
2013,8,21,2,4,0,3,3
2013,8,21,2,5,3,60,63
2013,8,21,2,6,12,221,233
2013,8,21,2,7,32,603,635
2013,8,21,2,8,39,886,925
2013,8,21,2,9,71,349,420
2013,8,21,2,10,71,176,247
2013,8,21,2,11,119,208,327
2013,8,21,2,12,102,291,393
2013,8,21,2,13,134,281,415
2013,8,21,2,14,114,235,349
2013,8,21,2,15,130,265,395
2013,8,21,2,16,134,434,568
2013,8,21,2,17,170,962,1132
2013,8,21,2,18,178,936,1114
2013,8,21,2,19,161,687,848
2013,8,21,2,20,96,456,552
2013,8,21,2,21,31,223,254
2013,8,21,2,22,18,147,165
2013,8,21,2,23,10,85,95
2013,8,22,3,0,7,42,49
2013,8,22,3,1,4,23,27
2013,8,22,3,2,1,12,13
2013,8,22,3,3,0,6,6
2013,8,22,3,4,0,6,6
2013,8,22,3,5,1,53,54
2013,8,22,3,6,10,213,223
2013,8,22,3,7,19,583,602
2013,8,22,3,8,46,820,866
2013,8,22,3,9,78,352,430
2013,8,22,3,10,106,187,293
2013,8,22,3,11,120,193,313
2013,8,22,3,12,172,315,487
2013,8,22,3,13,133,316,449
2013,8,22,3,14,123,235,358
2013,8,22,3,15,125,273,398
2013,8,22,3,16,149,472,621
2013,8,22,3,17,160,893,1053
2013,8,22,3,18,177,943,1120
2013,8,22,3,19,138,645,783
2013,8,22,3,20,93,471,564
2013,8,22,3,21,76,331,407
2013,8,22,3,22,86,238,324
2013,8,22,3,23,37,167,204
2013,8,23,4,0,14,88,102
2013,8,23,4,1,10,37,47
2013,8,23,4,2,3,22,25
2013,8,23,4,3,0,5,5
2013,8,23,4,4,0,8,8
2013,8,23,4,5,1,57,58
2013,8,23,4,6,6,184,190
2013,8,23,4,7,29,496,525
2013,8,23,4,8,37,804,841
2013,8,23,4,9,39,388,427
2013,8,23,4,10,95,225,320
2013,8,23,4,11,63,164,227
2013,8,23,4,12,21,95,116
2013,8,23,4,13,44,123,167
2013,8,23,4,14,59,169,228
2013,8,23,4,15,93,306,399
2013,8,23,4,16,113,415,528
2013,8,23,4,17,107,765,872
2013,8,23,4,18,105,635,740
2013,8,23,4,19,106,504,610
2013,8,23,4,20,65,359,424
2013,8,23,4,21,55,284,339
2013,8,23,4,22,42,224,266
2013,8,23,4,23,51,184,235
2013,8,24,5,0,23,172,195
2013,8,24,5,1,19,96,115
2013,8,24,5,2,15,70,85
2013,8,24,5,3,7,36,43
2013,8,24,5,4,2,5,7
2013,8,24,5,5,4,18,22
2013,8,24,5,6,4,38,42
2013,8,24,5,7,25,128,153
2013,8,24,5,8,65,245,310
2013,8,24,5,9,121,338,459
2013,8,24,5,10,220,474,694
2013,8,24,5,11,263,527,790
2013,8,24,5,12,322,595,917
2013,8,24,5,13,370,570,940
2013,8,24,5,14,389,539,928
2013,8,24,5,15,315,516,831
2013,8,24,5,16,316,489,805
2013,8,24,5,17,337,450,787
2013,8,24,5,18,274,478,752
2013,8,24,5,19,219,409,628
2013,8,24,5,20,150,287,437
2013,8,24,5,21,120,295,415
2013,8,24,5,22,118,222,340
2013,8,24,5,23,85,210,295
2013,8,25,6,0,59,190,249
2013,8,25,6,1,33,129,162
2013,8,25,6,2,28,77,105
2013,8,25,6,3,8,37,45
2013,8,25,6,4,7,12,19
2013,8,25,6,5,5,13,18
2013,8,25,6,6,5,24,29
2013,8,25,6,7,39,65,104
2013,8,25,6,8,41,135,176
2013,8,25,6,9,99,221,320
2013,8,25,6,10,231,401,632
2013,8,25,6,11,251,430,681
2013,8,25,6,12,281,485,766
2013,8,25,6,13,303,514,817
2013,8,25,6,14,311,477,788
2013,8,25,6,15,326,477,803
2013,8,25,6,16,302,493,795
2013,8,25,6,17,286,457,743
2013,8,25,6,18,210,474,684
2013,8,25,6,19,193,433,626
2013,8,25,6,20,103,274,377
2013,8,25,6,21,82,212,294
2013,8,25,6,22,80,154,234
2013,8,25,6,23,44,73,117
2013,8,26,0,0,23,40,63
2013,8,26,0,1,2,16,18
2013,8,26,0,2,3,5,8
2013,8,26,0,3,5,6,11
2013,8,26,0,4,4,7,11
2013,8,26,0,5,3,57,60
2013,8,26,0,6,10,198,208
2013,8,26,0,7,17,635,652
2013,8,26,0,8,38,799,837
2013,8,26,0,9,49,340,389
2013,8,26,0,10,124,177,301
2013,8,26,0,11,131,181,312
2013,8,26,0,12,119,294,413
2013,8,26,0,13,102,296,398
2013,8,26,0,14,112,251,363
2013,8,26,0,15,132,291,423
2013,8,26,0,16,142,452,594
2013,8,26,0,17,169,1020,1189
2013,8,26,0,18,127,861,988
2013,8,26,0,19,127,709,836
2013,8,26,0,20,86,462,548
2013,8,26,0,21,76,300,376
2013,8,26,0,22,57,197,254
2013,8,26,0,23,29,104,133
2013,8,27,1,0,19,51,70
2013,8,27,1,1,7,21,28
2013,8,27,1,2,2,9,11
2013,8,27,1,3,2,4,6
2013,8,27,1,4,2,7,9
2013,8,27,1,5,1,61,62
2013,8,27,1,6,10,231,241
2013,8,27,1,7,27,644,671
2013,8,27,1,8,52,860,912
2013,8,27,1,9,81,397,478
2013,8,27,1,10,98,187,285
2013,8,27,1,11,106,201,307
2013,8,27,1,12,110,314,424
2013,8,27,1,13,110,241,351
2013,8,27,1,14,114,256,370
2013,8,27,1,15,105,303,408
2013,8,27,1,16,123,484,607
2013,8,27,1,17,141,999,1140
2013,8,27,1,18,126,1007,1133
2013,8,27,1,19,99,698,797
2013,8,27,1,20,70,455,525
2013,8,27,1,21,57,330,387
2013,8,27,1,22,44,187,231
2013,8,27,1,23,32,137,169
2013,8,28,2,0,21,58,79
2013,8,28,2,1,4,22,26
2013,8,28,2,2,7,11,18
2013,8,28,2,3,2,5,7
2013,8,28,2,4,2,7,9
2013,8,28,2,5,1,62,63
2013,8,28,2,6,8,220,228
2013,8,28,2,7,19,484,503
2013,8,28,2,8,55,770,825
2013,8,28,2,9,61,342,403
2013,8,28,2,10,57,164,221
2013,8,28,2,11,75,209,284
2013,8,28,2,12,60,326,386
2013,8,28,2,13,43,184,227
2013,8,28,2,14,60,194,254
2013,8,28,2,15,60,260,320
2013,8,28,2,16,80,480,560
2013,8,28,2,17,101,806,907
2013,8,28,2,18,105,765,870
2013,8,28,2,19,49,435,484
2013,8,28,2,20,45,349,394
2013,8,28,2,21,39,251,290
2013,8,28,2,22,22,210,232
2013,8,28,2,23,17,128,145
2013,8,29,3,0,15,63,78
2013,8,29,3,1,4,21,25
2013,8,29,3,2,5,8,13
2013,8,29,3,3,2,6,8
2013,8,29,3,4,2,4,6
2013,8,29,3,5,1,46,47
2013,8,29,3,6,14,208,222
2013,8,29,3,7,22,545,567
2013,8,29,3,8,46,855,901
2013,8,29,3,9,75,365,440
2013,8,29,3,10,93,185,278
2013,8,29,3,11,116,211,327
2013,8,29,3,12,116,311,427
2013,8,29,3,13,111,272,383
2013,8,29,3,14,99,262,361
2013,8,29,3,15,120,317,437
2013,8,29,3,16,156,478,634
2013,8,29,3,17,183,908,1091
2013,8,29,3,18,131,873,1004
2013,8,29,3,19,118,605,723
2013,8,29,3,20,56,483,539
2013,8,29,3,21,75,329,404
2013,8,29,3,22,52,243,295
2013,8,29,3,23,34,191,225
2013,8,30,4,0,49,89,138
2013,8,30,4,1,17,39,56
2013,8,30,4,2,1,21,22
2013,8,30,4,3,3,9,12
2013,8,30,4,4,3,10,13
2013,8,30,4,5,1,44,45
2013,8,30,4,6,13,141,154
2013,8,30,4,7,30,439,469
2013,8,30,4,8,42,811,853
2013,8,30,4,9,63,411,474
2013,8,30,4,10,118,254,372
2013,8,30,4,11,155,258,413
2013,8,30,4,12,161,354,515
2013,8,30,4,13,169,346,515
2013,8,30,4,14,219,382,601
2013,8,30,4,15,208,503,711
2013,8,30,4,16,182,592,774
2013,8,30,4,17,229,747,976
2013,8,30,4,18,185,603,788
2013,8,30,4,19,144,436,580
2013,8,30,4,20,109,320,429
2013,8,30,4,21,99,285,384
2013,8,30,4,22,65,205,270
2013,8,30,4,23,41,143,184
2013,8,31,5,0,38,122,160
2013,8,31,5,1,24,92,116
2013,8,31,5,2,10,86,96
2013,8,31,5,3,4,23,27
2013,8,31,5,4,7,14,21
2013,8,31,5,5,4,11,15
2013,8,31,5,6,12,29,41
2013,8,31,5,7,19,84,103
2013,8,31,5,8,50,186,236
2013,8,31,5,9,123,274,397
2013,8,31,5,10,228,328,556
2013,8,31,5,11,278,389,667
2013,8,31,5,12,372,408,780
2013,8,31,5,13,415,346,761
2013,8,31,5,14,399,328,727
2013,8,31,5,15,466,342,808
2013,8,31,5,16,391,347,738
2013,8,31,5,17,383,337,720
2013,8,31,5,18,316,311,627
2013,8,31,5,19,255,294,549
2013,8,31,5,20,192,199,391
2013,8,31,5,21,168,170,338
2013,8,31,5,22,129,198,327
2013,8,31,5,23,82,196,278
2013,9,1,6,0,43,148,191
2013,9,1,6,1,31,118,149
2013,9,1,6,2,38,66,104
2013,9,1,6,3,17,33,50
2013,9,1,6,4,4,20,24
2013,9,1,6,5,1,17,18
2013,9,1,6,6,10,17,27
2013,9,1,6,7,30,54,84
2013,9,1,6,8,59,103,162
2013,9,1,6,9,169,198,367
2013,9,1,6,10,267,289,556
2013,9,1,6,11,315,308,623
2013,9,1,6,12,421,362,783
2013,9,1,6,13,427,349,776
2013,9,1,6,14,431,282,713
2013,9,1,6,15,388,294,682
2013,9,1,6,16,378,272,650
2013,9,1,6,17,374,305,679
2013,9,1,6,18,381,357,738
2013,9,1,6,19,295,314,609
2013,9,1,6,20,212,210,422
2013,9,1,6,21,180,179,359
2013,9,1,6,22,126,168,294
2013,9,1,6,23,100,140,240
2013,9,2,0,0,60,116,176
2013,9,2,0,1,5,48,53
2013,9,2,0,2,11,39,50
2013,9,2,0,3,5,13,18
2013,9,2,0,4,1,5,6
2013,9,2,0,5,1,8,9
2013,9,2,0,6,10,25,35
2013,9,2,0,7,39,55,94
2013,9,2,0,8,65,117,182
2013,9,2,0,9,165,187,352
2013,9,2,0,10,289,272,561
2013,9,2,0,11,307,336,643
2013,9,2,0,12,296,428,724
2013,9,2,0,13,312,423,735
2013,9,2,0,14,293,398,691
2013,9,2,0,15,305,334,639
2013,9,2,0,16,272,344,616
2013,9,2,0,17,191,383,574
2013,9,2,0,18,187,377,564
2013,9,2,0,19,130,365,495
2013,9,2,0,20,128,249,377
2013,9,2,0,21,74,188,262
2013,9,2,0,22,34,136,170
2013,9,2,0,23,21,75,96
2013,9,3,1,0,9,35,44
2013,9,3,1,1,8,15,23
2013,9,3,1,2,4,11,15
2013,9,3,1,3,0,2,2
2013,9,3,1,4,5,12,17
2013,9,3,1,5,3,44,47
2013,9,3,1,6,10,200,210
2013,9,3,1,7,35,614,649
2013,9,3,1,8,53,737,790
2013,9,3,1,9,56,339,395
2013,9,3,1,10,69,192,261
2013,9,3,1,11,91,203,294
2013,9,3,1,12,103,278,381
2013,9,3,1,13,98,256,354
2013,9,3,1,14,99,252,351
2013,9,3,1,15,113,260,373
2013,9,3,1,16,111,455,566
2013,9,3,1,17,150,896,1046
2013,9,3,1,18,111,1019,1130
2013,9,3,1,19,105,657,762
2013,9,3,1,20,52,436,488
2013,9,3,1,21,45,337,382
2013,9,3,1,22,35,213,248
2013,9,3,1,23,9,107,116
2013,9,4,2,0,24,55,79
2013,9,4,2,1,5,21,26
2013,9,4,2,2,0,3,3
2013,9,4,2,3,0,3,3
2013,9,4,2,4,1,10,11
2013,9,4,2,5,1,71,72
2013,9,4,2,6,16,204,220
2013,9,4,2,7,35,726,761
2013,9,4,2,8,41,882,923
2013,9,4,2,9,57,384,441
2013,9,4,2,10,107,189,296
2013,9,4,2,11,111,218,329
2013,9,4,2,12,87,305,392
2013,9,4,2,13,104,285,389
2013,9,4,2,14,110,250,360
2013,9,4,2,15,83,314,397
2013,9,4,2,16,119,515,634
2013,9,4,2,17,157,1051,1208
2013,9,4,2,18,135,973,1108
2013,9,4,2,19,140,702,842
2013,9,4,2,20,71,450,521
2013,9,4,2,21,53,324,377
2013,9,4,2,22,57,240,297
2013,9,4,2,23,18,119,137
2013,9,5,3,0,14,53,67
2013,9,5,3,1,5,23,28
2013,9,5,3,2,2,12,14
2013,9,5,3,3,0,4,4
2013,9,5,3,4,1,5,6
2013,9,5,3,5,3,50,53
2013,9,5,3,6,16,223,239
2013,9,5,3,7,36,699,735
2013,9,5,3,8,46,880,926
2013,9,5,3,9,73,403,476
2013,9,5,3,10,85,217,302
2013,9,5,3,11,73,217,290
2013,9,5,3,12,107,331,438
2013,9,5,3,13,101,325,426
2013,9,5,3,14,112,271,383
2013,9,5,3,15,119,290,409
2013,9,5,3,16,133,502,635
2013,9,5,3,17,148,1029,1177
2013,9,5,3,18,125,951,1076
2013,9,5,3,19,129,690,819
2013,9,5,3,20,92,508,600
2013,9,5,3,21,76,345,421
2013,9,5,3,22,60,245,305
2013,9,5,3,23,19,159,178
2013,9,6,4,0,14,100,114
2013,9,6,4,1,2,53,55
2013,9,6,4,2,5,21,26
2013,9,6,4,3,0,6,6
2013,9,6,4,4,2,5,7
2013,9,6,4,5,5,45,50
2013,9,6,4,6,7,200,207
2013,9,6,4,7,23,631,654
2013,9,6,4,8,61,935,996
2013,9,6,4,9,60,376,436
2013,9,6,4,10,92,227,319
2013,9,6,4,11,112,285,397
2013,9,6,4,12,123,381,504
2013,9,6,4,13,155,353,508
2013,9,6,4,14,127,336,463
2013,9,6,4,15,143,380,523
2013,9,6,4,16,139,541,680
2013,9,6,4,17,194,985,1179
2013,9,6,4,18,146,821,967
2013,9,6,4,19,122,588,710
2013,9,6,4,20,87,386,473
2013,9,6,4,21,75,306,381
2013,9,6,4,22,67,262,329
2013,9,6,4,23,53,221,274
2013,9,7,5,0,50,196,246
2013,9,7,5,1,19,114,133
2013,9,7,5,2,11,72,83
2013,9,7,5,3,7,29,36
2013,9,7,5,4,2,11,13
2013,9,7,5,5,3,14,17
2013,9,7,5,6,8,53,61
2013,9,7,5,7,15,96,111
2013,9,7,5,8,45,207,252
2013,9,7,5,9,109,356,465
2013,9,7,5,10,178,414,592
2013,9,7,5,11,226,529,755
2013,9,7,5,12,276,572,848
2013,9,7,5,13,317,490,807
2013,9,7,5,14,329,496,825
2013,9,7,5,15,276,528,804
2013,9,7,5,16,304,477,781
2013,9,7,5,17,292,482,774
2013,9,7,5,18,226,495,721
2013,9,7,5,19,183,442,625
2013,9,7,5,20,127,315,442
2013,9,7,5,21,83,240,323
2013,9,7,5,22,68,219,287
2013,9,7,5,23,57,178,235
2013,9,8,6,0,49,207,256
2013,9,8,6,1,17,126,143
2013,9,8,6,2,12,89,101
2013,9,8,6,3,10,40,50
2013,9,8,6,4,6,10,16
2013,9,8,6,5,22,43,65
2013,9,8,6,6,16,42,58
2013,9,8,6,7,29,72,101
2013,9,8,6,8,64,156,220
2013,9,8,6,9,128,300,428
2013,9,8,6,10,185,411,596
2013,9,8,6,11,273,496,769
2013,9,8,6,12,302,529,831
2013,9,8,6,13,298,522,820
2013,9,8,6,14,279,457,736
2013,9,8,6,15,281,446,727
2013,9,8,6,16,276,514,790
2013,9,8,6,17,236,486,722
2013,9,8,6,18,206,440,646
2013,9,8,6,19,136,334,470
2013,9,8,6,20,69,309,378
2013,9,8,6,21,50,211,261
2013,9,8,6,22,62,145,207
2013,9,8,6,23,29,96,125
2013,9,9,0,0,8,28,36
2013,9,9,0,1,5,21,26
2013,9,9,0,2,1,11,12
2013,9,9,0,3,1,5,6
2013,9,9,0,4,2,9,11
2013,9,9,0,5,4,56,60
2013,9,9,0,6,11,211,222
2013,9,9,0,7,32,648,680
2013,9,9,0,8,48,820,868
2013,9,9,0,9,61,361,422
2013,9,9,0,10,87,176,263
2013,9,9,0,11,116,189,305
2013,9,9,0,12,88,278,366
2013,9,9,0,13,105,266,371
2013,9,9,0,14,101,245,346
2013,9,9,0,15,97,288,385
2013,9,9,0,16,121,505,626
2013,9,9,0,17,132,1033,1165
2013,9,9,0,18,135,955,1090
2013,9,9,0,19,68,612,680
2013,9,9,0,20,55,378,433
2013,9,9,0,21,50,317,367
2013,9,9,0,22,31,217,248
2013,9,9,0,23,23,130,153
2013,9,10,1,0,7,36,43
2013,9,10,1,1,3,26,29
2013,9,10,1,2,2,8,10
2013,9,10,1,3,0,2,2
2013,9,10,1,4,3,12,15
2013,9,10,1,5,3,57,60
2013,9,10,1,6,15,243,258
2013,9,10,1,7,52,746,798
2013,9,10,1,8,47,874,921
2013,9,10,1,9,57,357,414
2013,9,10,1,10,73,152,225
2013,9,10,1,11,111,211,322
2013,9,10,1,12,88,333,421
2013,9,10,1,13,75,272,347
2013,9,10,1,14,109,209,318
2013,9,10,1,15,90,273,363
2013,9,10,1,16,109,466,575
2013,9,10,1,17,144,960,1104
2013,9,10,1,18,127,989,1116
2013,9,10,1,19,116,673,789
2013,9,10,1,20,84,495,579
2013,9,10,1,21,49,343,392
2013,9,10,1,22,54,263,317
2013,9,10,1,23,18,134,152
2013,9,11,2,0,13,57,70
2013,9,11,2,1,8,24,32
2013,9,11,2,2,7,9,16
2013,9,11,2,3,0,5,5
2013,9,11,2,4,1,8,9
2013,9,11,2,5,5,66,71
2013,9,11,2,6,11,226,237
2013,9,11,2,7,42,646,688
2013,9,11,2,8,47,938,985
2013,9,11,2,9,48,359,407
2013,9,11,2,10,60,175,235
2013,9,11,2,11,62,192,254
2013,9,11,2,12,69,264,333
2013,9,11,2,13,77,241,318
2013,9,11,2,14,59,209,268
2013,9,11,2,15,69,266,335
2013,9,11,2,16,110,430,540
2013,9,11,2,17,121,968,1089
2013,9,11,2,18,112,947,1059
2013,9,11,2,19,114,712,826
2013,9,11,2,20,74,493,567
2013,9,11,2,21,62,357,419
2013,9,11,2,22,63,253,316
2013,9,11,2,23,37,151,188
2013,9,12,3,0,18,64,82
2013,9,12,3,1,7,31,38
2013,9,12,3,2,0,9,9
2013,9,12,3,3,0,8,8
2013,9,12,3,4,2,13,15
2013,9,12,3,5,7,57,64
2013,9,12,3,6,11,232,243
2013,9,12,3,7,30,722,752
2013,9,12,3,8,35,912,947
2013,9,12,3,9,48,399,447
2013,9,12,3,10,81,221,302
2013,9,12,3,11,89,191,280
2013,9,12,3,12,84,241,325
2013,9,12,3,13,84,245,329
2013,9,12,3,14,60,196,256
2013,9,12,3,15,100,265,365
2013,9,12,3,16,85,372,457
2013,9,12,3,17,37,274,311
2013,9,12,3,18,30,270,300
2013,9,12,3,19,36,378,414
2013,9,12,3,20,33,359,392
2013,9,12,3,21,28,307,335
2013,9,12,3,22,27,221,248
2013,9,12,3,23,14,146,160
2013,9,13,4,0,17,74,91
2013,9,13,4,1,6,35,41
2013,9,13,4,2,0,23,23
2013,9,13,4,3,1,8,9
2013,9,13,4,4,2,9,11
2013,9,13,4,5,5,55,60
2013,9,13,4,6,3,203,206
2013,9,13,4,7,24,611,635
2013,9,13,4,8,38,888,926
2013,9,13,4,9,56,365,421
2013,9,13,4,10,58,219,277
2013,9,13,4,11,110,266,376
2013,9,13,4,12,116,353,469
2013,9,13,4,13,125,340,465
2013,9,13,4,14,123,351,474
2013,9,13,4,15,120,398,518
2013,9,13,4,16,135,610,745
2013,9,13,4,17,159,992,1151
2013,9,13,4,18,113,865,978
2013,9,13,4,19,109,587,696
2013,9,13,4,20,85,412,497
2013,9,13,4,21,81,295,376
2013,9,13,4,22,66,316,382
2013,9,13,4,23,38,191,229
2013,9,14,5,0,41,141,182
2013,9,14,5,1,23,125,148
2013,9,14,5,2,26,89,115
2013,9,14,5,3,14,43,57
2013,9,14,5,4,2,12,14
2013,9,14,5,5,0,14,14
2013,9,14,5,6,7,55,62
2013,9,14,5,7,23,115,138
2013,9,14,5,8,55,226,281
2013,9,14,5,9,110,343,453
2013,9,14,5,10,181,443,624
2013,9,14,5,11,299,518,817
2013,9,14,5,12,332,577,909
2013,9,14,5,13,403,548,951
2013,9,14,5,14,369,549,918
2013,9,14,5,15,424,527,951
2013,9,14,5,16,367,495,862
2013,9,14,5,17,355,503,858
2013,9,14,5,18,339,499,838
2013,9,14,5,19,234,403,637
2013,9,14,5,20,130,317,447
2013,9,14,5,21,82,295,377
2013,9,14,5,22,83,259,342
2013,9,14,5,23,47,227,274
2013,9,15,6,0,30,160,190
2013,9,15,6,1,24,152,176
2013,9,15,6,2,13,108,121
2013,9,15,6,3,16,54,70
2013,9,15,6,4,0,5,5
2013,9,15,6,5,2,9,11
2013,9,15,6,6,5,14,19
2013,9,15,6,7,4,48,52
2013,9,15,6,8,51,155,206
2013,9,15,6,9,128,241,369
2013,9,15,6,10,221,413,634
2013,9,15,6,11,262,521,783
2013,9,15,6,12,331,626,957
2013,9,15,6,13,352,487,839
2013,9,15,6,14,318,511,829
2013,9,15,6,15,298,445,743
2013,9,15,6,16,301,563,864
2013,9,15,6,17,288,530,818
2013,9,15,6,18,196,506,702
2013,9,15,6,19,143,387,530
2013,9,15,6,20,103,305,408
2013,9,15,6,21,59,185,244
2013,9,15,6,22,32,140,172
2013,9,15,6,23,27,86,113
2013,9,16,0,0,12,51,63
2013,9,16,0,1,9,13,22
2013,9,16,0,2,2,8,10
2013,9,16,0,3,2,7,9
2013,9,16,0,4,0,7,7
2013,9,16,0,5,2,62,64
2013,9,16,0,6,6,219,225
2013,9,16,0,7,23,636,659
2013,9,16,0,8,38,872,910
2013,9,16,0,9,41,289,330
2013,9,16,0,10,36,98,134
2013,9,16,0,11,52,130,182
2013,9,16,0,12,48,260,308
2013,9,16,0,13,82,227,309
2013,9,16,0,14,71,225,296
2013,9,16,0,15,81,269,350
2013,9,16,0,16,92,481,573
2013,9,16,0,17,109,972,1081
2013,9,16,0,18,106,897,1003
2013,9,16,0,19,77,578,655
2013,9,16,0,20,74,383,457
2013,9,16,0,21,50,293,343
2013,9,16,0,22,48,200,248
2013,9,16,0,23,24,97,121
2013,9,17,1,0,7,41,48
2013,9,17,1,1,1,17,18
2013,9,17,1,2,0,11,11
2013,9,17,1,3,0,5,5
2013,9,17,1,4,1,8,9
2013,9,17,1,5,1,64,65
2013,9,17,1,6,10,251,261
2013,9,17,1,7,30,745,775
2013,9,17,1,8,39,877,916
2013,9,17,1,9,46,369,415
2013,9,17,1,10,79,205,284
2013,9,17,1,11,109,212,321
2013,9,17,1,12,87,338,425
2013,9,17,1,13,85,300,385
2013,9,17,1,14,109,314,423
2013,9,17,1,15,98,340,438
2013,9,17,1,16,125,585,710
2013,9,17,1,17,93,1074,1167
2013,9,17,1,18,140,1077,1217
2013,9,17,1,19,63,651,714
2013,9,17,1,20,48,443,491
2013,9,17,1,21,53,399,452
2013,9,17,1,22,20,249,269
2013,9,17,1,23,25,124,149
2013,9,18,2,0,8,55,63
2013,9,18,2,1,3,25,28
2013,9,18,2,2,0,9,9
2013,9,18,2,3,0,3,3
2013,9,18,2,4,2,13,15
2013,9,18,2,5,4,58,62
2013,9,18,2,6,4,223,227
2013,9,18,2,7,29,734,763
2013,9,18,2,8,36,952,988
2013,9,18,2,9,29,423,452
2013,9,18,2,10,59,208,267
2013,9,18,2,11,90,243,333
2013,9,18,2,12,112,297,409
2013,9,18,2,13,102,307,409
2013,9,18,2,14,115,305,420
2013,9,18,2,15,122,320,442
2013,9,18,2,16,112,523,635
2013,9,18,2,17,122,1143,1265
2013,9,18,2,18,109,1004,1113
2013,9,18,2,19,78,653,731
2013,9,18,2,20,55,450,505
2013,9,18,2,21,32,370,402
2013,9,18,2,22,50,298,348
2013,9,18,2,23,25,145,170
2013,9,19,3,0,17,45,62
2013,9,19,3,1,11,24,35
2013,9,19,3,2,2,11,13
2013,9,19,3,3,0,8,8
2013,9,19,3,4,5,8,13
2013,9,19,3,5,3,59,62
2013,9,19,3,6,10,233,243
2013,9,19,3,7,31,694,725
2013,9,19,3,8,44,952,996
2013,9,19,3,9,52,427,479
2013,9,19,3,10,103,243,346
2013,9,19,3,11,109,264,373
2013,9,19,3,12,119,327,446
2013,9,19,3,13,105,307,412
2013,9,19,3,14,140,293,433
2013,9,19,3,15,122,337,459
2013,9,19,3,16,140,498,638
2013,9,19,3,17,168,1078,1246
2013,9,19,3,18,162,978,1140
2013,9,19,3,19,95,635,730
2013,9,19,3,20,69,448,517
2013,9,19,3,21,60,420,480
2013,9,19,3,22,37,326,363
2013,9,19,3,23,33,209,242
2013,9,20,4,0,19,98,117
2013,9,20,4,1,5,47,52
2013,9,20,4,2,5,18,23
2013,9,20,4,3,3,4,7
2013,9,20,4,4,4,14,18
2013,9,20,4,5,2,45,47
2013,9,20,4,6,5,205,210
2013,9,20,4,7,22,647,669
2013,9,20,4,8,46,908,954
2013,9,20,4,9,63,441,504
2013,9,20,4,10,106,227,333
2013,9,20,4,11,125,295,420
2013,9,20,4,12,134,366,500
2013,9,20,4,13,141,342,483
2013,9,20,4,14,164,344,508
2013,9,20,4,15,208,417,625
2013,9,20,4,16,150,591,741
2013,9,20,4,17,173,1015,1188
2013,9,20,4,18,148,886,1034
2013,9,20,4,19,107,569,676
2013,9,20,4,20,90,414,504
2013,9,20,4,21,88,349,437
2013,9,20,4,22,69,282,351
2013,9,20,4,23,32,243,275
2013,9,21,5,0,35,172,207
2013,9,21,5,1,25,139,164
2013,9,21,5,2,29,82,111
2013,9,21,5,3,12,46,58
2013,9,21,5,4,6,15,21
2013,9,21,5,5,1,15,16
2013,9,21,5,6,4,34,38
2013,9,21,5,7,17,114,131
2013,9,21,5,8,35,230,265
2013,9,21,5,9,108,364,472
2013,9,21,5,10,210,459,669
2013,9,21,5,11,255,538,793
2013,9,21,5,12,339,577,916
2013,9,21,5,13,328,536,864
2013,9,21,5,14,283,480,763
2013,9,21,5,15,238,350,588
2013,9,21,5,16,74,145,219
2013,9,21,5,17,70,89,159
2013,9,21,5,18,23,97,120
2013,9,21,5,19,21,99,120
2013,9,21,5,20,13,55,68
2013,9,21,5,21,6,11,17
2013,9,21,5,22,3,33,36
2013,9,21,5,23,15,89,104
2013,9,22,6,0,16,93,109
2013,9,22,6,1,8,83,91
2013,9,22,6,2,2,46,48
2013,9,22,6,3,5,36,41
2013,9,22,6,4,3,11,14
2013,9,22,6,5,2,13,15
2013,9,22,6,6,6,19,25
2013,9,22,6,7,13,61,74
2013,9,22,6,8,48,171,219
2013,9,22,6,9,131,274,405
2013,9,22,6,10,189,457,646
2013,9,22,6,11,220,499,719
2013,9,22,6,12,245,620,865
2013,9,22,6,13,289,555,844
2013,9,22,6,14,321,530,851
2013,9,22,6,15,276,473,749
2013,9,22,6,16,293,645,938
2013,9,22,6,17,200,534,734
2013,9,22,6,18,185,462,647
2013,9,22,6,19,119,401,520
2013,9,22,6,20,81,295,376
2013,9,22,6,21,38,176,214
2013,9,22,6,22,40,153,193
2013,9,22,6,23,20,85,105
2013,9,23,0,0,4,48,52
2013,9,23,0,1,7,16,23
2013,9,23,0,2,1,6,7
2013,9,23,0,3,0,5,5
2013,9,23,0,4,1,12,13
2013,9,23,0,5,2,54,56
2013,9,23,0,6,3,199,202
2013,9,23,0,7,27,594,621
2013,9,23,0,8,42,808,850
2013,9,23,0,9,58,361,419
2013,9,23,0,10,61,179,240
2013,9,23,0,11,98,213,311
2013,9,23,0,12,92,300,392
2013,9,23,0,13,108,297,405
2013,9,23,0,14,113,280,393
2013,9,23,0,15,111,319,430
2013,9,23,0,16,115,499,614
2013,9,23,0,17,149,1072,1221
2013,9,23,0,18,116,933,1049
2013,9,23,0,19,63,639,702
2013,9,23,0,20,46,403,449
2013,9,23,0,21,32,288,320
2013,9,23,0,22,16,168,184
2013,9,23,0,23,7,102,109
2013,9,24,1,0,6,27,33
2013,9,24,1,1,5,19,24
2013,9,24,1,2,1,7,8
2013,9,24,1,3,2,1,3
2013,9,24,1,4,0,11,11
2013,9,24,1,5,4,53,57
2013,9,24,1,6,10,226,236
2013,9,24,1,7,22,711,733
2013,9,24,1,8,34,917,951
2013,9,24,1,9,43,398,441
2013,9,24,1,10,62,194,256
2013,9,24,1,11,84,255,339
2013,9,24,1,12,58,310,368
2013,9,24,1,13,69,271,340
2013,9,24,1,14,86,270,356
2013,9,24,1,15,95,304,399
2013,9,24,1,16,113,507,620
2013,9,24,1,17,131,1097,1228
2013,9,24,1,18,115,1068,1183
2013,9,24,1,19,72,705,777
2013,9,24,1,20,47,429,476
2013,9,24,1,21,39,332,371
2013,9,24,1,22,29,229,258
2013,9,24,1,23,17,121,138
2013,9,25,2,0,7,43,50
2013,9,25,2,1,2,21,23
2013,9,25,2,2,3,6,9
2013,9,25,2,3,0,1,1
2013,9,25,2,4,1,12,13
2013,9,25,2,5,1,54,55
2013,9,25,2,6,8,219,227
2013,9,25,2,7,35,662,697
2013,9,25,2,8,51,955,1006
2013,9,25,2,9,38,432,470
2013,9,25,2,10,48,258,306
2013,9,25,2,11,62,264,326
2013,9,25,2,12,53,327,380
2013,9,25,2,13,85,298,383
2013,9,25,2,14,93,255,348
2013,9,25,2,15,104,297,401
2013,9,25,2,16,98,534,632
2013,9,25,2,17,131,1062,1193
2013,9,25,2,18,113,980,1093
2013,9,25,2,19,74,659,733
2013,9,25,2,20,60,452,512
2013,9,25,2,21,62,312,374
2013,9,25,2,22,27,227,254
2013,9,25,2,23,13,116,129
2013,9,26,3,0,11,55,66
2013,9,26,3,1,5,29,34
2013,9,26,3,2,0,12,12
2013,9,26,3,3,0,4,4
2013,9,26,3,4,1,6,7
2013,9,26,3,5,1,57,58
2013,9,26,3,6,6,218,224
2013,9,26,3,7,28,690,718
2013,9,26,3,8,38,914,952
2013,9,26,3,9,45,433,478
2013,9,26,3,10,53,235,288
2013,9,26,3,11,91,215,306
2013,9,26,3,12,93,326,419
2013,9,26,3,13,89,294,383
2013,9,26,3,14,108,297,405
2013,9,26,3,15,92,344,436
2013,9,26,3,16,134,490,624
2013,9,26,3,17,182,1007,1189
2013,9,26,3,18,123,1076,1199
2013,9,26,3,19,62,650,712
2013,9,26,3,20,48,446,494
2013,9,26,3,21,31,353,384
2013,9,26,3,22,37,256,293
2013,9,26,3,23,15,193,208
2013,9,27,4,0,15,95,110
2013,9,27,4,1,10,58,68
2013,9,27,4,2,7,14,21
2013,9,27,4,3,2,6,8
2013,9,27,4,4,1,8,9
2013,9,27,4,5,3,54,57
2013,9,27,4,6,4,182,186
2013,9,27,4,7,32,574,606
2013,9,27,4,8,45,915,960
2013,9,27,4,9,63,430,493
2013,9,27,4,10,57,210,267
2013,9,27,4,11,112,267,379
2013,9,27,4,12,106,373,479
2013,9,27,4,13,142,362,504
2013,9,27,4,14,157,351,508
2013,9,27,4,15,163,361,524
2013,9,27,4,16,139,590,729
2013,9,27,4,17,164,965,1129
2013,9,27,4,18,116,870,986
2013,9,27,4,19,113,547,660
2013,9,27,4,20,67,346,413
2013,9,27,4,21,62,294,356
2013,9,27,4,22,36,268,304
2013,9,27,4,23,19,214,233
2013,9,28,5,0,18,159,177
2013,9,28,5,1,18,121,139
2013,9,28,5,2,14,85,99
2013,9,28,5,3,12,34,46
2013,9,28,5,4,6,17,23
2013,9,28,5,5,7,15,22
2013,9,28,5,6,5,38,43
2013,9,28,5,7,15,124,139
2013,9,28,5,8,44,209,253
2013,9,28,5,9,83,316,399
2013,9,28,5,10,183,466,649
2013,9,28,5,11,212,462,674
2013,9,28,5,12,309,495,804
2013,9,28,5,13,352,454,806
2013,9,28,5,14,381,518,899
2013,9,28,5,15,391,469,860
2013,9,28,5,16,354,487,841
2013,9,28,5,17,360,474,834
2013,9,28,5,18,252,412,664
2013,9,28,5,19,190,374,564
2013,9,28,5,20,99,326,425
2013,9,28,5,21,76,212,288
2013,9,28,5,22,62,227,289
2013,9,28,5,23,61,192,253
2013,9,29,6,0,36,138,174
2013,9,29,6,1,27,110,137
2013,9,29,6,2,31,114,145
2013,9,29,6,3,29,40,69
2013,9,29,6,4,9,14,23
2013,9,29,6,5,4,7,11
2013,9,29,6,6,4,21,25
2013,9,29,6,7,17,55,72
2013,9,29,6,8,44,130,174
2013,9,29,6,9,115,219,334
2013,9,29,6,10,201,407,608
2013,9,29,6,11,263,458,721
2013,9,29,6,12,304,555,859
2013,9,29,6,13,279,507,786
2013,9,29,6,14,280,478,758
2013,9,29,6,15,338,472,810
2013,9,29,6,16,271,477,748
2013,9,29,6,17,282,469,751
2013,9,29,6,18,203,475,678
2013,9,29,6,19,129,430,559
2013,9,29,6,20,82,250,332
2013,9,29,6,21,49,178,227
2013,9,29,6,22,58,184,242
2013,9,29,6,23,27,95,122
2013,9,30,0,0,23,44,67
2013,9,30,0,1,3,15,18
2013,9,30,0,2,4,12,16
2013,9,30,0,3,0,5,5
2013,9,30,0,4,0,10,10
2013,9,30,0,5,1,43,44
2013,9,30,0,6,8,220,228
2013,9,30,0,7,25,619,644
2013,9,30,0,8,62,794,856
2013,9,30,0,9,62,356,418
2013,9,30,0,10,92,177,269
2013,9,30,0,11,103,219,322
2013,9,30,0,12,94,289,383
2013,9,30,0,13,104,261,365
2013,9,30,0,14,82,244,326
2013,9,30,0,15,102,288,390
2013,9,30,0,16,84,543,627
2013,9,30,0,17,173,991,1164
2013,9,30,0,18,100,998,1098
2013,9,30,0,19,66,636,702
2013,9,30,0,20,64,406,470
2013,9,30,0,21,43,297,340
2013,9,30,0,22,30,202,232
2013,9,30,0,23,13,125,138
2013,10,1,1,0,12,52,64
2013,10,1,1,1,0,28,28
2013,10,1,1,2,3,11,14
2013,10,1,1,3,1,2,3
2013,10,1,1,4,0,8,8
2013,10,1,1,5,6,45,51
2013,10,1,1,6,4,202,206
2013,10,1,1,7,27,738,765
2013,10,1,1,8,37,910,947
2013,10,1,1,9,46,410,456
2013,10,1,1,10,90,242,332
2013,10,1,1,11,94,314,408
2013,10,1,1,12,121,387,508
2013,10,1,1,13,132,377,509
2013,10,1,1,14,116,370,486
2013,10,1,1,15,96,371,467
2013,10,1,1,16,125,537,662
2013,10,1,1,17,151,1041,1192
2013,10,1,1,18,95,1073,1168
2013,10,1,1,19,59,687,746
2013,10,1,1,20,46,431,477
2013,10,1,1,21,37,323,360
2013,10,1,1,22,31,274,305
2013,10,1,1,23,10,186,196
2013,10,2,2,0,6,72,78
2013,10,2,2,1,6,22,28
2013,10,2,2,2,2,14,16
2013,10,2,2,3,0,4,4
2013,10,2,2,4,0,8,8
2013,10,2,2,5,5,46,51
2013,10,2,2,6,11,193,204
2013,10,2,2,7,25,617,642
2013,10,2,2,8,47,912,959
2013,10,2,2,9,30,448,478
2013,10,2,2,10,55,236,291
2013,10,2,2,11,50,304,354
2013,10,2,2,12,118,407,525
2013,10,2,2,13,86,394,480
2013,10,2,2,14,102,354,456
2013,10,2,2,15,113,377,490
2013,10,2,2,16,115,525,640
2013,10,2,2,17,155,1095,1250
2013,10,2,2,18,116,1026,1142
2013,10,2,2,19,92,707,799
2013,10,2,2,20,54,507,561
2013,10,2,2,21,55,364,419
2013,10,2,2,22,29,271,300
2013,10,2,2,23,17,193,210
2013,10,3,3,0,11,58,69
2013,10,3,3,1,6,33,39
2013,10,3,3,2,0,16,16
2013,10,3,3,3,0,6,6
2013,10,3,3,4,0,7,7
2013,10,3,3,5,4,45,49
2013,10,3,3,6,8,200,208
2013,10,3,3,7,27,577,604
2013,10,3,3,8,34,932,966
2013,10,3,3,9,60,429,489
2013,10,3,3,10,75,235,310
2013,10,3,3,11,107,327,434
2013,10,3,3,12,102,375,477
2013,10,3,3,13,93,389,482
2013,10,3,3,14,98,365,463
2013,10,3,3,15,101,367,468
2013,10,3,3,16,95,564,659
2013,10,3,3,17,113,962,1075
2013,10,3,3,18,92,1017,1109
2013,10,3,3,19,49,648,697
2013,10,3,3,20,50,459,509
2013,10,3,3,21,60,403,463
2013,10,3,3,22,38,289,327
2013,10,3,3,23,25,206,231
2013,10,4,4,0,11,119,130
2013,10,4,4,1,3,30,33
2013,10,4,4,2,11,31,42
2013,10,4,4,3,3,12,15
2013,10,4,4,4,0,6,6
2013,10,4,4,5,0,48,48
2013,10,4,4,6,7,167,174
2013,10,4,4,7,10,523,533
2013,10,4,4,8,44,898,942
2013,10,4,4,9,66,410,476
2013,10,4,4,10,77,218,295
2013,10,4,4,11,118,315,433
2013,10,4,4,12,155,400,555
2013,10,4,4,13,152,453,605
2013,10,4,4,14,160,400,560
2013,10,4,4,15,167,393,560
2013,10,4,4,16,130,569,699
2013,10,4,4,17,151,914,1065
2013,10,4,4,18,126,839,965
2013,10,4,4,19,83,605,688
2013,10,4,4,20,62,386,448
2013,10,4,4,21,51,330,381
2013,10,4,4,22,41,260,301
2013,10,4,4,23,39,270,309
2013,10,5,5,0,23,201,224
2013,10,5,5,1,18,145,163
2013,10,5,5,2,16,98,114
2013,10,5,5,3,4,48,52
2013,10,5,5,4,1,10,11
2013,10,5,5,5,1,13,14
2013,10,5,5,6,7,28,35
2013,10,5,5,7,22,120,142
2013,10,5,5,8,37,239,276
2013,10,5,5,9,90,373,463
2013,10,5,5,10,177,449,626
2013,10,5,5,11,311,509,820
2013,10,5,5,12,370,539,909
2013,10,5,5,13,442,523,965
2013,10,5,5,14,337,474,811
2013,10,5,5,15,324,499,823
2013,10,5,5,16,372,482,854
2013,10,5,5,17,231,475,706
2013,10,5,5,18,201,493,694
2013,10,5,5,19,132,434,566
2013,10,5,5,20,88,284,372
2013,10,5,5,21,85,271,356
2013,10,5,5,22,55,232,287
2013,10,5,5,23,57,246,303
2013,10,6,6,0,48,224,272
2013,10,6,6,1,31,152,183
2013,10,6,6,2,12,136,148
2013,10,6,6,3,15,44,59
2013,10,6,6,4,0,14,14
2013,10,6,6,5,2,9,11
2013,10,6,6,6,5,20,25
2013,10,6,6,7,20,56,76
2013,10,6,6,8,53,145,198
2013,10,6,6,9,133,301,434
2013,10,6,6,10,204,383,587
2013,10,6,6,11,291,485,776
2013,10,6,6,12,297,597,894
2013,10,6,6,13,343,518,861
2013,10,6,6,14,308,541,849
2013,10,6,6,15,316,469,785
2013,10,6,6,16,263,537,800
2013,10,6,6,17,214,525,739
2013,10,6,6,18,156,498,654
2013,10,6,6,19,78,408,486
2013,10,6,6,20,74,275,349
2013,10,6,6,21,58,211,269
2013,10,6,6,22,30,146,176
2013,10,6,6,23,41,90,131
2013,10,7,0,0,8,36,44
2013,10,7,0,1,5,22,27
2013,10,7,0,2,1,9,10
2013,10,7,0,3,6,5,11
2013,10,7,0,4,0,13,13
2013,10,7,0,5,3,42,45
2013,10,7,0,6,6,195,201
2013,10,7,0,7,9,555,564
2013,10,7,0,8,30,803,833
2013,10,7,0,9,27,303,330
2013,10,7,0,10,48,168,216
2013,10,7,0,11,23,79,102
2013,10,7,0,12,3,22,25
2013,10,7,0,13,1,28,29
2013,10,7,0,14,5,33,38
2013,10,7,0,15,7,92,99
2013,10,7,0,16,26,230,256
2013,10,7,0,17,38,649,687
2013,10,7,0,18,46,715,761
2013,10,7,0,19,54,563,617
2013,10,7,0,20,33,359,392
2013,10,7,0,21,15,272,287
2013,10,7,0,22,17,180,197
2013,10,7,0,23,10,86,96
2013,10,8,1,0,7,39,46
2013,10,8,1,1,3,14,17
2013,10,8,1,2,2,3,5
2013,10,8,1,3,0,6,6
2013,10,8,1,4,4,7,11
2013,10,8,1,5,1,43,44
2013,10,8,1,6,5,206,211
2013,10,8,1,7,28,649,677
2013,10,8,1,8,32,1001,1033
2013,10,8,1,9,43,399,442
2013,10,8,1,10,64,198,262
2013,10,8,1,11,97,251,348
2013,10,8,1,12,80,367,447
2013,10,8,1,13,99,366,465
2013,10,8,1,14,148,314,462
2013,10,8,1,15,139,378,517
2013,10,8,1,16,116,527,643
2013,10,8,1,17,128,966,1094
2013,10,8,1,18,96,1004,1100
2013,10,8,1,19,59,651,710
2013,10,8,1,20,31,514,545
2013,10,8,1,21,40,348,388
2013,10,8,1,22,36,294,330
2013,10,8,1,23,20,121,141
2013,10,9,2,0,21,57,78
2013,10,9,2,1,10,24,34
2013,10,9,2,2,5,8,13
2013,10,9,2,3,2,6,8
2013,10,9,2,4,1,10,11
2013,10,9,2,5,1,53,54
2013,10,9,2,6,9,207,216
2013,10,9,2,7,29,591,620
2013,10,9,2,8,46,908,954
2013,10,9,2,9,58,401,459
2013,10,9,2,10,57,213,270
2013,10,9,2,11,65,256,321
2013,10,9,2,12,95,299,394
2013,10,9,2,13,87,325,412
2013,10,9,2,14,71,265,336
2013,10,9,2,15,66,277,343
2013,10,9,2,16,34,344,378
2013,10,9,2,17,36,323,359
2013,10,9,2,18,18,289,307
2013,10,9,2,19,11,247,258
2013,10,9,2,20,9,164,173
2013,10,9,2,21,11,169,180
2013,10,9,2,22,11,148,159
2013,10,9,2,23,4,97,101
2013,10,10,3,0,10,40,50
2013,10,10,3,1,0,18,18
2013,10,10,3,2,0,8,8
2013,10,10,3,3,0,1,1
2013,10,10,3,4,1,5,6
2013,10,10,3,5,1,18,19
2013,10,10,3,6,8,77,85
2013,10,10,3,7,0,72,72
2013,10,10,3,8,2,77,79
2013,10,10,3,9,1,57,58
2013,10,10,3,10,3,41,44
2013,10,10,3,11,2,29,31
2013,10,10,3,12,11,76,87
2013,10,10,3,13,15,111,126
2013,10,10,3,14,18,129,147
2013,10,10,3,15,21,180,201
2013,10,10,3,16,29,159,188
2013,10,10,3,17,18,270,288
2013,10,10,3,18,19,272,291
2013,10,10,3,19,5,239,244
2013,10,10,3,20,6,171,177
2013,10,10,3,21,5,123,128
2013,10,10,3,22,0,99,99
2013,10,10,3,23,5,80,85
2013,10,11,4,0,3,50,53
2013,10,11,4,1,1,19,20
2013,10,11,4,2,1,13,14
2013,10,11,4,3,1,6,7
2013,10,11,4,4,1,7,8
2013,10,11,4,5,2,29,31
2013,10,11,4,6,4,89,93
2013,10,11,4,7,3,95,98
2013,10,11,4,8,6,160,166
2013,10,11,4,9,9,170,179
2013,10,11,4,10,3,80,83
2013,10,11,4,11,12,67,79
2013,10,11,4,12,4,56,60
2013,10,11,4,13,3,57,60
2013,10,11,4,14,7,69,76
2013,10,11,4,15,9,63,72
2013,10,11,4,16,19,92,111
2013,10,11,4,17,11,131,142
2013,10,11,4,18,5,160,165
2013,10,11,4,19,6,138,144
2013,10,11,4,20,2,29,31
2013,10,11,4,21,3,26,29
2013,10,11,4,22,1,34,35
2013,10,11,4,23,1,43,44
2013,10,12,5,0,7,53,60
2013,10,12,5,1,3,58,61
2013,10,12,5,2,2,29,31
2013,10,12,5,3,1,22,23
2013,10,12,5,4,3,6,9
2013,10,12,5,5,0,13,13
2013,10,12,5,6,2,15,17
2013,10,12,5,7,6,47,53
2013,10,12,5,8,10,99,109
2013,10,12,5,9,25,130,155
2013,10,12,5,10,31,178,209
2013,10,12,5,11,63,292,355
2013,10,12,5,12,96,339,435
2013,10,12,5,13,103,365,468
2013,10,12,5,14,188,346,534
2013,10,12,5,15,190,406,596
2013,10,12,5,16,239,382,621
2013,10,12,5,17,125,311,436
2013,10,12,5,18,98,310,408
2013,10,12,5,19,37,142,179
2013,10,12,5,20,26,138,164
2013,10,12,5,21,26,112,138
2013,10,12,5,22,15,77,92
2013,10,12,5,23,4,91,95
2013,10,13,6,0,7,62,69
2013,10,13,6,1,21,76,97
2013,10,13,6,2,12,81,93
2013,10,13,6,3,11,37,48
2013,10,13,6,4,1,9,10
2013,10,13,6,5,3,6,9
2013,10,13,6,6,8,16,24
2013,10,13,6,7,8,20,28
2013,10,13,6,8,12,70,82
2013,10,13,6,9,39,119,158
2013,10,13,6,10,66,231,297
2013,10,13,6,11,82,304,386
2013,10,13,6,12,118,355,473
2013,10,13,6,13,149,387,536
2013,10,13,6,14,125,320,445
2013,10,13,6,15,175,373,548
2013,10,13,6,16,196,427,623
2013,10,13,6,17,137,358,495
2013,10,13,6,18,86,336,422
2013,10,13,6,19,82,302,384
2013,10,13,6,20,71,207,278
2013,10,13,6,21,37,145,182
2013,10,13,6,22,48,150,198
2013,10,13,6,23,29,113,142
2013,10,14,0,0,14,81,95
2013,10,14,0,1,2,44,46
2013,10,14,0,2,4,29,33
2013,10,14,0,3,0,12,12
2013,10,14,0,4,1,6,7
2013,10,14,0,5,1,28,29
2013,10,14,0,6,6,84,90
2013,10,14,0,7,18,250,268
2013,10,14,0,8,29,487,516
2013,10,14,0,9,47,314,361
2013,10,14,0,10,78,289,367
2013,10,14,0,11,170,378,548
2013,10,14,0,12,204,411,615
2013,10,14,0,13,237,468,705
2013,10,14,0,14,197,417,614
2013,10,14,0,15,176,465,641
2013,10,14,0,16,201,542,743
2013,10,14,0,17,155,702,857
2013,10,14,0,18,130,693,823
2013,10,14,0,19,45,481,526
2013,10,14,0,20,46,332,378
2013,10,14,0,21,37,294,331
2013,10,14,0,22,22,181,203
2013,10,14,0,23,10,122,132
2013,10,15,1,0,3,51,54
2013,10,15,1,1,5,18,23
2013,10,15,1,2,0,2,2
2013,10,15,1,3,0,2,2
2013,10,15,1,4,0,18,18
2013,10,15,1,5,3,46,49
2013,10,15,1,6,7,180,187
2013,10,15,1,7,14,564,578
2013,10,15,1,8,40,923,963
2013,10,15,1,9,34,372,406
2013,10,15,1,10,71,225,296
2013,10,15,1,11,85,241,326
2013,10,15,1,12,104,365,469
2013,10,15,1,13,88,352,440
2013,10,15,1,14,109,336,445
2013,10,15,1,15,83,354,437
2013,10,15,1,16,104,541,645
2013,10,15,1,17,87,1036,1123
2013,10,15,1,18,74,981,1055
2013,10,15,1,19,32,637,669
2013,10,15,1,20,37,414,451
2013,10,15,1,21,31,357,388
2013,10,15,1,22,14,207,221
2013,10,15,1,23,6,128,134
2013,10,16,2,0,3,55,58
2013,10,16,2,1,1,18,19
2013,10,16,2,2,0,6,6
2013,10,16,2,3,0,4,4
2013,10,16,2,4,0,12,12
2013,10,16,2,5,3,45,48
2013,10,16,2,6,4,200,204
2013,10,16,2,7,19,560,579
2013,10,16,2,8,36,970,1006
2013,10,16,2,9,23,426,449
2013,10,16,2,10,65,267,332
2013,10,16,2,11,87,303,390
2013,10,16,2,12,106,334,440
2013,10,16,2,13,94,335,429
2013,10,16,2,14,119,293,412
2013,10,16,2,15,117,384,501
2013,10,16,2,16,88,535,623
2013,10,16,2,17,92,1041,1133
2013,10,16,2,18,84,1000,1084
2013,10,16,2,19,69,628,697
2013,10,16,2,20,43,461,504
2013,10,16,2,21,19,338,357
2013,10,16,2,22,24,245,269
2013,10,16,2,23,18,155,173
2013,10,17,3,0,3,62,65
2013,10,17,3,1,2,25,27
2013,10,17,3,2,1,14,15
2013,10,17,3,3,0,8,8
2013,10,17,3,4,0,7,7
2013,10,17,3,5,1,46,47
2013,10,17,3,6,1,214,215
2013,10,17,3,7,28,621,649
2013,10,17,3,8,28,968,996
2013,10,17,3,9,37,480,517
2013,10,17,3,10,49,231,280
2013,10,17,3,11,66,231,297
2013,10,17,3,12,77,337,414
2013,10,17,3,13,81,295,376
2013,10,17,3,14,97,255,352
2013,10,17,3,15,76,293,369
2013,10,17,3,16,114,543,657
2013,10,17,3,17,112,1056,1168
2013,10,17,3,18,88,965,1053
2013,10,17,3,19,71,640,711
2013,10,17,3,20,48,510,558
2013,10,17,3,21,32,342,374
2013,10,17,3,22,21,181,202
2013,10,17,3,23,16,175,191
2013,10,18,4,0,9,90,99
2013,10,18,4,1,10,37,47
2013,10,18,4,2,2,19,21
2013,10,18,4,3,0,10,10
2013,10,18,4,4,0,9,9
2013,10,18,4,5,2,44,46
2013,10,18,4,6,1,174,175
2013,10,18,4,7,19,560,579
2013,10,18,4,8,32,995,1027
2013,10,18,4,9,63,444,507
2013,10,18,4,10,111,270,381
2013,10,18,4,11,125,268,393
2013,10,18,4,12,160,431,591
2013,10,18,4,13,135,337,472
2013,10,18,4,14,153,374,527
2013,10,18,4,15,188,403,591
2013,10,18,4,16,190,586,776
2013,10,18,4,17,208,985,1193
2013,10,18,4,18,122,840,962
2013,10,18,4,19,82,530,612
2013,10,18,4,20,88,342,430
2013,10,18,4,21,66,305,371
2013,10,18,4,22,55,241,296
2013,10,18,4,23,50,208,258
2013,10,19,5,0,33,136,169
2013,10,19,5,1,17,105,122
2013,10,19,5,2,8,64,72
2013,10,19,5,3,5,36,41
2013,10,19,5,4,1,14,15
2013,10,19,5,5,0,8,8
2013,10,19,5,6,3,26,29
2013,10,19,5,7,12,77,89
2013,10,19,5,8,45,223,268
2013,10,19,5,9,80,303,383
2013,10,19,5,10,213,370,583
2013,10,19,5,11,238,505,743
2013,10,19,5,12,347,526,873
2013,10,19,5,13,336,538,874
2013,10,19,5,14,330,398,728
2013,10,19,5,15,343,430,773
2013,10,19,5,16,266,446,712
2013,10,19,5,17,253,392,645
2013,10,19,5,18,206,377,583
2013,10,19,5,19,117,341,458
2013,10,19,5,20,110,283,393
2013,10,19,5,21,85,206,291
2013,10,19,5,22,77,229,306
2013,10,19,5,23,67,190,257
2013,10,20,6,0,31,163,194
2013,10,20,6,1,23,107,130
2013,10,20,6,2,17,94,111
2013,10,20,6,3,6,40,46
2013,10,20,6,4,3,11,14
2013,10,20,6,5,3,8,11
2013,10,20,6,6,5,32,37
2013,10,20,6,7,15,70,85
2013,10,20,6,8,40,137,177
2013,10,20,6,9,96,251,347
2013,10,20,6,10,194,372,566
2013,10,20,6,11,212,500,712
2013,10,20,6,12,236,523,759
2013,10,20,6,13,296,459,755
2013,10,20,6,14,290,453,743
2013,10,20,6,15,298,476,774
2013,10,20,6,16,230,544,774
2013,10,20,6,17,217,449,666
2013,10,20,6,18,156,443,599
2013,10,20,6,19,74,327,401
2013,10,20,6,20,42,209,251
2013,10,20,6,21,39,177,216
2013,10,20,6,22,13,122,135
2013,10,20,6,23,6,85,91
2013,10,21,0,0,8,34,42
2013,10,21,0,1,3,18,21
2013,10,21,0,2,0,8,8
2013,10,21,0,3,0,5,5
2013,10,21,0,4,0,10,10
2013,10,21,0,5,3,46,49
2013,10,21,0,6,4,175,179
2013,10,21,0,7,14,566,580
2013,10,21,0,8,29,882,911
2013,10,21,0,9,43,402,445
2013,10,21,0,10,93,200,293
2013,10,21,0,11,121,204,325
2013,10,21,0,12,124,308,432
2013,10,21,0,13,127,294,421
2013,10,21,0,14,105,267,372
2013,10,21,0,15,111,318,429
2013,10,21,0,16,125,531,656
2013,10,21,0,17,151,1036,1187
2013,10,21,0,18,93,954,1047
2013,10,21,0,19,45,551,596
2013,10,21,0,20,36,363,399
2013,10,21,0,21,50,291,341
2013,10,21,0,22,26,172,198
2013,10,21,0,23,20,90,110
2013,10,22,1,0,9,29,38
2013,10,22,1,1,1,13,14
2013,10,22,1,2,1,10,11
2013,10,22,1,3,2,3,5
2013,10,22,1,4,1,11,12
2013,10,22,1,5,1,66,67
2013,10,22,1,6,7,220,227
2013,10,22,1,7,11,710,721
2013,10,22,1,8,28,1007,1035
2013,10,22,1,9,34,415,449
2013,10,22,1,10,60,198,258
2013,10,22,1,11,63,209,272
2013,10,22,1,12,38,280,318
2013,10,22,1,13,46,298,344
2013,10,22,1,14,56,245,301
2013,10,22,1,15,77,325,402
2013,10,22,1,16,48,576,624
2013,10,22,1,17,94,1053,1147
2013,10,22,1,18,54,943,997
2013,10,22,1,19,37,625,662
2013,10,22,1,20,27,427,454
2013,10,22,1,21,16,334,350
2013,10,22,1,22,19,226,245
2013,10,22,1,23,6,115,121
2013,10,23,2,0,3,40,43
2013,10,23,2,1,2,20,22
2013,10,23,2,2,0,12,12
2013,10,23,2,3,0,6,6
2013,10,23,2,4,1,10,11
2013,10,23,2,5,1,45,46
2013,10,23,2,6,4,113,117
2013,10,23,2,7,14,436,450
2013,10,23,2,8,22,890,912
2013,10,23,2,9,31,439,470
2013,10,23,2,10,30,206,236
2013,10,23,2,11,44,217,261
2013,10,23,2,12,49,323,372
2013,10,23,2,13,50,293,343
2013,10,23,2,14,60,248,308
2013,10,23,2,15,65,278,343
2013,10,23,2,16,51,446,497
2013,10,23,2,17,75,983,1058
2013,10,23,2,18,48,852,900
2013,10,23,2,19,23,549,572
2013,10,23,2,20,13,340,353
2013,10,23,2,21,16,303,319
2013,10,23,2,22,5,184,189
2013,10,23,2,23,9,121,130
2013,10,24,3,0,4,50,54
2013,10,24,3,1,1,25,26
2013,10,24,3,2,1,4,5
2013,10,24,3,3,0,4,4
2013,10,24,3,4,1,5,6
2013,10,24,3,5,0,40,40
2013,10,24,3,6,2,179,181
2013,10,24,3,7,8,585,593
2013,10,24,3,8,19,945,964
2013,10,24,3,9,25,403,428
2013,10,24,3,10,40,188,228
2013,10,24,3,11,48,203,251
2013,10,24,3,12,35,289,324
2013,10,24,3,13,39,239,278
2013,10,24,3,14,50,251,301
2013,10,24,3,15,66,310,376
2013,10,24,3,16,34,425,459
2013,10,24,3,17,77,917,994
2013,10,24,3,18,57,795,852
2013,10,24,3,19,28,481,509
2013,10,24,3,20,24,390,414
2013,10,24,3,21,16,251,267
2013,10,24,3,22,12,186,198
2013,10,24,3,23,5,140,145
2013,10,25,4,0,2,76,78
2013,10,25,4,1,6,26,32
2013,10,25,4,2,1,14,15
2013,10,25,4,3,0,4,4
2013,10,25,4,4,0,10,10
2013,10,25,4,5,1,50,51
2013,10,25,4,6,1,133,134
2013,10,25,4,7,13,435,448
2013,10,25,4,8,15,843,858
2013,10,25,4,9,24,407,431
2013,10,25,4,10,47,182,229
2013,10,25,4,11,54,225,279
2013,10,25,4,12,55,324,379
2013,10,25,4,13,112,349,461
2013,10,25,4,14,80,305,385
2013,10,25,4,15,116,389,505
2013,10,25,4,16,134,520,654
2013,10,25,4,17,106,841,947
2013,10,25,4,18,53,665,718
2013,10,25,4,19,34,404,438
2013,10,25,4,20,16,314,330
2013,10,25,4,21,20,195,215
2013,10,25,4,22,15,179,194
2013,10,25,4,23,8,150,158
2013,10,26,5,0,13,130,143
2013,10,26,5,1,4,107,111
2013,10,26,5,2,0,74,74
2013,10,26,5,3,0,21,21
2013,10,26,5,4,2,4,6
2013,10,26,5,5,1,15,16
2013,10,26,5,6,0,18,18
2013,10,26,5,7,5,77,82
2013,10,26,5,8,31,188,219
2013,10,26,5,9,61,282,343
2013,10,26,5,10,118,354,472
2013,10,26,5,11,188,420,608
2013,10,26,5,12,205,453,658
2013,10,26,5,13,217,482,699
2013,10,26,5,14,237,464,701
2013,10,26,5,15,252,465,717
2013,10,26,5,16,238,446,684
2013,10,26,5,17,253,420,673
2013,10,26,5,18,111,347,458
2013,10,26,5,19,88,306,394
2013,10,26,5,20,64,247,311
2013,10,26,5,21,47,188,235
2013,10,26,5,22,21,162,183
2013,10,26,5,23,39,118,157
2013,10,27,6,0,16,122,138
2013,10,27,6,1,31,107,138
2013,10,27,6,2,22,105,127
2013,10,27,6,3,10,50,60
2013,10,27,6,4,3,21,24
2013,10,27,6,5,5,12,17
2013,10,27,6,6,8,54,62
2013,10,27,6,7,26,80,106
2013,10,27,6,8,72,150,222
2013,10,27,6,9,138,275,413
2013,10,27,6,10,166,407,573
2013,10,27,6,11,231,400,631
2013,10,27,6,12,199,504,703
2013,10,27,6,13,232,474,706
2013,10,27,6,14,280,455,735
2013,10,27,6,15,240,433,673
2013,10,27,6,16,236,445,681
2013,10,27,6,17,189,400,589
2013,10,27,6,18,98,376,474
2013,10,27,6,19,75,241,316
2013,10,27,6,20,34,198,232
2013,10,27,6,21,30,160,190
2013,10,27,6,22,17,112,129
2013,10,27,6,23,23,60,83
2013,10,28,0,0,17,30,47
2013,10,28,0,1,3,18,21
2013,10,28,0,2,0,7,7
2013,10,28,0,3,0,5,5
2013,10,28,0,4,0,4,4
2013,10,28,0,5,1,44,45
2013,10,28,0,6,6,149,155
2013,10,28,0,7,10,500,510
2013,10,28,0,8,31,882,913
2013,10,28,0,9,51,379,430
2013,10,28,0,10,83,172,255
2013,10,28,0,11,113,210,323
2013,10,28,0,12,102,259,361
2013,10,28,0,13,119,245,364
2013,10,28,0,14,107,235,342
2013,10,28,0,15,101,299,400
2013,10,28,0,16,106,494,600
2013,10,28,0,17,93,1070,1163
2013,10,28,0,18,96,945,1041
2013,10,28,0,19,37,538,575
2013,10,28,0,20,28,404,432
2013,10,28,0,21,25,277,302
2013,10,28,0,22,33,174,207
2013,10,28,0,23,15,86,101
2013,10,29,1,0,10,35,45
2013,10,29,1,1,0,14,14
2013,10,29,1,2,0,2,2
2013,10,29,1,3,0,4,4
2013,10,29,1,4,0,9,9
2013,10,29,1,5,4,49,53
2013,10,29,1,6,3,185,188
2013,10,29,1,7,11,633,644
2013,10,29,1,8,39,1016,1055
2013,10,29,1,9,27,384,411
2013,10,29,1,10,65,221,286
2013,10,29,1,11,69,223,292
2013,10,29,1,12,87,290,377
2013,10,29,1,13,80,300,380
2013,10,29,1,14,93,277,370
2013,10,29,1,15,83,337,420
2013,10,29,1,16,83,510,593
2013,10,29,1,17,103,1095,1198
2013,10,29,1,18,85,912,997
2013,10,29,1,19,46,561,607
2013,10,29,1,20,30,411,441
2013,10,29,1,21,17,346,363
2013,10,29,1,22,16,215,231
2013,10,29,1,23,12,142,154
2013,10,30,2,0,4,49,53
2013,10,30,2,1,1,29,30
2013,10,30,2,2,1,17,18
2013,10,30,2,3,0,6,6
2013,10,30,2,4,1,14,15
2013,10,30,2,5,1,50,51
2013,10,30,2,6,5,146,151
2013,10,30,2,7,8,406,414
2013,10,30,2,8,24,466,490
2013,10,30,2,9,20,340,360
2013,10,30,2,10,32,173,205
2013,10,30,2,11,52,229,281
2013,10,30,2,12,51,299,350
2013,10,30,2,13,85,311,396
2013,10,30,2,14,72,280,352
2013,10,30,2,15,79,336,415
2013,10,30,2,16,104,524,628
2013,10,30,2,17,96,1025,1121
2013,10,30,2,18,66,917,983
2013,10,30,2,19,27,559,586
2013,10,30,2,20,21,444,465
2013,10,30,2,21,24,326,350
2013,10,30,2,22,13,231,244
2013,10,30,2,23,19,161,180
2013,10,31,3,0,6,76,82
2013,10,31,3,1,1,19,20
2013,10,31,3,2,0,10,10
2013,10,31,3,3,0,6,6
2013,10,31,3,4,0,8,8
2013,10,31,3,5,1,55,56
2013,10,31,3,6,2,165,167
2013,10,31,3,7,12,557,569
2013,10,31,3,8,29,913,942
2013,10,31,3,9,41,417,458
2013,10,31,3,10,23,212,235
2013,10,31,3,11,58,232,290
2013,10,31,3,12,60,332,392
2013,10,31,3,13,78,314,392
2013,10,31,3,14,60,278,338
2013,10,31,3,15,79,352,431
2013,10,31,3,16,66,587,653
2013,10,31,3,17,73,1055,1128
2013,10,31,3,18,36,805,841
2013,10,31,3,19,27,365,392
2013,10,31,3,20,16,297,313
2013,10,31,3,21,16,253,269
2013,10,31,3,22,18,200,218
2013,10,31,3,23,22,197,219
2013,11,1,4,0,18,117,135
2013,11,1,4,1,14,81,95
2013,11,1,4,2,5,41,46
2013,11,1,4,3,4,27,31
2013,11,1,4,4,0,9,9
2013,11,1,4,5,3,55,58
2013,11,1,4,6,0,127,127
2013,11,1,4,7,8,279,287
2013,11,1,4,8,24,811,835
2013,11,1,4,9,3,208,211
2013,11,1,4,10,12,151,163
2013,11,1,4,11,41,169,210
2013,11,1,4,12,45,308,353
2013,11,1,4,13,66,324,390
2013,11,1,4,14,76,282,358
2013,11,1,4,15,107,370,477
2013,11,1,4,16,108,531,639
2013,11,1,4,17,136,978,1114
2013,11,1,4,18,78,756,834
2013,11,1,4,19,55,504,559
2013,11,1,4,20,37,363,400
2013,11,1,4,21,29,333,362
2013,11,1,4,22,24,249,273
2013,11,1,4,23,29,185,214
2013,11,2,5,0,31,180,211
2013,11,2,5,1,26,107,133
2013,11,2,5,2,17,106,123
2013,11,2,5,3,8,43,51
2013,11,2,5,4,4,17,21
2013,11,2,5,5,0,14,14
2013,11,2,5,6,1,21,22
2013,11,2,5,7,14,83,97
2013,11,2,5,8,30,193,223
2013,11,2,5,9,75,284,359
2013,11,2,5,10,179,442,621
2013,11,2,5,11,204,521,725
2013,11,2,5,12,266,583,849
2013,11,2,5,13,318,527,845
2013,11,2,5,14,346,523,869
2013,11,2,5,15,357,543,900
2013,11,2,5,16,312,453,765
2013,11,2,5,17,260,448,708
2013,11,2,5,18,147,411,558
2013,11,2,5,19,76,311,387
2013,11,2,5,20,55,215,270
2013,11,2,5,21,55,223,278
2013,11,2,5,22,46,216,262
2013,11,2,5,23,39,160,199
2013,11,3,6,0,23,128,151
2013,11,3,6,1,28,239,267
2013,11,3,6,2,7,51,58
2013,11,3,6,3,1,23,24
2013,11,3,6,4,0,4,4
2013,11,3,6,5,2,10,12
2013,11,3,6,6,9,35,44
2013,11,3,6,7,23,75,98
2013,11,3,6,8,54,165,219
2013,11,3,6,9,106,285,391
2013,11,3,6,10,167,438,605
2013,11,3,6,11,222,433,655
2013,11,3,6,12,263,485,748
2013,11,3,6,13,240,473,713
2013,11,3,6,14,235,429,664
2013,11,3,6,15,211,479,690
2013,11,3,6,16,185,470,655
2013,11,3,6,17,130,388,518
2013,11,3,6,18,77,293,370
2013,11,3,6,19,48,250,298
2013,11,3,6,20,34,190,224
2013,11,3,6,21,19,119,138
2013,11,3,6,22,20,92,112
2013,11,3,6,23,12,65,77
2013,11,4,0,0,7,16,23
2013,11,4,0,1,2,10,12
2013,11,4,0,2,3,2,5
2013,11,4,0,3,0,4,4
2013,11,4,0,4,1,7,8
2013,11,4,0,5,1,47,48
2013,11,4,0,6,6,175,181
2013,11,4,0,7,19,597,616
2013,11,4,0,8,23,775,798
2013,11,4,0,9,44,325,369
2013,11,4,0,10,50,169,219
2013,11,4,0,11,56,197,253
2013,11,4,0,12,62,269,331
2013,11,4,0,13,50,208,258
2013,11,4,0,14,45,195,240
2013,11,4,0,15,33,270,303
2013,11,4,0,16,27,423,450
2013,11,4,0,17,40,813,853
2013,11,4,0,18,24,673,697
2013,11,4,0,19,15,489,504
2013,11,4,0,20,14,298,312
2013,11,4,0,21,15,210,225
2013,11,4,0,22,9,135,144
2013,11,4,0,23,9,92,101
2013,11,5,1,0,5,27,32
2013,11,5,1,1,1,10,11
2013,11,5,1,2,1,7,8
2013,11,5,1,3,0,5,5
2013,11,5,1,4,1,8,9
2013,11,5,1,5,0,57,57
2013,11,5,1,6,5,205,210
2013,11,5,1,7,19,687,706
2013,11,5,1,8,39,917,956
2013,11,5,1,9,20,381,401
2013,11,5,1,10,36,178,214
2013,11,5,1,11,68,210,278
2013,11,5,1,12,47,294,341
2013,11,5,1,13,67,296,363
2013,11,5,1,14,67,256,323
2013,11,5,1,15,41,287,328
2013,11,5,1,16,61,528,589
2013,11,5,1,17,71,923,994
2013,11,5,1,18,34,813,847
2013,11,5,1,19,19,528,547
2013,11,5,1,20,11,354,365
2013,11,5,1,21,18,270,288
2013,11,5,1,22,26,209,235
2013,11,5,1,23,13,103,116
2013,11,6,2,0,5,47,52
2013,11,6,2,1,1,14,15
2013,11,6,2,2,6,7,13
2013,11,6,2,3,3,4,7
2013,11,6,2,4,0,8,8
2013,11,6,2,5,4,51,55
2013,11,6,2,6,3,211,214
2013,11,6,2,7,15,685,700
2013,11,6,2,8,33,965,998
2013,11,6,2,9,27,387,414
2013,11,6,2,10,42,200,242
2013,11,6,2,11,50,236,286
2013,11,6,2,12,65,318,383
2013,11,6,2,13,68,306,374
2013,11,6,2,14,79,237,316
2013,11,6,2,15,75,315,390
2013,11,6,2,16,79,511,590
2013,11,6,2,17,75,1005,1080
2013,11,6,2,18,36,865,901
2013,11,6,2,19,48,612,660
2013,11,6,2,20,31,429,460
2013,11,6,2,21,17,309,326
2013,11,6,2,22,15,220,235
2013,11,6,2,23,20,138,158
2013,11,7,3,0,9,53,62
2013,11,7,3,1,3,19,22
2013,11,7,3,2,8,12,20
2013,11,7,3,3,0,3,3
2013,11,7,3,4,0,8,8
2013,11,7,3,5,0,56,56
2013,11,7,3,6,6,227,233
2013,11,7,3,7,22,756,778
2013,11,7,3,8,44,1035,1079
2013,11,7,3,9,17,440,457
2013,11,7,3,10,27,234,261
2013,11,7,3,11,25,151,176
2013,11,7,3,12,18,157,175
2013,11,7,3,13,28,219,247
2013,11,7,3,14,38,250,288
2013,11,7,3,15,51,302,353
2013,11,7,3,16,57,467,524
2013,11,7,3,17,35,847,882
2013,11,7,3,18,31,791,822
2013,11,7,3,19,23,501,524
2013,11,7,3,20,15,389,404
2013,11,7,3,21,17,302,319
2013,11,7,3,22,8,231,239
2013,11,7,3,23,3,130,133
2013,11,8,4,0,5,66,71
2013,11,8,4,1,11,34,45
2013,11,8,4,2,1,13,14
2013,11,8,4,3,12,2,14
2013,11,8,4,4,6,8,14
2013,11,8,4,5,1,50,51
2013,11,8,4,6,1,141,142
2013,11,8,4,7,17,517,534
2013,11,8,4,8,27,877,904
2013,11,8,4,9,27,390,417
2013,11,8,4,10,52,209,261
2013,11,8,4,11,54,266,320
2013,11,8,4,12,66,284,350
2013,11,8,4,13,75,314,389
2013,11,8,4,14,69,262,331
2013,11,8,4,15,68,335,403
2013,11,8,4,16,62,468,530
2013,11,8,4,17,61,802,863
2013,11,8,4,18,37,655,692
2013,11,8,4,19,18,379,397
2013,11,8,4,20,17,291,308
2013,11,8,4,21,10,193,203
2013,11,8,4,22,20,177,197
2013,11,8,4,23,11,128,139
2013,11,9,5,0,12,112,124
2013,11,9,5,1,5,80,85
2013,11,9,5,2,6,58,64
2013,11,9,5,3,3,18,21
2013,11,9,5,4,1,7,8
2013,11,9,5,5,5,7,12
2013,11,9,5,6,0,28,28
2013,11,9,5,7,12,81,93
2013,11,9,5,8,41,195,236
2013,11,9,5,9,86,264,350
2013,11,9,5,10,123,336,459
2013,11,9,5,11,179,450,629
2013,11,9,5,12,244,476,720
2013,11,9,5,13,258,414,672
2013,11,9,5,14,253,440,693
2013,11,9,5,15,255,454,709
2013,11,9,5,16,268,439,707
2013,11,9,5,17,179,341,520
2013,11,9,5,18,61,277,338
2013,11,9,5,19,53,260,313
2013,11,9,5,20,30,199,229
2013,11,9,5,21,48,178,226
2013,11,9,5,22,38,148,186
2013,11,9,5,23,32,164,196
2013,11,10,6,0,17,145,162
2013,11,10,6,1,9,117,126
2013,11,10,6,2,13,77,90
2013,11,10,6,3,3,22,25
2013,11,10,6,4,1,6,7
2013,11,10,6,5,0,6,6
2013,11,10,6,6,3,25,28
2013,11,10,6,7,23,73,96
2013,11,10,6,8,35,125,160
2013,11,10,6,9,93,244,337
2013,11,10,6,10,144,349,493
2013,11,10,6,11,196,410,606
2013,11,10,6,12,249,522,771
2013,11,10,6,13,276,501,777
2013,11,10,6,14,257,452,709
2013,11,10,6,15,248,425,673
2013,11,10,6,16,201,403,604
2013,11,10,6,17,108,318,426
2013,11,10,6,18,67,245,312
2013,11,10,6,19,41,222,263
2013,11,10,6,20,33,155,188
2013,11,10,6,21,20,148,168
2013,11,10,6,22,17,130,147
2013,11,10,6,23,12,74,86
2013,11,11,0,0,7,42,49
2013,11,11,0,1,6,15,21
2013,11,11,0,2,0,10,10
2013,11,11,0,3,0,8,8
2013,11,11,0,4,0,6,6
2013,11,11,0,5,1,17,18
2013,11,11,0,6,3,85,88
2013,11,11,0,7,9,287,296
2013,11,11,0,8,40,613,653
2013,11,11,0,9,60,393,453
2013,11,11,0,10,75,317,392
2013,11,11,0,11,101,318,419
2013,11,11,0,12,121,331,452
2013,11,11,0,13,108,353,461
2013,11,11,0,14,96,317,413
2013,11,11,0,15,98,341,439
2013,11,11,0,16,69,399,468
2013,11,11,0,17,57,625,682
2013,11,11,0,18,35,615,650
2013,11,11,0,19,21,428,449
2013,11,11,0,20,21,304,325
2013,11,11,0,21,20,232,252
2013,11,11,0,22,17,164,181
2013,11,11,0,23,7,72,79
2013,11,12,1,0,4,33,37
2013,11,12,1,1,3,16,19
2013,11,12,1,2,1,4,5
2013,11,12,1,3,3,1,4
2013,11,12,1,4,0,7,7
2013,11,12,1,5,0,58,58
2013,11,12,1,6,2,178,180
2013,11,12,1,7,11,564,575
2013,11,12,1,8,22,873,895
2013,11,12,1,9,11,339,350
2013,11,12,1,10,8,126,134
2013,11,12,1,11,14,138,152
2013,11,12,1,12,11,198,209
2013,11,12,1,13,10,181,191
2013,11,12,1,14,17,149,166
2013,11,12,1,15,22,197,219
2013,11,12,1,16,18,362,380
2013,11,12,1,17,19,702,721
2013,11,12,1,18,15,625,640
2013,11,12,1,19,13,422,435
2013,11,12,1,20,12,278,290
2013,11,12,1,21,17,251,268
2013,11,12,1,22,24,129,153
2013,11,12,1,23,5,69,74
2013,11,13,2,0,3,29,32
2013,11,13,2,1,2,12,14
2013,11,13,2,2,1,6,7
2013,11,13,2,4,0,11,11
2013,11,13,2,5,1,49,50
2013,11,13,2,6,3,159,162
2013,11,13,2,7,10,526,536
2013,11,13,2,8,29,957,986
2013,11,13,2,9,23,373,396
2013,11,13,2,10,17,202,219
2013,11,13,2,11,16,158,174
2013,11,13,2,12,16,232,248
2013,11,13,2,13,22,213,235
2013,11,13,2,14,17,173,190
2013,11,13,2,15,12,196,208
2013,11,13,2,16,20,357,377
2013,11,13,2,17,16,708,724
2013,11,13,2,18,13,702,715
2013,11,13,2,19,22,435,457
2013,11,13,2,20,8,302,310
2013,11,13,2,21,11,250,261
2013,11,13,2,22,8,145,153
2013,11,13,2,23,10,69,79
2013,11,14,3,0,7,44,51
2013,11,14,3,1,1,11,12
2013,11,14,3,2,2,7,9
2013,11,14,3,3,0,1,1
2013,11,14,3,4,0,8,8
2013,11,14,3,5,0,42,42
2013,11,14,3,6,3,151,154
2013,11,14,3,7,9,527,536
2013,11,14,3,8,19,956,975
2013,11,14,3,9,23,399,422
2013,11,14,3,10,23,178,201
2013,11,14,3,11,27,192,219
2013,11,14,3,12,30,284,314
2013,11,14,3,13,37,278,315
2013,11,14,3,14,30,225,255
2013,11,14,3,15,37,262,299
2013,11,14,3,16,28,421,449
2013,11,14,3,17,32,767,799
2013,11,14,3,18,26,744,770
2013,11,14,3,19,12,485,497
2013,11,14,3,20,9,387,396
2013,11,14,3,21,12,286,298
2013,11,14,3,22,7,202,209
2013,11,14,3,23,5,123,128
2013,11,15,4,0,3,68,71
2013,11,15,4,1,2,31,33
2013,11,15,4,2,1,21,22
2013,11,15,4,3,2,8,10
2013,11,15,4,4,0,6,6
2013,11,15,4,5,0,51,51
2013,11,15,4,6,1,131,132
2013,11,15,4,7,6,523,529
2013,11,15,4,8,24,868,892
2013,11,15,4,9,30,392,422
2013,11,15,4,10,52,220,272
2013,11,15,4,11,54,240,294
2013,11,15,4,12,77,308,385
2013,11,15,4,13,85,319,404
2013,11,15,4,14,66,298,364
2013,11,15,4,15,112,336,448
2013,11,15,4,16,105,483,588
2013,11,15,4,17,67,821,888
2013,11,15,4,18,35,637,672
2013,11,15,4,19,28,444,472
2013,11,15,4,20,12,329,341
2013,11,15,4,21,11,230,241
2013,11,15,4,22,9,134,143
2013,11,15,4,23,2,72,74
2013,11,16,5,0,3,34,37
2013,11,16,5,1,0,42,42
2013,11,16,5,2,1,33,34
2013,11,16,5,3,0,13,13
2013,11,16,5,4,0,5,5
2013,11,16,5,5,1,6,7
2013,11,16,5,6,4,15,19
2013,11,16,5,7,9,59,68
2013,11,16,5,8,22,146,168
2013,11,16,5,9,48,267,315
2013,11,16,5,10,90,328,418
2013,11,16,5,11,101,431,532
2013,11,16,5,12,146,451,597
2013,11,16,5,13,162,482,644
2013,11,16,5,14,214,448,662
2013,11,16,5,15,205,445,650
2013,11,16,5,16,172,458,630
2013,11,16,5,17,117,354,471
2013,11,16,5,18,78,317,395
2013,11,16,5,19,45,253,298
2013,11,16,5,20,35,207,242
2013,11,16,5,21,25,197,222
2013,11,16,5,22,28,197,225
2013,11,16,5,23,24,173,197
2013,11,17,6,0,17,141,158
2013,11,17,6,1,21,125,146
2013,11,17,6,2,25,101,126
2013,11,17,6,3,12,40,52
2013,11,17,6,4,3,7,10
2013,11,17,6,5,1,6,7
2013,11,17,6,6,4,19,23
2013,11,17,6,7,12,48,60
2013,11,17,6,8,24,136,160
2013,11,17,6,9,52,224,276
2013,11,17,6,10,85,347,432
2013,11,17,6,11,175,446,621
2013,11,17,6,12,136,511,647
2013,11,17,6,13,142,475,617
2013,11,17,6,14,182,436,618
2013,11,17,6,15,169,473,642
2013,11,17,6,16,123,489,612
2013,11,17,6,17,93,418,511
2013,11,17,6,18,60,321,381
2013,11,17,6,19,36,253,289
2013,11,17,6,20,28,207,235
2013,11,17,6,21,17,166,183
2013,11,17,6,22,13,119,132
2013,11,17,6,23,16,71,87
2013,11,18,0,0,7,40,47
2013,11,18,0,1,3,10,13
2013,11,18,0,2,0,7,7
2013,11,18,0,3,3,1,4
2013,11,18,0,4,0,6,6
2013,11,18,0,5,0,37,37
2013,11,18,0,6,5,173,178
2013,11,18,0,7,4,577,581
2013,11,18,0,8,40,996,1036
2013,11,18,0,9,36,408,444
2013,11,18,0,10,63,199,262
2013,11,18,0,11,57,228,285
2013,11,18,0,12,47,308,355
2013,11,18,0,13,50,292,342
2013,11,18,0,14,71,238,309
2013,11,18,0,15,56,334,390
2013,11,18,0,16,53,467,520
2013,11,18,0,17,58,939,997
2013,11,18,0,18,58,886,944
2013,11,18,0,19,29,574,603
2013,11,18,0,20,28,368,396
2013,11,18,0,21,13,277,290
2013,11,18,0,22,11,172,183
2013,11,18,0,23,15,106,121
2013,11,19,1,0,3,35,38
2013,11,19,1,1,1,19,20
2013,11,19,1,2,2,6,8
2013,11,19,1,3,1,4,5
2013,11,19,1,4,0,9,9
2013,11,19,1,5,1,47,48
2013,11,19,1,6,5,182,187
2013,11,19,1,7,9,582,591
2013,11,19,1,8,28,1015,1043
2013,11,19,1,9,20,424,444
2013,11,19,1,10,26,187,213
2013,11,19,1,11,35,198,233
2013,11,19,1,12,33,254,287
2013,11,19,1,13,37,266,303
2013,11,19,1,14,37,209,246
2013,11,19,1,15,42,255,297
2013,11,19,1,16,32,434,466
2013,11,19,1,17,34,808,842
2013,11,19,1,18,20,735,755
2013,11,19,1,19,17,533,550
2013,11,19,1,20,17,331,348
2013,11,19,1,21,8,301,309
2013,11,19,1,22,15,171,186
2013,11,19,1,23,4,90,94
2013,11,20,2,0,2,45,47
2013,11,20,2,1,2,13,15
2013,11,20,2,2,1,8,9
2013,11,20,2,3,1,1,2
2013,11,20,2,4,0,10,10
2013,11,20,2,5,0,51,51
2013,11,20,2,6,1,181,182
2013,11,20,2,7,10,537,547
2013,11,20,2,8,22,939,961
2013,11,20,2,9,20,404,424
2013,11,20,2,10,26,194,220
2013,11,20,2,11,38,208,246
2013,11,20,2,12,38,261,299
2013,11,20,2,13,40,248,288
2013,11,20,2,14,53,240,293
2013,11,20,2,15,33,270,303
2013,11,20,2,16,41,409,450
2013,11,20,2,17,39,787,826
2013,11,20,2,18,30,722,752
2013,11,20,2,19,15,494,509
2013,11,20,2,20,16,347,363
2013,11,20,2,21,10,264,274
2013,11,20,2,22,8,205,213
2013,11,20,2,23,6,119,125
2013,11,21,3,0,1,42,43
2013,11,21,3,1,3,12,15
2013,11,21,3,2,1,15,16
2013,11,21,3,3,0,2,2
2013,11,21,3,4,0,9,9
2013,11,21,3,5,0,51,51
2013,11,21,3,6,1,166,167
2013,11,21,3,7,13,516,529
2013,11,21,3,8,19,934,953
2013,11,21,3,9,14,395,409
2013,11,21,3,10,30,215,245
2013,11,21,3,11,27,219,246
2013,11,21,3,12,38,265,303
2013,11,21,3,13,44,268,312
2013,11,21,3,14,36,217,253
2013,11,21,3,15,42,308,350
2013,11,21,3,16,41,415,456
2013,11,21,3,17,30,785,815
2013,11,21,3,18,37,748,785
2013,11,21,3,19,20,510,530
2013,11,21,3,20,22,395,417
2013,11,21,3,21,17,293,310
2013,11,21,3,22,16,196,212
2013,11,21,3,23,19,141,160
2013,11,22,4,0,7,83,90
2013,11,22,4,1,11,38,49
2013,11,22,4,2,1,14,15
2013,11,22,4,3,3,4,7
2013,11,22,4,4,0,8,8
2013,11,22,4,5,1,46,47
2013,11,22,4,6,2,159,161
2013,11,22,4,7,10,453,463
2013,11,22,4,8,19,981,1000
2013,11,22,4,9,32,423,455
2013,11,22,4,10,41,238,279
2013,11,22,4,11,50,247,297
2013,11,22,4,12,65,339,404
2013,11,22,4,13,76,300,376
2013,11,22,4,14,70,303,373
2013,11,22,4,15,75,340,415
2013,11,22,4,16,62,472,534
2013,11,22,4,17,41,837,878
2013,11,22,4,18,38,703,741
2013,11,22,4,19,37,515,552
2013,11,22,4,20,17,289,306
2013,11,22,4,21,25,252,277
2013,11,22,4,22,9,272,281
2013,11,22,4,23,27,195,222
2013,11,23,5,0,14,151,165
2013,11,23,5,1,7,103,110
2013,11,23,5,2,7,82,89
2013,11,23,5,3,4,40,44
2013,11,23,5,4,1,8,9
2013,11,23,5,5,1,10,11
2013,11,23,5,6,5,19,24
2013,11,23,5,7,11,78,89
2013,11,23,5,8,23,125,148
2013,11,23,5,9,54,266,320
2013,11,23,5,10,92,334,426
2013,11,23,5,11,148,426,574
2013,11,23,5,12,147,441,588
2013,11,23,5,13,159,433,592
2013,11,23,5,14,147,415,562
2013,11,23,5,15,153,409,562
2013,11,23,5,16,112,319,431
2013,11,23,5,17,66,282,348
2013,11,23,5,18,36,261,297
2013,11,23,5,19,26,228,254
2013,11,23,5,20,21,150,171
2013,11,23,5,21,20,141,161
2013,11,23,5,22,9,99,108
2013,11,23,5,23,4,93,97
2013,11,24,6,0,3,85,88
2013,11,24,6,1,6,62,68
2013,11,24,6,2,5,56,61
2013,11,24,6,3,0,18,18
2013,11,24,6,4,3,8,11
2013,11,24,6,5,0,6,6
2013,11,24,6,6,3,8,11
2013,11,24,6,7,6,26,32
2013,11,24,6,8,6,66,72
2013,11,24,6,9,16,124,140
2013,11,24,6,10,36,168,204
2013,11,24,6,11,49,258,307
2013,11,24,6,12,34,256,290
2013,11,24,6,13,50,261,311
2013,11,24,6,14,29,201,230
2013,11,24,6,15,31,214,245
2013,11,24,6,16,31,250,281
2013,11,24,6,17,19,218,237
2013,11,24,6,18,9,157,166
2013,11,24,6,19,10,118,128
2013,11,24,6,20,13,95,108
2013,11,24,6,21,9,76,85
2013,11,24,6,22,0,73,73
2013,11,24,6,23,2,53,55
2013,11,25,0,0,2,22,24
2013,11,25,0,1,0,4,4
2013,11,25,0,2,1,1,2
2013,11,25,0,3,0,5,5
2013,11,25,0,4,1,5,6
2013,11,25,0,5,0,28,28
2013,11,25,0,6,0,123,123
2013,11,25,0,7,6,394,400
2013,11,25,0,8,9,738,747
2013,11,25,0,9,15,335,350
2013,11,25,0,10,21,141,162
2013,11,25,0,11,38,164,202
2013,11,25,0,12,26,205,231
2013,11,25,0,13,27,164,191
2013,11,25,0,14,27,181,208
2013,11,25,0,15,39,216,255
2013,11,25,0,16,27,363,390
2013,11,25,0,17,36,575,611
2013,11,25,0,18,11,502,513
2013,11,25,0,19,8,358,366
2013,11,25,0,20,7,207,214
2013,11,25,0,21,4,163,167
2013,11,25,0,22,2,90,92
2013,11,25,0,23,3,66,69
2013,11,26,1,0,0,27,27
2013,11,26,1,1,0,9,9
2013,11,26,1,2,0,8,8
2013,11,26,1,3,0,2,2
2013,11,26,1,4,1,5,6
2013,11,26,1,5,0,31,31
2013,11,26,1,6,6,137,143
2013,11,26,1,7,4,380,384
2013,11,26,1,8,7,351,358
2013,11,26,1,9,3,114,117
2013,11,26,1,10,4,53,57
2013,11,26,1,11,2,43,45
2013,11,26,1,12,7,52,59
2013,11,26,1,13,3,49,52
2013,11,26,1,14,1,49,50
2013,11,26,1,15,2,43,45
2013,11,26,1,16,2,87,89
2013,11,26,1,17,4,122,126
2013,11,26,1,18,3,137,140
2013,11,26,1,19,0,61,61
2013,11,26,1,20,1,32,33
2013,11,26,1,21,1,27,28
2013,11,26,1,22,0,21,21
2013,11,26,1,23,0,10,10
2013,11,27,2,0,0,6,6
2013,11,27,2,1,0,2,2
2013,11,27,2,2,0,2,2
2013,11,27,2,3,1,1,2
2013,11,27,2,4,0,8,8
2013,11,27,2,5,0,17,17
2013,11,27,2,6,0,34,34
2013,11,27,2,7,0,107,107
2013,11,27,2,8,6,341,347
2013,11,27,2,9,6,259,265
2013,11,27,2,10,4,77,81
2013,11,27,2,11,4,77,81
2013,11,27,2,12,1,73,74
2013,11,27,2,13,4,86,90
2013,11,27,2,14,2,103,105
2013,11,27,2,15,1,184,185
2013,11,27,2,16,0,166,166
2013,11,27,2,17,3,185,188
2013,11,27,2,18,2,161,163
2013,11,27,2,19,2,111,113
2013,11,27,2,20,0,81,81
2013,11,27,2,21,2,65,67
2013,11,27,2,22,2,40,42
2013,11,27,2,23,4,34,38
2013,11,28,3,0,2,15,17
2013,11,28,3,1,1,19,20
2013,11,28,3,2,3,17,20
2013,11,28,3,3,0,12,12
2013,11,28,3,4,0,8,8
2013,11,28,3,5,0,5,5
2013,11,28,3,6,1,23,24
2013,11,28,3,7,0,27,27
2013,11,28,3,8,9,67,76
2013,11,28,3,9,10,79,89
2013,11,28,3,10,19,111,130
2013,11,28,3,11,35,102,137
2013,11,28,3,12,44,98,142
2013,11,28,3,13,42,102,144
2013,11,28,3,14,62,104,166
2013,11,28,3,15,50,104,154
2013,11,28,3,16,37,72,109
2013,11,28,3,17,23,38,61
2013,11,28,3,18,7,30,37
2013,11,28,3,19,13,21,34
2013,11,28,3,20,13,41,54
2013,11,28,3,21,6,35,41
2013,11,28,3,22,3,43,46
2013,11,28,3,23,8,42,50
2013,11,29,4,0,1,16,17
2013,11,29,4,1,0,12,12
2013,11,29,4,2,0,5,5
2013,11,29,4,3,1,5,6
2013,11,29,4,4,1,1,2
2013,11,29,4,5,1,7,8
2013,11,29,4,6,4,28,32
2013,11,29,4,7,4,59,63
2013,11,29,4,8,15,120,135
2013,11,29,4,9,16,106,122
2013,11,29,4,10,35,105,140
2013,11,29,4,11,66,132,198
2013,11,29,4,12,83,163,246
2013,11,29,4,13,105,185,290
2013,11,29,4,14,112,194,306
2013,11,29,4,15,91,197,288
2013,11,29,4,16,84,224,308
2013,11,29,4,17,34,191,225
2013,11,29,4,18,15,113,128
2013,11,29,4,19,13,110,123
2013,11,29,4,20,9,84,93
2013,11,29,4,21,12,64,76
2013,11,29,4,22,19,58,77
2013,11,29,4,23,3,53,56
2013,11,30,5,0,4,25,29
2013,11,30,5,1,1,25,26
2013,11,30,5,2,4,22,26
2013,11,30,5,3,3,8,11
2013,11,30,5,4,1,4,5
2013,11,30,5,5,1,2,3
2013,11,30,5,6,1,13,14
2013,11,30,5,7,3,18,21
2013,11,30,5,8,14,52,66
2013,11,30,5,9,27,90,117
2013,11,30,5,10,50,128,178
2013,11,30,5,11,72,177,249
2013,11,30,5,12,67,175,242
2013,11,30,5,13,93,194,287
2013,11,30,5,14,101,196,297
2013,11,30,5,15,102,213,315
2013,11,30,5,16,86,193,279
2013,11,30,5,17,55,151,206
2013,11,30,5,18,37,113,150
2013,11,30,5,19,15,106,121
2013,11,30,5,20,24,102,126
2013,11,30,5,21,11,87,98
2013,11,30,5,22,7,97,104
2013,11,30,5,23,5,67,72
2013,12,1,6,0,1,53,54
2013,12,1,6,1,2,44,46
2013,12,1,6,2,3,26,29
2013,12,1,6,3,3,15,18
2013,12,1,6,4,1,8,9
2013,12,1,6,5,0,5,5
2013,12,1,6,6,0,15,15
2013,12,1,6,7,1,29,30
2013,12,1,6,8,4,68,72
2013,12,1,6,9,19,130,149
2013,12,1,6,10,28,187,215
2013,12,1,6,11,54,221,275
2013,12,1,6,12,80,270,350
2013,12,1,6,13,93,248,341
2013,12,1,6,14,88,305,393
2013,12,1,6,15,89,259,348
2013,12,1,6,16,53,294,347
2013,12,1,6,17,40,238,278
2013,12,1,6,18,44,178,222
2013,12,1,6,19,27,141,168
2013,12,1,6,20,6,104,110
2013,12,1,6,21,17,89,106
2013,12,1,6,22,1,79,80
2013,12,1,6,23,8,59,67
2013,12,2,0,0,1,26,27
2013,12,2,0,1,1,16,17
2013,12,2,0,2,3,8,11
2013,12,2,0,3,2,3,5
2013,12,2,0,4,1,10,11
2013,12,2,0,5,0,42,42
2013,12,2,0,6,2,158,160
2013,12,2,0,7,4,482,486
2013,12,2,0,8,15,849,864
2013,12,2,0,9,14,320,334
2013,12,2,0,10,12,165,177
2013,12,2,0,11,25,151,176
2013,12,2,0,12,18,232,250
2013,12,2,0,13,25,207,232
2013,12,2,0,14,27,180,207
2013,12,2,0,15,30,216,246
2013,12,2,0,16,26,385,411
2013,12,2,0,17,24,761,785
2013,12,2,0,18,17,635,652
2013,12,2,0,19,9,484,493
2013,12,2,0,20,7,320,327
2013,12,2,0,21,12,226,238
2013,12,2,0,22,7,121,128
2013,12,2,0,23,2,104,106
2013,12,3,1,0,3,36,39
2013,12,3,1,1,2,11,13
2013,12,3,1,2,0,6,6
2013,12,3,1,3,0,1,1
2013,12,3,1,4,0,10,10
2013,12,3,1,5,2,45,47
2013,12,3,1,6,4,174,178
2013,12,3,1,7,8,563,571
2013,12,3,1,8,15,945,960
2013,12,3,1,9,16,449,465
2013,12,3,1,10,19,190,209
2013,12,3,1,11,29,207,236
2013,12,3,1,12,41,275,316
2013,12,3,1,13,40,256,296
2013,12,3,1,14,30,212,242
2013,12,3,1,15,37,275,312
2013,12,3,1,16,42,457,499
2013,12,3,1,17,39,840,879
2013,12,3,1,18,21,751,772
2013,12,3,1,19,24,492,516
2013,12,3,1,20,19,348,367
2013,12,3,1,21,8,286,294
2013,12,3,1,22,12,171,183
2013,12,3,1,23,6,106,112
2013,12,4,2,0,0,43,43
2013,12,4,2,1,4,12,16
2013,12,4,2,2,0,17,17
2013,12,4,2,4,0,13,13
2013,12,4,2,5,1,50,51
2013,12,4,2,6,0,186,186
2013,12,4,2,7,12,559,571
2013,12,4,2,8,28,988,1016
2013,12,4,2,9,9,375,384
2013,12,4,2,10,27,227,254
2013,12,4,2,11,47,201,248
2013,12,4,2,12,28,271,299
2013,12,4,2,13,34,294,328
2013,12,4,2,14,43,249,292
2013,12,4,2,15,34,254,288
2013,12,4,2,16,48,429,477
2013,12,4,2,17,23,792,815
2013,12,4,2,18,31,789,820
2013,12,4,2,19,15,518,533
2013,12,4,2,20,21,355,376
2013,12,4,2,21,21,305,326
2013,12,4,2,22,10,204,214
2013,12,4,2,23,1,106,107
2013,12,5,3,0,2,64,66
2013,12,5,3,1,0,19,19
2013,12,5,3,2,0,9,9
2013,12,5,3,3,0,6,6
2013,12,5,3,4,0,10,10
2013,12,5,3,5,0,45,45
2013,12,5,3,6,7,210,217
2013,12,5,3,7,17,569,586
2013,12,5,3,8,27,931,958
2013,12,5,3,9,30,448,478
2013,12,5,3,10,31,221,252
2013,12,5,3,11,33,211,244
2013,12,5,3,12,51,301,352
2013,12,5,3,13,62,347,409
2013,12,5,3,14,47,277,324
2013,12,5,3,15,41,336,377
2013,12,5,3,16,54,479,533
2013,12,5,3,17,45,826,871
2013,12,5,3,18,26,780,806
2013,12,5,3,19,33,533,566
2013,12,5,3,20,32,398,430
2013,12,5,3,21,27,260,287
2013,12,5,3,22,12,220,232
2013,12,5,3,23,5,161,166
2013,12,6,4,0,10,89,99
2013,12,6,4,1,0,36,36
2013,12,6,4,2,1,16,17
2013,12,6,4,3,0,7,7
2013,12,6,4,4,0,7,7
2013,12,6,4,5,0,49,49
2013,12,6,4,6,2,116,118
2013,12,6,4,7,5,250,255
2013,12,6,4,8,13,525,538
2013,12,6,4,9,9,243,252
2013,12,6,4,10,20,140,160
2013,12,6,4,11,18,76,94
2013,12,6,4,12,15,86,101
2013,12,6,4,13,8,137,145
2013,12,6,4,14,4,78,82
2013,12,6,4,15,4,68,72
2013,12,6,4,16,3,120,123
2013,12,6,4,17,6,204,210
2013,12,6,4,18,1,179,180
2013,12,6,4,19,3,147,150
2013,12,6,4,20,4,113,117
2013,12,6,4,21,5,71,76
2013,12,6,4,22,14,30,44
2013,12,6,4,23,0,44,44
2013,12,7,5,0,0,29,29
2013,12,7,5,1,1,18,19
2013,12,7,5,2,2,47,49
2013,12,7,5,3,1,23,24
2013,12,7,5,4,0,8,8
2013,12,7,5,5,1,5,6
2013,12,7,5,6,6,18,24
2013,12,7,5,7,6,63,69
2013,12,7,5,8,11,131,142
2013,12,7,5,9,30,217,247
2013,12,7,5,10,44,302,346
2013,12,7,5,11,64,369,433
2013,12,7,5,12,63,372,435
2013,12,7,5,13,72,399,471
2013,12,7,5,14,62,356,418
2013,12,7,5,15,77,363,440
2013,12,7,5,16,40,332,372
2013,12,7,5,17,34,263,297
2013,12,7,5,18,26,238,264
2013,12,7,5,19,21,231,252
2013,12,7,5,20,6,169,175
2013,12,7,5,21,14,135,149
2013,12,7,5,22,10,133,143
2013,12,7,5,23,5,114,119
2013,12,8,6,0,8,133,141
2013,12,8,6,1,9,79,88
2013,12,8,6,2,1,62,63
2013,12,8,6,3,3,23,26
2013,12,8,6,4,0,6,6
2013,12,8,6,5,1,8,9
2013,12,8,6,6,1,9,10
2013,12,8,6,7,4,32,36
2013,12,8,6,8,3,85,88
2013,12,8,6,9,12,88,100
2013,12,8,6,10,12,117,129
2013,12,8,6,11,5,122,127
2013,12,8,6,12,7,111,118
2013,12,8,6,13,2,78,80
2013,12,8,6,14,2,48,50
2013,12,8,6,15,4,58,62
2013,12,8,6,16,4,37,41
2013,12,8,6,17,1,45,46
2013,12,8,6,18,3,43,46
2013,12,8,6,19,3,27,30
2013,12,8,6,20,2,28,30
2013,12,8,6,21,1,21,22
2013,12,8,6,22,0,10,10
2013,12,8,6,23,0,18,18
2013,12,9,0,0,0,3,3
2013,12,9,0,1,0,1,1
2013,12,9,0,2,0,4,4
2013,12,9,0,3,0,2,2
2013,12,9,0,4,2,3,5
2013,12,9,0,5,1,18,19
2013,12,9,0,6,1,37,38
2013,12,9,0,7,0,68,68
2013,12,9,0,8,2,149,151
2013,12,9,0,9,4,202,206
2013,12,9,0,10,2,179,181
2013,12,9,0,11,1,113,114
2013,12,9,0,12,0,103,103
2013,12,9,0,13,2,130,132
2013,12,9,0,14,7,107,114
2013,12,9,0,15,6,152,158
2013,12,9,0,16,9,239,248
2013,12,9,0,17,11,484,495
2013,12,9,0,18,7,480,487
2013,12,9,0,19,5,324,329
2013,12,9,0,20,2,243,245
2013,12,9,0,21,2,171,173
2013,12,9,0,22,1,124,125
2013,12,9,0,23,2,70,72
2013,12,10,1,0,2,31,33
2013,12,10,1,1,0,11,11
2013,12,10,1,2,1,0,1
2013,12,10,1,3,0,2,2
2013,12,10,1,4,0,7,7
2013,12,10,1,5,1,28,29
2013,12,10,1,6,0,60,60
2013,12,10,1,7,3,59,62
2013,12,10,1,8,1,91,92
2013,12,10,1,9,1,51,52
2013,12,10,1,10,5,49,54
2013,12,10,1,11,1,54,55
2013,12,10,1,12,4,104,108
2013,12,10,1,13,3,114,117
2013,12,10,1,14,5,146,151
2013,12,10,1,15,14,189,203
2013,12,10,1,16,15,236,251
2013,12,10,1,17,14,328,342
2013,12,10,1,18,9,345,354
2013,12,10,1,19,7,218,225
2013,12,10,1,20,6,175,181
2013,12,10,1,21,4,141,145
2013,12,10,1,22,1,127,128
2013,12,10,1,23,2,59,61
2013,12,11,2,0,0,35,35
2013,12,11,2,1,1,13,14
2013,12,11,2,2,0,5,5
2013,12,11,2,3,0,2,2
2013,12,11,2,4,0,4,4
2013,12,11,2,5,1,35,36
2013,12,11,2,6,2,116,118
2013,12,11,2,7,5,352,357
2013,12,11,2,8,15,729,744
2013,12,11,2,9,6,360,366
2013,12,11,2,10,16,133,149
2013,12,11,2,11,21,167,188
2013,12,11,2,12,19,199,218
2013,12,11,2,13,14,168,182
2013,12,11,2,14,14,161,175
2013,12,11,2,15,13,203,216
2013,12,11,2,16,26,330,356
2013,12,11,2,17,12,619,631
2013,12,11,2,18,14,565,579
2013,12,11,2,19,12,382,394
2013,12,11,2,20,13,286,299
2013,12,11,2,21,9,220,229
2013,12,11,2,22,4,138,142
2013,12,11,2,23,7,84,91
2013,12,12,3,0,1,42,43
2013,12,12,3,1,2,15,17
2013,12,12,3,2,0,7,7
2013,12,12,3,3,2,4,6
2013,12,12,3,4,0,3,3
2013,12,12,3,5,1,40,41
2013,12,12,3,6,1,132,133
2013,12,12,3,7,3,371,374
2013,12,12,3,8,13,696,709
2013,12,12,3,9,14,354,368
2013,12,12,3,10,11,168,179
2013,12,12,3,11,9,148,157
2013,12,12,3,12,8,164,172
2013,12,12,3,13,9,178,187
2013,12,12,3,14,10,146,156
2013,12,12,3,15,13,210,223
2013,12,12,3,16,10,316,326
2013,12,12,3,17,9,542,551
2013,12,12,3,18,10,474,484
2013,12,12,3,19,8,332,340
2013,12,12,3,20,10,246,256
2013,12,12,3,21,6,182,188
2013,12,12,3,22,6,136,142
2013,12,12,3,23,2,69,71
2013,12,13,4,0,0,54,54
2013,12,13,4,1,2,26,28
2013,12,13,4,2,1,10,11
2013,12,13,4,3,0,5,5
2013,12,13,4,4,0,4,4
2013,12,13,4,5,2,47,49
2013,12,13,4,6,0,115,115
2013,12,13,4,7,3,331,334
2013,12,13,4,8,6,707,713
2013,12,13,4,9,7,394,401
2013,12,13,4,10,14,187,201
2013,12,13,4,11,16,189,205
2013,12,13,4,12,19,230,249
2013,12,13,4,13,24,218,242
2013,12,13,4,14,19,221,240
2013,12,13,4,15,28,252,280
2013,12,13,4,16,32,375,407
2013,12,13,4,17,21,564,585
2013,12,13,4,18,13,504,517
2013,12,13,4,19,12,318,330
2013,12,13,4,20,7,224,231
2013,12,13,4,21,9,207,216
2013,12,13,4,22,6,155,161
2013,12,13,4,23,5,103,108
2013,12,14,5,0,12,101,113
2013,12,14,5,1,3,85,88
2013,12,14,5,2,4,46,50
2013,12,14,5,3,2,26,28
2013,12,14,5,4,1,3,4
2013,12,14,5,5,1,11,12
2013,12,14,5,6,1,13,14
2013,12,14,5,7,2,50,52
2013,12,14,5,8,12,129,141
2013,12,14,5,9,11,177,188
2013,12,14,5,10,24,243,267
2013,12,14,5,11,38,283,321
2013,12,14,5,12,36,317,353
2013,12,14,5,13,45,305,350
2013,12,14,5,14,19,246,265
2013,12,14,5,15,18,172,190
2013,12,14,5,16,7,60,67
2013,12,14,5,17,4,48,52
2013,12,14,5,18,3,48,51
2013,12,14,5,19,4,52,56
2013,12,14,5,20,4,30,34
2013,12,14,5,21,1,28,29
2013,12,14,5,22,1,47,48
2013,12,14,5,23,0,55,55
2013,12,15,6,0,1,64,65
2013,12,15,6,1,2,48,50
2013,12,15,6,2,2,67,69
2013,12,15,6,3,2,25,27
2013,12,15,6,4,2,7,9
2013,12,15,6,5,1,3,4
2013,12,15,6,6,0,11,11
2013,12,15,6,7,3,36,39
2013,12,15,6,8,7,77,84
2013,12,15,6,9,14,163,177
2013,12,15,6,10,44,244,288
2013,12,15,6,11,53,299,352
2013,12,15,6,12,59,395,454
2013,12,15,6,13,62,379,441
2013,12,15,6,14,81,341,422
2013,12,15,6,15,57,361,418
2013,12,15,6,16,52,351,403
2013,12,15,6,17,45,244,289
2013,12,15,6,18,14,195,209
2013,12,15,6,19,11,161,172
2013,12,15,6,20,15,112,127
2013,12,15,6,21,6,105,111
2013,12,15,6,22,5,77,82
2013,12,15,6,23,1,50,51
2013,12,16,0,0,2,38,40
2013,12,16,0,1,4,9,13
2013,12,16,0,2,1,3,4
2013,12,16,0,3,0,2,2
2013,12,16,0,4,2,6,8
2013,12,16,0,5,1,36,37
2013,12,16,0,6,1,150,151
2013,12,16,0,7,5,406,411
2013,12,16,0,8,8,768,776
2013,12,16,0,9,7,380,387
2013,12,16,0,10,11,140,151
2013,12,16,0,11,19,140,159
2013,12,16,0,12,28,206,234
2013,12,16,0,13,34,216,250
2013,12,16,0,14,10,173,183
2013,12,16,0,15,20,219,239
2013,12,16,0,16,20,307,327
2013,12,16,0,17,10,630,640
2013,12,16,0,18,12,534,546
2013,12,16,0,19,19,425,444
2013,12,16,0,20,5,253,258
2013,12,16,0,21,11,199,210
2013,12,16,0,22,6,117,123
2013,12,16,0,23,3,73,76
2013,12,17,1,0,1,29,30
2013,12,17,1,1,0,18,18
2013,12,17,1,2,0,3,3
2013,12,17,1,3,2,3,5
2013,12,17,1,4,0,6,6
2013,12,17,1,5,0,48,48
2013,12,17,1,6,1,162,163
2013,12,17,1,7,4,428,432
2013,12,17,1,8,6,846,852
2013,12,17,1,9,6,397,403
2013,12,17,1,10,13,181,194
2013,12,17,1,11,14,190,204
2013,12,17,1,12,16,196,212
2013,12,17,1,13,26,218,244
2013,12,17,1,14,12,175,187
2013,12,17,1,15,16,235,251
2013,12,17,1,16,17,327,344
2013,12,17,1,17,13,411,424
2013,12,17,1,18,17,390,407
2013,12,17,1,19,16,294,310
2013,12,17,1,20,4,251,255
2013,12,17,1,21,9,185,194
2013,12,17,1,22,3,125,128
2013,12,17,1,23,6,87,93
2013,12,18,2,0,2,31,33
2013,12,18,2,1,1,14,15
2013,12,18,2,2,0,7,7
2013,12,18,2,3,0,3,3
2013,12,18,2,4,0,5,5
2013,12,18,2,5,1,38,39
2013,12,18,2,6,0,138,138
2013,12,18,2,7,4,433,437
2013,12,18,2,8,12,774,786
2013,12,18,2,9,13,352,365
2013,12,18,2,10,22,141,163
2013,12,18,2,11,26,156,182
2013,12,18,2,12,20,196,216
2013,12,18,2,13,39,206,245
2013,12,18,2,14,15,183,198
2013,12,18,2,15,34,212,246
2013,12,18,2,16,35,346,381
2013,12,18,2,17,27,643,670
2013,12,18,2,18,11,559,570
2013,12,18,2,19,6,385,391
2013,12,18,2,20,5,297,302
2013,12,18,2,21,7,208,215
2013,12,18,2,22,5,132,137
2013,12,18,2,23,7,89,96
2013,12,19,3,0,1,28,29
2013,12,19,3,1,2,14,16
2013,12,19,3,2,0,10,10
2013,12,19,3,3,0,3,3
2013,12,19,3,4,0,6,6
2013,12,19,3,5,0,42,42
2013,12,19,3,6,2,134,136
2013,12,19,3,7,2,393,395
2013,12,19,3,8,10,766,776
2013,12,19,3,9,20,381,401
2013,12,19,3,10,19,160,179
2013,12,19,3,11,28,186,214
2013,12,19,3,12,52,264,316
2013,12,19,3,13,35,247,282
2013,12,19,3,14,58,224,282
2013,12,19,3,15,50,314,364
2013,12,19,3,16,51,390,441
2013,12,19,3,17,67,693,760
2013,12,19,3,18,10,701,711
2013,12,19,3,19,26,446,472
2013,12,19,3,20,14,298,312
2013,12,19,3,21,13,235,248
2013,12,19,3,22,10,177,187
2013,12,19,3,23,11,123,134
2013,12,20,4,0,8,74,82
2013,12,20,4,1,6,40,46
2013,12,20,4,2,7,14,21
2013,12,20,4,3,0,6,6
2013,12,20,4,4,1,6,7
2013,12,20,4,5,1,46,47
2013,12,20,4,6,2,127,129
2013,12,20,4,7,2,389,391
2013,12,20,4,8,20,685,705
2013,12,20,4,9,23,466,489
2013,12,20,4,10,34,192,226
2013,12,20,4,11,36,234,270
2013,12,20,4,12,53,300,353
2013,12,20,4,13,43,288,331
2013,12,20,4,14,60,257,317
2013,12,20,4,15,67,309,376
2013,12,20,4,16,53,424,477
2013,12,20,4,17,51,612,663
2013,12,20,4,18,19,483,502
2013,12,20,4,19,18,341,359
2013,12,20,4,20,28,227,255
2013,12,20,4,21,22,184,206
2013,12,20,4,22,18,164,182
2013,12,20,4,23,8,127,135
2013,12,21,5,0,11,104,115
2013,12,21,5,1,4,67,71
2013,12,21,5,2,8,64,72
2013,12,21,5,3,3,20,23
2013,12,21,5,4,2,2,4
2013,12,21,5,5,1,3,4
2013,12,21,5,6,3,18,21
2013,12,21,5,7,7,48,55
2013,12,21,5,8,21,102,123
2013,12,21,5,9,55,191,246
2013,12,21,5,10,74,265,339
2013,12,21,5,11,111,345,456
2013,12,21,5,12,142,357,499
2013,12,21,5,13,178,411,589
2013,12,21,5,14,220,459,679
2013,12,21,5,15,238,459,697
2013,12,21,5,16,241,405,646
2013,12,21,5,17,177,322,499
2013,12,21,5,18,103,268,371
2013,12,21,5,19,66,202,268
2013,12,21,5,20,60,145,205
2013,12,21,5,21,49,154,203
2013,12,21,5,22,37,137,174
2013,12,21,5,23,27,109,136
2013,12,22,6,0,38,75,113
2013,12,22,6,1,16,69,85
2013,12,22,6,2,1,41,42
2013,12,22,6,3,7,15,22
2013,12,22,6,4,5,3,8
2013,12,22,6,5,1,3,4
2013,12,22,6,6,0,11,11
2013,12,22,6,7,3,31,34
2013,12,22,6,8,6,45,51
2013,12,22,6,9,8,39,47
2013,12,22,6,10,22,74,96
2013,12,22,6,11,23,100,123
2013,12,22,6,12,45,160,205
2013,12,22,6,13,57,181,238
2013,12,22,6,14,76,206,282
2013,12,22,6,15,77,195,272
2013,12,22,6,16,90,233,323
2013,12,22,6,17,59,186,245
2013,12,22,6,18,36,117,153
2013,12,22,6,19,20,123,143
2013,12,22,6,20,17,104,121
2013,12,22,6,21,28,86,114
2013,12,22,6,22,14,44,58
2013,12,22,6,23,11,48,59
2013,12,23,0,0,4,13,17
2013,12,23,0,1,2,7,9
2013,12,23,0,2,0,1,1
2013,12,23,0,3,0,2,2
2013,12,23,0,4,0,2,2
2013,12,23,0,5,0,10,10
2013,12,23,0,6,1,28,29
2013,12,23,0,7,3,84,87
2013,12,23,0,8,8,110,118
2013,12,23,0,9,15,78,93
2013,12,23,0,10,8,28,36
2013,12,23,0,11,16,42,58
2013,12,23,0,12,14,58,72
2013,12,23,0,13,8,87,95
2013,12,23,0,14,9,131,140
2013,12,23,0,15,21,136,157
2013,12,23,0,16,9,175,184
2013,12,23,0,17,15,254,269
2013,12,23,0,18,5,207,212
2013,12,23,0,19,11,150,161
2013,12,23,0,20,4,106,110
2013,12,23,0,21,0,69,69
2013,12,23,0,22,4,50,54
2013,12,23,0,23,2,44,46
2013,12,24,1,0,1,25,26
2013,12,24,1,1,0,5,5
2013,12,24,1,2,0,2,2
2013,12,24,1,3,0,3,3
2013,12,24,1,4,0,7,7
2013,12,24,1,5,0,19,19
2013,12,24,1,6,2,56,58
2013,12,24,1,7,2,105,107
2013,12,24,1,8,5,205,210
2013,12,24,1,9,7,153,160
2013,12,24,1,10,34,103,137
2013,12,24,1,11,39,158,197
2013,12,24,1,12,49,169,218
2013,12,24,1,13,43,230,273
2013,12,24,1,14,23,209,232
2013,12,24,1,15,22,182,204
2013,12,24,1,16,11,146,157
2013,12,24,1,17,13,110,123
2013,12,24,1,18,10,64,74
2013,12,24,1,19,4,44,48
2013,12,24,1,20,2,31,33
2013,12,24,1,21,3,27,30
2013,12,24,1,22,5,16,21
2013,12,24,1,23,1,24,25
2013,12,25,2,0,0,6,6
2013,12,25,2,1,1,11,12
2013,12,25,2,2,0,1,1
2013,12,25,2,3,0,2,2
2013,12,25,2,5,1,3,4
2013,12,25,2,6,1,4,5
2013,12,25,2,7,0,6,6
2013,12,25,2,8,3,19,22
2013,12,25,2,9,18,25,43
2013,12,25,2,10,16,35,51
2013,12,25,2,11,37,52,89
2013,12,25,2,12,54,64,118
2013,12,25,2,13,61,62,123
2013,12,25,2,14,49,51,100
2013,12,25,2,15,36,55,91
2013,12,25,2,16,37,56,93
2013,12,25,2,17,11,44,55
2013,12,25,2,18,9,35,44
2013,12,25,2,19,7,37,44
2013,12,25,2,20,6,26,32
2013,12,25,2,21,5,26,31
2013,12,25,2,22,2,22,24
2013,12,25,2,23,0,16,16
2013,12,26,3,0,0,9,9
2013,12,26,3,1,0,2,2
2013,12,26,3,2,0,1,1
2013,12,26,3,4,0,2,2
2013,12,26,3,5,0,13,13
2013,12,26,3,6,0,28,28
2013,12,26,3,7,1,85,86
2013,12,26,3,8,1,158,159
2013,12,26,3,9,6,143,149
2013,12,26,3,10,16,75,91
2013,12,26,3,11,33,96,129
2013,12,26,3,12,54,135,189
2013,12,26,3,13,55,133,188
2013,12,26,3,14,48,111,159
2013,12,26,3,15,66,154,220
2013,12,26,3,16,64,178,242
2013,12,26,3,17,40,232,272
2013,12,26,3,18,12,160,172
2013,12,26,3,19,10,113,123
2013,12,26,3,20,7,80,87
2013,12,26,3,21,2,51,53
2013,12,26,3,22,6,47,53
2013,12,26,3,23,4,38,42
2013,12,27,4,0,0,19,19
2013,12,27,4,1,2,8,10
2013,12,27,4,2,1,6,7
2013,12,27,4,4,0,1,1
2013,12,27,4,5,1,22,23
2013,12,27,4,6,1,46,47
2013,12,27,4,7,2,127,129
2013,12,27,4,8,14,226,240
2013,12,27,4,9,22,184,206
2013,12,27,4,10,70,107,177
2013,12,27,4,11,98,135,233
2013,12,27,4,12,59,155,214
2013,12,27,4,13,92,181,273
2013,12,27,4,14,77,203,280
2013,12,27,4,15,87,184,271
2013,12,27,4,16,91,250,341
2013,12,27,4,17,66,304,370
2013,12,27,4,18,33,204,237
2013,12,27,4,19,26,142,168
2013,12,27,4,20,20,112,132
2013,12,27,4,21,17,68,85
2013,12,27,4,22,19,76,95
2013,12,27,4,23,3,58,61
2013,12,28,5,0,1,48,49
2013,12,28,5,1,5,34,39
2013,12,28,5,2,1,20,21
2013,12,28,5,3,2,4,6
2013,12,28,5,4,0,5,5
2013,12,28,5,5,0,5,5
2013,12,28,5,6,1,11,12
2013,12,28,5,7,4,27,31
2013,12,28,5,8,8,49,57
2013,12,28,5,9,48,86,134
2013,12,28,5,10,109,135,244
2013,12,28,5,11,158,157,315
2013,12,28,5,12,219,195,414
2013,12,28,5,13,217,221,438
2013,12,28,5,14,287,261,548
2013,12,28,5,15,262,226,488
2013,12,28,5,16,240,238,478
2013,12,28,5,17,151,192,343
2013,12,28,5,18,86,152,238
2013,12,28,5,19,52,107,159
2013,12,28,5,20,27,88,115
2013,12,28,5,21,35,117,152
2013,12,28,5,22,19,70,89
2013,12,28,5,23,4,66,70
2013,12,29,6,0,9,46,55
2013,12,29,6,1,15,47,62
2013,12,29,6,2,1,27,28
2013,12,29,6,3,1,17,18
2013,12,29,6,4,1,3,4
2013,12,29,6,5,0,1,1
2013,12,29,6,6,1,1,2
2013,12,29,6,7,2,10,12
2013,12,29,6,8,0,11,11
2013,12,29,6,9,2,16,18
2013,12,29,6,10,5,19,24
2013,12,29,6,11,1,20,21
2013,12,29,6,12,1,17,18
2013,12,29,6,13,12,35,47
2013,12,29,6,14,24,77,101
2013,12,29,6,15,20,115,135
2013,12,29,6,16,37,145,182
2013,12,29,6,17,24,137,161
2013,12,29,6,18,35,119,154
2013,12,29,6,19,20,83,103
2013,12,29,6,20,18,60,78
2013,12,29,6,21,31,68,99
2013,12,29,6,22,18,64,82
2013,12,29,6,23,11,33,44
2013,12,30,0,0,12,19,31
2013,12,30,0,1,2,11,13
2013,12,30,0,2,0,5,5
2013,12,30,0,3,0,3,3
2013,12,30,0,4,1,4,5
2013,12,30,0,5,0,27,27
2013,12,30,0,6,0,92,92
2013,12,30,0,7,3,231,234
2013,12,30,0,8,16,401,417
2013,12,30,0,9,46,261,307
2013,12,30,0,10,51,140,191
2013,12,30,0,11,58,162,220
2013,12,30,0,12,67,169,236
2013,12,30,0,13,71,188,259
2013,12,30,0,14,78,172,250
2013,12,30,0,15,75,212,287
2013,12,30,0,16,73,267,340
2013,12,30,0,17,45,434,479
2013,12,30,0,18,22,346,368
2013,12,30,0,19,13,238,251
2013,12,30,0,20,15,123,138
2013,12,30,0,21,17,92,109
2013,12,30,0,22,5,74,79
2013,12,30,0,23,4,55,59
2013,12,31,1,0,0,25,25
2013,12,31,1,1,0,14,14
2013,12,31,1,2,2,6,8
2013,12,31,1,3,0,1,1
2013,12,31,1,4,1,6,7
2013,12,31,1,5,1,17,18
2013,12,31,1,6,0,64,64
2013,12,31,1,7,2,184,186
2013,12,31,1,8,15,397,412
2013,12,31,1,9,28,257,285
2013,12,31,1,10,38,152,190
2013,12,31,1,11,72,168,240
2013,12,31,1,12,53,233,286
2013,12,31,1,13,48,270,318
2013,12,31,1,14,58,298,356
2013,12,31,1,15,74,366,440
2013,12,31,1,16,61,313,374
2013,12,31,1,17,22,234,256
2013,12,31,1,18,15,185,200
2013,12,31,1,19,7,146,153
2013,12,31,1,20,13,88,101
2013,12,31,1,21,11,88,99
2013,12,31,1,22,4,68,72
2013,12,31,1,23,6,55,61
2014,1,1,2,0,4,63,67
2014,1,1,2,1,5,101,106
2014,1,1,2,2,24,98,122
2014,1,1,2,3,13,52,65
2014,1,1,2,4,0,10,10
2014,1,1,2,5,0,12,12
2014,1,1,2,6,0,11,11
2014,1,1,2,7,0,13,13
2014,1,1,2,8,1,26,27
2014,1,1,2,9,12,55,67
2014,1,1,2,10,20,72,92
2014,1,1,2,11,37,143,180
2014,1,1,2,12,67,194,261
2014,1,1,2,13,94,192,286
2014,1,1,2,14,121,217,338
2014,1,1,2,15,107,190,297
2014,1,1,2,16,81,201,282
2014,1,1,2,17,53,159,212
2014,1,1,2,18,17,132,149
2014,1,1,2,19,22,117,139
2014,1,1,2,20,22,83,105
2014,1,1,2,21,6,85,91
2014,1,1,2,22,16,53,69
2014,1,1,2,23,7,33,40
2014,1,2,3,0,2,14,16
2014,1,2,3,1,0,2,2
2014,1,2,3,2,0,1,1
2014,1,2,3,4,0,1,1
2014,1,2,3,5,3,21,24
2014,1,2,3,6,1,111,112
2014,1,2,3,7,5,268,273
2014,1,2,3,8,10,599,609
2014,1,2,3,9,15,325,340
2014,1,2,3,10,19,115,134
2014,1,2,3,11,19,131,150
2014,1,2,3,12,28,172,200
2014,1,2,3,13,43,181,224
2014,1,2,3,14,45,179,224
2014,1,2,3,15,40,199,239
2014,1,2,3,16,17,194,211
2014,1,2,3,17,21,235,256
2014,1,2,3,18,10,163,173
2014,1,2,3,19,7,65,72
2014,1,2,3,20,0,42,42
2014,1,2,3,21,2,23,25
2014,1,2,3,22,1,14,15
2014,1,2,3,23,0,13,13
2014,1,3,4,0,1,6,7
2014,1,3,4,1,3,6,9
2014,1,3,4,2,0,3,3
2014,1,3,4,4,0,2,2
2014,1,3,4,5,0,12,12
2014,1,3,4,6,1,17,18
2014,1,3,4,7,0,51,51
2014,1,3,4,8,2,133,135
2014,1,3,4,9,2,101,103
2014,1,3,4,10,14,46,60
2014,1,3,4,11,4,50,54
2014,1,3,4,12,0,72,72
2014,1,3,4,13,6,73,79
2014,1,3,4,14,9,71,80
2014,1,3,4,15,11,97,108
2014,1,3,4,16,8,112,120
2014,1,3,4,17,7,222,229
2014,1,3,4,18,2,194,196
2014,1,3,4,19,5,99,104
2014,1,3,4,20,0,67,67
2014,1,3,4,21,0,54,54
2014,1,3,4,22,0,41,41
2014,1,3,4,23,0,30,30
2014,1,4,5,0,1,20,21
2014,1,4,5,1,0,17,17
2014,1,4,5,2,0,13,13
2014,1,4,5,3,2,6,8
2014,1,4,5,4,0,1,1
2014,1,4,5,5,0,6,6
2014,1,4,5,6,0,4,4
2014,1,4,5,7,1,22,23
2014,1,4,5,8,1,52,53
2014,1,4,5,9,4,94,98
2014,1,4,5,10,11,119,130
2014,1,4,5,11,12,167,179
2014,1,4,5,12,15,182,197
2014,1,4,5,13,12,163,175
2014,1,4,5,14,21,167,188
2014,1,4,5,15,23,195,218
2014,1,4,5,16,6,195,201
2014,1,4,5,17,14,137,151
2014,1,4,5,18,7,146,153
2014,1,4,5,19,4,132,136
2014,1,4,5,20,6,89,95
2014,1,4,5,21,3,74,77
2014,1,4,5,22,9,61,70
2014,1,4,5,23,6,61,67
2014,1,5,6,0,5,59,64
2014,1,5,6,1,1,44,45
2014,1,5,6,2,1,34,35
2014,1,5,6,3,0,20,20
2014,1,5,6,4,0,4,4
2014,1,5,6,5,0,3,3
2014,1,5,6,6,0,2,2
2014,1,5,6,7,3,14,17
2014,1,5,6,8,0,21,21
2014,1,5,6,9,0,44,44
2014,1,5,6,10,1,84,85
2014,1,5,6,11,6,120,126
2014,1,5,6,12,11,147,158
2014,1,5,6,13,13,176,189
2014,1,5,6,14,13,163,176
2014,1,5,6,15,28,165,193
2014,1,5,6,16,20,218,238
2014,1,5,6,17,16,193,209
2014,1,5,6,18,8,102,110
2014,1,5,6,19,3,101,104
2014,1,5,6,20,0,114,114
2014,1,5,6,21,2,53,55
2014,1,5,6,22,2,32,34
2014,1,5,6,23,2,32,34
2014,1,6,0,0,0,16,16
2014,1,6,0,1,0,4,4
2014,1,6,0,2,0,2,2
2014,1,6,0,3,0,2,2
2014,1,6,0,4,0,2,2
2014,1,6,0,5,0,15,15
2014,1,6,0,6,0,81,81
2014,1,6,0,7,3,171,174
2014,1,6,0,8,5,599,604
2014,1,6,0,9,6,241,247
2014,1,6,0,10,7,106,113
2014,1,6,0,11,10,103,113
2014,1,6,0,12,14,144,158
2014,1,6,0,13,7,148,155
2014,1,6,0,14,11,117,128
2014,1,6,0,15,10,174,184
2014,1,6,0,16,9,248,257
2014,1,6,0,17,13,471,484
2014,1,6,0,18,10,364,374
2014,1,6,0,19,4,209,213
2014,1,6,0,20,8,89,97
2014,1,6,0,21,4,77,81
2014,1,6,0,22,1,27,28
2014,1,6,0,23,1,20,21
2014,1,7,1,0,0,19,19
2014,1,7,1,1,0,4,4
2014,1,7,1,2,0,1,1
2014,1,7,1,3,0,1,1
2014,1,7,1,4,0,2,2
2014,1,7,1,5,0,24,24
2014,1,7,1,6,0,51,51
2014,1,7,1,7,4,145,149
2014,1,7,1,8,4,308,312
2014,1,7,1,9,2,208,210
2014,1,7,1,10,3,66,69
2014,1,7,1,11,3,46,49
2014,1,7,1,12,0,77,77
2014,1,7,1,13,1,69,70
2014,1,7,1,14,2,72,74
2014,1,7,1,15,4,75,79
2014,1,7,1,16,0,140,140
2014,1,7,1,17,1,279,280
2014,1,7,1,18,2,279,281
2014,1,7,1,19,1,176,177
2014,1,7,1,20,0,94,94
2014,1,7,1,21,1,71,72
2014,1,7,1,22,1,56,57
2014,1,7,1,23,0,38,38
2014,1,8,2,0,0,8,8
2014,1,8,2,1,0,1,1
2014,1,8,2,2,0,1,1
2014,1,8,2,3,0,1,1
2014,1,8,2,4,0,3,3
2014,1,8,2,5,0,23,23
2014,1,8,2,6,1,92,93
2014,1,8,2,7,2,208,210
2014,1,8,2,8,4,547,551
2014,1,8,2,9,2,301,303
2014,1,8,2,10,4,94,98
2014,1,8,2,11,7,123,130
2014,1,8,2,12,8,149,157
2014,1,8,2,13,4,132,136
2014,1,8,2,14,8,145,153
2014,1,8,2,15,4,156,160
2014,1,8,2,16,10,226,236
2014,1,8,2,17,6,499,505
2014,1,8,2,18,8,437,445
2014,1,8,2,19,4,325,329
2014,1,8,2,20,1,171,172
2014,1,8,2,21,0,124,124
2014,1,8,2,22,1,77,78
2014,1,8,2,23,1,58,59
2014,1,9,3,0,1,11,12
2014,1,9,3,1,1,4,5
2014,1,9,3,2,1,1,2
2014,1,9,3,3,0,4,4
2014,1,9,3,4,0,2,2
2014,1,9,3,5,0,36,36
2014,1,9,3,6,2,128,130
2014,1,9,3,7,2,327,329
2014,1,9,3,8,5,742,747
2014,1,9,3,9,3,351,354
2014,1,9,3,10,17,133,150
2014,1,9,3,11,19,115,134
2014,1,9,3,12,34,189,223
2014,1,9,3,13,28,189,217
2014,1,9,3,14,11,156,167
2014,1,9,3,15,21,197,218
2014,1,9,3,16,16,272,288
2014,1,9,3,17,8,541,549
2014,1,9,3,18,8,471,479
2014,1,9,3,19,3,346,349
2014,1,9,3,20,2,248,250
2014,1,9,3,21,4,163,167
2014,1,9,3,22,2,111,113
2014,1,9,3,23,2,65,67
2014,1,10,4,0,2,40,42
2014,1,10,4,1,0,9,9
2014,1,10,4,2,0,7,7
2014,1,10,4,3,0,3,3
2014,1,10,4,4,0,3,3
2014,1,10,4,5,0,20,20
2014,1,10,4,6,0,39,39
2014,1,10,4,7,1,76,77
2014,1,10,4,8,0,133,133
2014,1,10,4,9,2,98,100
2014,1,10,4,10,0,35,35
2014,1,10,4,11,5,68,73
2014,1,10,4,12,3,125,128
2014,1,10,4,13,8,78,86
2014,1,10,4,14,6,54,60
2014,1,10,4,15,14,100,114
2014,1,10,4,16,5,102,107
2014,1,10,4,17,9,206,215
2014,1,10,4,18,7,180,187
2014,1,10,4,19,3,87,90
2014,1,10,4,20,6,116,122
2014,1,10,4,21,1,76,77
2014,1,10,4,22,2,70,72
2014,1,10,4,23,7,55,62
2014,1,11,5,0,2,62,64
2014,1,11,5,1,6,49,55
2014,1,11,5,2,1,29,30
2014,1,11,5,3,0,17,17
2014,1,11,5,4,0,6,6
2014,1,11,5,5,0,5,5
2014,1,11,5,6,0,3,3
2014,1,11,5,7,0,22,22
2014,1,11,5,8,3,58,61
2014,1,11,5,9,2,114,116
2014,1,11,5,10,0,64,64
2014,1,11,5,11,1,75,76
2014,1,11,5,12,1,86,87
2014,1,11,5,13,0,96,96
2014,1,11,5,14,6,119,125
2014,1,11,5,15,4,118,122
2014,1,11,5,16,2,85,87
2014,1,11,5,17,1,114,115
2014,1,11,5,18,8,150,158
2014,1,11,5,19,20,175,195
2014,1,11,5,20,23,120,143
2014,1,11,5,21,7,115,122
2014,1,11,5,22,5,97,102
2014,1,11,5,23,5,108,113
2014,1,12,6,0,3,102,105
2014,1,12,6,1,4,85,89
2014,1,12,6,2,3,65,68
2014,1,12,6,3,0,29,29
2014,1,12,6,4,0,8,8
2014,1,12,6,5,1,3,4
2014,1,12,6,6,4,7,11
2014,1,12,6,7,7,28,35
2014,1,12,6,8,27,81,108
2014,1,12,6,9,21,164,185
2014,1,12,6,10,67,248,315
2014,1,12,6,11,66,327,393
2014,1,12,6,12,110,395,505
2014,1,12,6,13,135,421,556
2014,1,12,6,14,137,397,534
2014,1,12,6,15,110,430,540
2014,1,12,6,16,90,455,545
2014,1,12,6,17,71,316,387
2014,1,12,6,18,44,282,326
2014,1,12,6,19,34,199,233
2014,1,12,6,20,34,184,218
2014,1,12,6,21,14,118,132
2014,1,12,6,22,11,73,84
2014,1,12,6,23,6,51,57
2014,1,13,0,0,3,15,18
2014,1,13,0,1,2,6,8
2014,1,13,0,2,4,5,9
2014,1,13,0,3,0,1,1
2014,1,13,0,4,0,4,4
2014,1,13,0,5,0,37,37
2014,1,13,0,6,2,137,139
2014,1,13,0,7,27,417,444
2014,1,13,0,8,20,806,826
2014,1,13,0,9,32,359,391
2014,1,13,0,10,44,130,174
2014,1,13,0,11,43,175,218
2014,1,13,0,12,65,270,335
2014,1,13,0,13,67,266,333
2014,1,13,0,14,63,200,263
2014,1,13,0,15,88,218,306
2014,1,13,0,16,65,404,469
2014,1,13,0,17,67,787,854
2014,1,13,0,18,21,695,716
2014,1,13,0,19,39,492,531
2014,1,13,0,20,26,324,350
2014,1,13,0,21,28,232,260
2014,1,13,0,22,18,142,160
2014,1,13,0,23,8,65,73
2014,1,14,1,0,8,24,32
2014,1,14,1,1,2,9,11
2014,1,14,1,2,0,2,2
2014,1,14,1,3,1,1,2
2014,1,14,1,4,0,3,3
2014,1,14,1,5,1,44,45
2014,1,14,1,6,3,139,142
2014,1,14,1,7,11,295,306
2014,1,14,1,8,33,741,774
2014,1,14,1,9,36,318,354
2014,1,14,1,10,17,92,109
2014,1,14,1,11,5,56,61
2014,1,14,1,12,4,46,50
2014,1,14,1,13,5,39,44
2014,1,14,1,14,10,73,83
2014,1,14,1,15,21,154,175
2014,1,14,1,16,31,288,319
2014,1,14,1,17,35,611,646
2014,1,14,1,18,28,663,691
2014,1,14,1,19,41,411,452
2014,1,14,1,20,19,307,326
2014,1,14,1,21,17,221,238
2014,1,14,1,22,14,167,181
2014,1,14,1,23,3,77,80
2014,1,15,2,0,4,30,34
2014,1,15,2,1,2,11,13
2014,1,15,2,2,2,8,10
2014,1,15,2,4,0,2,2
2014,1,15,2,5,1,37,38
2014,1,15,2,6,2,137,139
2014,1,15,2,7,16,421,437
2014,1,15,2,8,18,811,829
2014,1,15,2,9,29,359,388
2014,1,15,2,10,21,153,174
2014,1,15,2,11,31,178,209
2014,1,15,2,12,48,224,272
2014,1,15,2,13,45,198,243
2014,1,15,2,14,50,197,247
2014,1,15,2,15,50,243,293
2014,1,15,2,16,36,394,430
2014,1,15,2,17,59,741,800
2014,1,15,2,18,35,684,719
2014,1,15,2,19,20,433,453
2014,1,15,2,20,19,296,315
2014,1,15,2,21,10,206,216
2014,1,15,2,22,10,158,168
2014,1,15,2,23,8,73,81
2014,1,16,3,0,3,37,40
2014,1,16,3,1,2,6,8
2014,1,16,3,2,0,6,6
2014,1,16,3,3,0,4,4
2014,1,16,3,4,2,4,6
2014,1,16,3,5,2,42,44
2014,1,16,3,6,2,145,147
2014,1,16,3,7,6,409,415
2014,1,16,3,8,23,841,864
2014,1,16,3,9,25,378,403
2014,1,16,3,10,19,144,163
2014,1,16,3,11,41,145,186
2014,1,16,3,12,32,200,232
2014,1,16,3,13,45,200,245
2014,1,16,3,14,41,153,194
2014,1,16,3,15,31,213,244
2014,1,16,3,16,28,353,381
2014,1,16,3,17,20,640,660
2014,1,16,3,18,26,651,677
2014,1,16,3,19,16,403,419
2014,1,16,3,20,5,276,281
2014,1,16,3,21,7,195,202
2014,1,16,3,22,3,144,147
2014,1,16,3,23,6,93,99
2014,1,17,4,0,6,45,51
2014,1,17,4,1,1,13,14
2014,1,17,4,2,2,10,12
2014,1,17,4,3,0,2,2
2014,1,17,4,4,0,3,3
2014,1,17,4,5,1,35,36
2014,1,17,4,6,1,119,120
2014,1,17,4,7,2,347,349
2014,1,17,4,8,10,777,787
2014,1,17,4,9,10,402,412
2014,1,17,4,10,27,174,201
2014,1,17,4,11,24,190,214
2014,1,17,4,12,41,257,298
2014,1,17,4,13,54,260,314
2014,1,17,4,14,64,245,309
2014,1,17,4,15,63,267,330
2014,1,17,4,16,78,391,469
2014,1,17,4,17,52,638,690
2014,1,17,4,18,29,537,566
2014,1,17,4,19,21,350,371
2014,1,17,4,20,13,213,226
2014,1,17,4,21,16,156,172
2014,1,17,4,22,12,121,133
2014,1,17,4,23,5,101,106
2014,1,18,5,0,7,88,95
2014,1,18,5,1,5,74,79
2014,1,18,5,2,4,33,37
2014,1,18,5,3,1,21,22
2014,1,18,5,4,0,8,8
2014,1,18,5,5,0,6,6
2014,1,18,5,6,0,16,16
2014,1,18,5,7,3,42,45
2014,1,18,5,8,7,87,94
2014,1,18,5,9,27,152,179
2014,1,18,5,10,46,213,259
2014,1,18,5,11,36,265,301
2014,1,18,5,12,49,239,288
2014,1,18,5,13,36,249,285
2014,1,18,5,14,48,205,253
2014,1,18,5,15,53,218,271
2014,1,18,5,16,31,223,254
2014,1,18,5,17,28,183,211
2014,1,18,5,18,7,145,152
2014,1,18,5,19,7,136,143
2014,1,18,5,20,4,124,128
2014,1,18,5,21,6,88,94
2014,1,18,5,22,2,60,62
2014,1,18,5,23,3,67,70
2014,1,19,6,0,3,62,65
2014,1,19,6,1,0,50,50
2014,1,19,6,2,3,44,47
2014,1,19,6,3,0,18,18
2014,1,19,6,4,0,3,3
2014,1,19,6,5,2,1,3
2014,1,19,6,6,1,6,7
2014,1,19,6,7,2,19,21
2014,1,19,6,8,2,55,57
2014,1,19,6,9,20,93,113
2014,1,19,6,10,35,191,226
2014,1,19,6,11,64,265,329
2014,1,19,6,12,99,318,417
2014,1,19,6,13,83,314,397
2014,1,19,6,14,79,358,437
2014,1,19,6,15,109,285,394
2014,1,19,6,16,73,271,344
2014,1,19,6,17,61,252,313
2014,1,19,6,18,23,239,262
2014,1,19,6,19,11,145,156
2014,1,19,6,20,10,127,137
2014,1,19,6,21,12,118,130
2014,1,19,6,22,17,128,145
2014,1,19,6,23,11,63,74
2014,1,20,0,0,5,43,48
2014,1,20,0,1,4,28,32
2014,1,20,0,2,1,14,15
2014,1,20,0,3,0,7,7
2014,1,20,0,4,0,3,3
2014,1,20,0,5,0,7,7
2014,1,20,0,6,2,40,42
2014,1,20,0,7,2,73,75
2014,1,20,0,8,8,139,147
2014,1,20,0,9,6,166,172
2014,1,20,0,10,54,194,248
2014,1,20,0,11,67,282,349
2014,1,20,0,12,118,362,480
2014,1,20,0,13,100,449,549
2014,1,20,0,14,113,372,485
2014,1,20,0,15,154,407,561
2014,1,20,0,16,120,428,548
2014,1,20,0,17,57,411,468
2014,1,20,0,18,32,324,356
2014,1,20,0,19,18,233,251
2014,1,20,0,20,5,196,201
2014,1,20,0,21,4,150,154
2014,1,20,0,22,6,98,104
2014,1,20,0,23,4,62,66
2014,1,21,1,0,4,25,29
2014,1,21,1,1,2,8,10
2014,1,21,1,3,0,1,1
2014,1,21,1,4,0,5,5
2014,1,21,1,5,1,38,39
2014,1,21,1,6,1,90,91
2014,1,21,1,7,2,184,186
2014,1,21,1,8,6,374,380
2014,1,21,1,9,5,265,270
2014,1,21,1,10,7,158,165
2014,1,21,1,11,6,106,112
2014,1,21,1,12,3,66,69
2014,1,21,1,13,0,60,60
2014,1,21,1,14,0,43,43
2014,1,21,1,15,2,53,55
2014,1,21,1,16,1,48,49
2014,1,21,1,17,0,51,51
2014,1,21,1,18,2,48,50
2014,1,21,1,19,0,22,22
2014,1,21,1,20,0,32,32
2014,1,21,1,21,0,17,17
2014,1,21,1,22,1,14,15
2014,1,21,1,23,2,13,15
2014,1,22,2,0,0,7,7
2014,1,22,2,1,1,4,5
2014,1,22,2,2,0,3,3
2014,1,22,2,3,1,0,1
2014,1,22,2,5,0,7,7
2014,1,22,2,6,0,19,19
2014,1,22,2,7,0,27,27
2014,1,22,2,8,0,99,99
2014,1,22,2,9,1,123,124
2014,1,22,2,10,1,83,84
2014,1,22,2,11,0,44,44
2014,1,22,2,12,0,46,46
2014,1,22,2,13,0,59,59
2014,1,22,2,14,0,45,45
2014,1,22,2,15,1,59,60
2014,1,22,2,16,1,100,101
2014,1,22,2,17,1,199,200
2014,1,22,2,18,2,169,171
2014,1,22,2,19,2,141,143
2014,1,22,2,20,0,92,92
2014,1,22,2,21,0,65,65
2014,1,22,2,22,0,36,36
2014,1,22,2,23,2,23,25
2014,1,23,3,0,0,9,9
2014,1,23,3,1,0,1,1
2014,1,23,3,2,0,2,2
2014,1,23,3,3,0,1,1
2014,1,23,3,4,0,1,1
2014,1,23,3,5,0,19,19
2014,1,23,3,6,0,50,50
2014,1,23,3,7,0,146,146
2014,1,23,3,8,2,346,348
2014,1,23,3,9,3,182,185
2014,1,23,3,10,1,78,79
2014,1,23,3,11,2,82,84
2014,1,23,3,12,6,87,93
2014,1,23,3,13,4,91,95
2014,1,23,3,14,4,98,102
2014,1,23,3,15,2,97,99
2014,1,23,3,16,2,117,119
2014,1,23,3,17,5,305,310
2014,1,23,3,18,1,260,261
2014,1,23,3,19,1,164,165
2014,1,23,3,20,1,119,120
2014,1,23,3,21,0,81,81
2014,1,23,3,22,0,54,54
2014,1,23,3,23,0,26,26
2014,1,24,4,0,1,13,14
2014,1,24,4,1,0,3,3
2014,1,24,4,2,0,5,5
2014,1,24,4,3,0,2,2
2014,1,24,4,4,0,1,1
2014,1,24,4,5,0,21,21
2014,1,24,4,6,0,61,61
2014,1,24,4,7,2,139,141
2014,1,24,4,8,4,328,332
2014,1,24,4,9,5,205,210
2014,1,24,4,10,2,94,96
2014,1,24,4,11,2,104,106
2014,1,24,4,12,1,105,106
2014,1,24,4,13,2,113,115
2014,1,24,4,14,7,107,114
2014,1,24,4,15,1,132,133
2014,1,24,4,16,0,161,161
2014,1,24,4,17,5,330,335
2014,1,24,4,18,2,249,251
2014,1,24,4,19,3,165,168
2014,1,24,4,20,1,101,102
2014,1,24,4,21,1,78,79
2014,1,24,4,22,0,55,55
2014,1,24,4,23,1,39,40
2014,1,25,5,0,0,34,34
2014,1,25,5,1,1,40,41
2014,1,25,5,2,2,27,29
2014,1,25,5,3,0,7,7
2014,1,25,5,4,0,2,2
2014,1,25,5,5,0,3,3
2014,1,25,5,6,0,11,11
2014,1,25,5,7,0,24,24
2014,1,25,5,8,0,75,75
2014,1,25,5,9,0,76,76
2014,1,25,5,10,0,142,142
2014,1,25,5,11,4,170,174
2014,1,25,5,12,5,159,164
2014,1,25,5,13,3,179,182
2014,1,25,5,14,13,159,172
2014,1,25,5,15,8,176,184
2014,1,25,5,16,22,170,192
2014,1,25,5,17,13,174,187
2014,1,25,5,18,7,133,140
2014,1,25,5,19,5,130,135
2014,1,25,5,20,3,98,101
2014,1,25,5,21,4,69,73
2014,1,25,5,22,2,74,76
2014,1,25,5,23,2,67,69
2014,1,26,6,0,1,65,66
2014,1,26,6,1,1,42,43
2014,1,26,6,2,0,34,34
2014,1,26,6,3,0,17,17
2014,1,26,6,4,0,3,3
2014,1,26,6,5,0,2,2
2014,1,26,6,6,0,4,4
2014,1,26,6,7,1,18,19
2014,1,26,6,8,1,48,49
2014,1,26,6,9,3,97,100
2014,1,26,6,10,8,149,157
2014,1,26,6,11,21,220,241
2014,1,26,6,12,14,223,237
2014,1,26,6,13,13,239,252
2014,1,26,6,14,17,200,217
2014,1,26,6,15,14,203,217
2014,1,26,6,16,21,206,227
2014,1,26,6,17,6,206,212
2014,1,26,6,18,6,138,144
2014,1,26,6,19,0,113,113
2014,1,26,6,20,0,78,78
2014,1,26,6,21,3,73,76
2014,1,26,6,22,0,46,46
2014,1,26,6,23,0,34,34
2014,1,27,0,0,0,17,17
2014,1,27,0,1,0,4,4
2014,1,27,0,2,0,3,3
2014,1,27,0,3,0,3,3
2014,1,27,0,4,0,5,5
2014,1,27,0,5,1,29,30
2014,1,27,0,6,0,126,126
2014,1,27,0,7,4,336,340
2014,1,27,0,8,3,714,717
2014,1,27,0,9,8,381,389
2014,1,27,0,10,12,132,144
2014,1,27,0,11,3,129,132
2014,1,27,0,12,6,188,194
2014,1,27,0,13,4,164,168
2014,1,27,0,14,5,159,164
2014,1,27,0,15,3,164,167
2014,1,27,0,16,2,252,254
2014,1,27,0,17,8,517,525
2014,1,27,0,18,6,427,433
2014,1,27,0,19,2,272,274
2014,1,27,0,20,1,213,214
2014,1,27,0,21,0,117,117
2014,1,27,0,22,1,73,74
2014,1,27,0,23,0,41,41
2014,1,28,1,0,0,12,12
2014,1,28,1,1,0,9,9
2014,1,28,1,2,0,1,1
2014,1,28,1,4,0,5,5
2014,1,28,1,5,0,27,27
2014,1,28,1,6,1,91,92
2014,1,28,1,7,1,226,227
2014,1,28,1,8,2,497,499
2014,1,28,1,9,4,229,233
2014,1,28,1,10,5,83,88
2014,1,28,1,11,4,72,76
2014,1,28,1,12,0,110,110
2014,1,28,1,13,2,105,107
2014,1,28,1,14,5,92,97
2014,1,28,1,15,2,115,117
2014,1,28,1,16,3,176,179
2014,1,28,1,17,4,364,368
2014,1,28,1,18,2,348,350
2014,1,28,1,19,1,215,216
2014,1,28,1,20,2,156,158
2014,1,28,1,21,0,102,102
2014,1,28,1,22,1,54,55
2014,1,28,1,23,0,32,32
2014,1,29,2,0,0,15,15
2014,1,29,2,1,0,2,2
2014,1,29,2,4,0,2,2
2014,1,29,2,5,0,18,18
2014,1,29,2,6,0,59,59
2014,1,29,2,7,0,145,145
2014,1,29,2,8,5,370,375
2014,1,29,2,9,2,230,232
2014,1,29,2,10,2,98,100
2014,1,29,2,11,2,93,95
2014,1,29,2,12,3,102,105
2014,1,29,2,13,5,102,107
2014,1,29,2,14,6,93,99
2014,1,29,2,15,8,119,127
2014,1,29,2,16,6,188,194
2014,1,29,2,17,3,400,403
2014,1,29,2,18,5,401,406
2014,1,29,2,19,5,243,248
2014,1,29,2,20,3,173,176
2014,1,29,2,21,2,120,122
2014,1,29,2,22,1,105,106
2014,1,29,2,23,0,49,49
2014,1,30,3,0,1,21,22
2014,1,30,3,1,0,13,13
2014,1,30,3,2,0,4,4
2014,1,30,3,4,0,3,3
2014,1,30,3,5,0,30,30
2014,1,30,3,6,0,105,105
2014,1,30,3,7,2,254,256
2014,1,30,3,8,2,587,589
2014,1,30,3,9,2,285,287
2014,1,30,3,10,2,127,129
2014,1,30,3,11,4,128,132
2014,1,30,3,12,7,151,158
2014,1,30,3,13,5,127,132
2014,1,30,3,14,7,134,141
2014,1,30,3,15,7,172,179
2014,1,30,3,16,7,241,248
2014,1,30,3,17,9,497,506
2014,1,30,3,18,4,468,472
2014,1,30,3,19,3,293,296
2014,1,30,3,20,3,177,180
2014,1,30,3,21,3,161,164
2014,1,30,3,22,0,105,105
2014,1,30,3,23,0,58,58
2014,1,31,4,0,0,28,28
2014,1,31,4,1,1,13,14
2014,1,31,4,2,1,4,5
2014,1,31,4,3,0,10,10
2014,1,31,4,4,0,1,1
2014,1,31,4,5,0,30,30
2014,1,31,4,6,1,115,116
2014,1,31,4,7,2,321,323
2014,1,31,4,8,3,665,668
2014,1,31,4,9,2,330,332
2014,1,31,4,10,9,141,150
2014,1,31,4,11,19,177,196
2014,1,31,4,12,24,232,256
2014,1,31,4,13,19,233,252
2014,1,31,4,14,41,212,253
2014,1,31,4,15,31,248,279
2014,1,31,4,16,29,333,362
2014,1,31,4,17,25,647,672
2014,1,31,4,18,5,494,499
2014,1,31,4,19,12,351,363
2014,1,31,4,20,4,246,250
2014,1,31,4,21,4,148,152
2014,1,31,4,22,4,169,173
2014,1,31,4,23,3,92,95
2014,2,1,5,0,0,84,84
2014,2,1,5,1,4,61,65
2014,2,1,5,2,4,47,51
2014,2,1,5,3,4,16,20
2014,2,1,5,4,0,5,5
2014,2,1,5,5,0,4,4
2014,2,1,5,6,1,12,13
2014,2,1,5,7,0,40,40
2014,2,1,5,8,0,125,125
2014,2,1,5,9,10,210,220
2014,2,1,5,10,36,261,297
2014,2,1,5,11,60,311,371
2014,2,1,5,12,71,377,448
2014,2,1,5,13,88,397,485
2014,2,1,5,14,91,430,521
2014,2,1,5,15,115,463,578
2014,2,1,5,16,106,413,519
2014,2,1,5,17,83,338,421
2014,2,1,5,18,46,266,312
2014,2,1,5,19,12,227,239
2014,2,1,5,20,7,157,164
2014,2,1,5,21,14,173,187
2014,2,1,5,22,10,133,143
2014,2,1,5,23,5,92,97
2014,2,2,6,0,6,93,99
2014,2,2,6,1,6,74,80
2014,2,2,6,2,1,66,67
2014,2,2,6,3,1,12,13
2014,2,2,6,4,3,4,7
2014,2,2,6,5,1,5,6
2014,2,2,6,6,2,13,15
2014,2,2,6,7,3,35,38
2014,2,2,6,8,12,99,111
2014,2,2,6,9,15,182,197
2014,2,2,6,10,57,243,300
2014,2,2,6,11,53,355,408
2014,2,2,6,12,87,416,503
2014,2,2,6,13,102,382,484
2014,2,2,6,14,127,377,504
2014,2,2,6,15,127,430,557
2014,2,2,6,16,92,415,507
2014,2,2,6,17,64,450,514
2014,2,2,6,18,29,288,317
2014,2,2,6,19,11,119,130
2014,2,2,6,20,6,101,107
2014,2,2,6,21,9,120,129
2014,2,2,6,22,12,246,258
2014,2,2,6,23,10,110,120
2014,2,3,0,0,1,10,11
2014,2,3,0,1,0,7,7
2014,2,3,0,2,0,3,3
2014,2,3,0,3,0,1,1
2014,2,3,0,5,0,8,8
2014,2,3,0,6,0,23,23
2014,2,3,0,7,0,58,58
2014,2,3,0,8,1,87,88
2014,2,3,0,9,0,64,64
2014,2,3,0,10,1,28,29
2014,2,3,0,11,1,32,33
2014,2,3,0,12,0,44,44
2014,2,3,0,13,0,39,39
2014,2,3,0,14,2,59,61
2014,2,3,0,15,2,112,114
2014,2,3,0,16,9,191,200
2014,2,3,0,17,12,442,454
2014,2,3,0,18,9,403,412
2014,2,3,0,19,9,302,311
2014,2,3,0,20,7,218,225
2014,2,3,0,21,2,172,174
2014,2,3,0,22,1,87,88
2014,2,3,0,23,4,42,46
2014,2,4,1,0,0,14,14
2014,2,4,1,1,0,11,11
2014,2,4,1,2,0,6,6
2014,2,4,1,4,0,1,1
2014,2,4,1,5,0,30,30
2014,2,4,1,6,1,147,148
2014,2,4,1,7,5,381,386
2014,2,4,1,8,7,782,789
2014,2,4,1,9,8,330,338
2014,2,4,1,10,9,161,170
2014,2,4,1,11,12,154,166
2014,2,4,1,12,10,213,223
2014,2,4,1,13,6,193,199
2014,2,4,1,14,9,126,135
2014,2,4,1,15,5,191,196
2014,2,4,1,16,11,282,293
2014,2,4,1,17,14,620,634
2014,2,4,1,18,14,559,573
2014,2,4,1,19,6,373,379
2014,2,4,1,20,7,256,263
2014,2,4,1,21,4,160,164
2014,2,4,1,22,1,76,77
2014,2,4,1,23,1,30,31
2014,2,5,2,0,0,13,13
2014,2,5,2,1,0,4,4
2014,2,5,2,4,0,3,3
2014,2,5,2,5,0,17,17
2014,2,5,2,6,0,58,58
2014,2,5,2,7,0,118,118
2014,2,5,2,8,2,203,205
2014,2,5,2,9,6,183,189
2014,2,5,2,10,1,81,82
2014,2,5,2,11,7,89,96
2014,2,5,2,12,5,120,125
2014,2,5,2,13,11,124,135
2014,2,5,2,14,9,143,152
2014,2,5,2,15,12,139,151
2014,2,5,2,16,9,261,270
2014,2,5,2,17,18,604,622
2014,2,5,2,18,15,536,551
2014,2,5,2,19,13,388,401
2014,2,5,2,20,6,244,250
2014,2,5,2,21,1,177,178
2014,2,5,2,22,1,116,117
2014,2,5,2,23,0,63,63
2014,2,6,3,0,0,22,22
2014,2,6,3,1,0,19,19
2014,2,6,3,2,0,3,3
2014,2,6,3,4,0,4,4
2014,2,6,3,5,1,24,25
2014,2,6,3,6,1,126,127
2014,2,6,3,7,0,341,341
2014,2,6,3,8,8,743,751
2014,2,6,3,9,14,321,335
2014,2,6,3,10,10,133,143
2014,2,6,3,11,11,153,164
2014,2,6,3,12,10,176,186
2014,2,6,3,13,10,190,200
2014,2,6,3,14,20,135,155
2014,2,6,3,15,15,189,204
2014,2,6,3,16,5,265,270
2014,2,6,3,17,10,583,593
2014,2,6,3,18,9,560,569
2014,2,6,3,19,7,402,409
2014,2,6,3,20,7,275,282
2014,2,6,3,21,8,209,217
2014,2,6,3,22,4,134,138
2014,2,6,3,23,0,86,86
2014,2,7,4,0,2,33,35
2014,2,7,4,1,0,17,17
2014,2,7,4,2,0,8,8
2014,2,7,4,3,0,3,3
2014,2,7,4,4,0,3,3
2014,2,7,4,5,0,40,40
2014,2,7,4,6,0,117,117
2014,2,7,4,7,0,335,335
2014,2,7,4,8,6,680,686
2014,2,7,4,9,10,367,377
2014,2,7,4,10,11,149,160
2014,2,7,4,11,26,165,191
2014,2,7,4,12,19,204,223
2014,2,7,4,13,13,210,223
2014,2,7,4,14,22,214,236
2014,2,7,4,15,29,276,305
2014,2,7,4,16,8,335,343
2014,2,7,4,17,21,614,635
2014,2,7,4,18,11,526,537
2014,2,7,4,19,15,356,371
2014,2,7,4,20,8,192,200
2014,2,7,4,21,1,143,144
2014,2,7,4,22,10,124,134
2014,2,7,4,23,8,116,124
2014,2,8,5,0,0,76,76
2014,2,8,5,1,2,61,63
2014,2,8,5,2,1,39,40
2014,2,8,5,3,0,17,17
2014,2,8,5,4,1,6,7
2014,2,8,5,5,0,10,10
2014,2,8,5,6,0,12,12
2014,2,8,5,7,1,47,48
2014,2,8,5,8,7,115,122
2014,2,8,5,9,19,170,189
2014,2,8,5,10,25,229,254
2014,2,8,5,11,38,307,345
2014,2,8,5,12,36,311,347
2014,2,8,5,13,63,314,377
2014,2,8,5,14,45,272,317
2014,2,8,5,15,37,310,347
2014,2,8,5,16,45,269,314
2014,2,8,5,17,33,292,325
2014,2,8,5,18,16,219,235
2014,2,8,5,19,9,182,191
2014,2,8,5,20,6,140,146
2014,2,8,5,21,2,117,119
2014,2,8,5,22,3,96,99
2014,2,8,5,23,1,78,79
2014,2,9,6,0,3,71,74
2014,2,9,6,1,4,61,65
2014,2,9,6,2,5,66,71
2014,2,9,6,3,2,13,15
2014,2,9,6,4,1,6,7
2014,2,9,6,5,0,1,1
2014,2,9,6,6,0,11,11
2014,2,9,6,7,1,31,32
2014,2,9,6,8,3,66,69
2014,2,9,6,9,9,117,126
2014,2,9,6,10,20,183,203
2014,2,9,6,11,30,258,288
2014,2,9,6,12,34,313,347
2014,2,9,6,13,16,321,337
2014,2,9,6,14,18,293,311
2014,2,9,6,15,15,276,291
2014,2,9,6,16,5,173,178
2014,2,9,6,17,10,150,160
2014,2,9,6,18,8,134,142
2014,2,9,6,19,8,118,126
2014,2,9,6,20,15,101,116
2014,2,9,6,21,5,71,76
2014,2,9,6,22,0,70,70
2014,2,9,6,23,0,30,30
2014,2,10,0,0,1,20,21
2014,2,10,0,1,0,3,3
2014,2,10,0,2,0,5,5
2014,2,10,0,3,0,4,4
2014,2,10,0,4,0,4,4
2014,2,10,0,5,0,44,44
2014,2,10,0,6,0,131,131
2014,2,10,0,7,1,304,305
2014,2,10,0,8,7,643,650
2014,2,10,0,9,6,317,323
2014,2,10,0,10,8,119,127
2014,2,10,0,11,13,127,140
2014,2,10,0,12,14,170,184
2014,2,10,0,13,9,153,162
2014,2,10,0,14,10,120,130
2014,2,10,0,15,9,156,165
2014,2,10,0,16,16,253,269
2014,2,10,0,17,14,521,535
2014,2,10,0,18,7,486,493
2014,2,10,0,19,3,278,281
2014,2,10,0,20,3,220,223
2014,2,10,0,21,5,149,154
2014,2,10,0,22,1,79,80
2014,2,10,0,23,0,49,49
2014,2,11,1,0,0,15,15
2014,2,11,1,1,0,10,10
2014,2,11,1,2,1,4,5
2014,2,11,1,3,0,1,1
2014,2,11,1,4,0,2,2
2014,2,11,1,5,0,33,33
2014,2,11,1,6,0,126,126
2014,2,11,1,7,3,348,351
2014,2,11,1,8,9,649,658
2014,2,11,1,9,6,315,321
2014,2,11,1,10,10,121,131
2014,2,11,1,11,27,143,170
2014,2,11,1,12,9,153,162
2014,2,11,1,13,16,163,179
2014,2,11,1,14,13,116,129
2014,2,11,1,15,9,164,173
2014,2,11,1,16,10,277,287
2014,2,11,1,17,31,535,566
2014,2,11,1,18,11,562,573
2014,2,11,1,19,9,351,360
2014,2,11,1,20,10,195,205
2014,2,11,1,21,4,172,176
2014,2,11,1,22,2,101,103
2014,2,11,1,23,1,46,47
2014,2,12,2,0,0,14,14
2014,2,12,2,1,0,5,5
2014,2,12,2,2,0,3,3
2014,2,12,2,3,0,1,1
2014,2,12,2,4,0,5,5
2014,2,12,2,5,0,29,29
2014,2,12,2,6,0,116,116
2014,2,12,2,7,1,310,311
2014,2,12,2,8,10,579,589
2014,2,12,2,9,3,314,317
2014,2,12,2,10,2,127,129
2014,2,12,2,11,7,131,138
2014,2,12,2,12,8,158,166
2014,2,12,2,13,4,135,139
2014,2,12,2,14,7,138,145
2014,2,12,2,15,8,151,159
2014,2,12,2,16,9,242,251
2014,2,12,2,17,9,473,482
2014,2,12,2,18,6,448,454
2014,2,12,2,19,1,306,307
2014,2,12,2,20,4,112,116
2014,2,12,2,21,0,60,60
2014,2,12,2,22,2,26,28
2014,2,12,2,23,4,19,23
2014,2,13,3,0,2,23,25
2014,2,13,3,1,1,15,16
2014,2,13,3,2,0,7,7
2014,2,13,3,3,1,2,3
2014,2,13,3,5,0,3,3
2014,2,13,3,6,0,2,2
2014,2,14,4,10,0,3,3
2014,2,14,4,11,5,97,102
2014,2,14,4,12,1,103,104
2014,2,14,4,13,6,122,128
2014,2,14,4,14,11,124,135
2014,2,14,4,15,12,172,184
2014,2,14,4,16,12,209,221
2014,2,14,4,17,14,326,340
2014,2,14,4,18,5,271,276
2014,2,14,4,19,2,161,163
2014,2,14,4,20,1,97,98
2014,2,14,4,21,3,67,70
2014,2,14,4,22,1,72,73
2014,2,14,4,23,0,52,52
2014,2,15,5,0,0,41,41
2014,2,15,5,1,2,29,31
2014,2,15,5,2,0,30,30
2014,2,15,5,3,1,14,15
2014,2,15,5,4,0,11,11
2014,2,15,5,5,1,7,8
2014,2,15,5,6,0,10,10
2014,2,15,5,7,1,27,28
2014,2,15,5,8,1,42,43
2014,2,15,5,9,2,47,49
2014,2,15,5,10,2,76,78
2014,2,15,5,11,10,92,102
2014,2,15,5,12,16,107,123
2014,2,15,5,13,14,116,130
2014,2,15,5,14,16,136,152
2014,2,15,5,15,27,129,156
2014,2,15,5,16,13,136,149
2014,2,15,5,17,17,160,177
2014,2,15,5,18,8,138,146
2014,2,15,5,19,5,93,98
2014,2,15,5,20,0,58,58
2014,2,15,5,21,2,59,61
2014,2,15,5,22,1,37,38
2014,2,15,5,23,0,47,47
2014,2,16,6,0,0,42,42
2014,2,16,6,1,0,44,44
2014,2,16,6,2,1,31,32
2014,2,16,6,3,0,14,14
2014,2,16,6,4,0,6,6
2014,2,16,6,5,1,6,7
2014,2,16,6,6,0,8,8
2014,2,16,6,7,3,24,27
2014,2,16,6,8,4,45,49
2014,2,16,6,9,16,87,103
2014,2,16,6,10,24,148,172
2014,2,16,6,11,17,187,204
2014,2,16,6,12,64,234,298
2014,2,16,6,13,40,210,250
2014,2,16,6,14,39,198,237
2014,2,16,6,15,40,205,245
2014,2,16,6,16,51,233,284
2014,2,16,6,17,30,200,230
2014,2,16,6,18,14,178,192
2014,2,16,6,19,16,113,129
2014,2,16,6,20,9,104,113
2014,2,16,6,21,9,72,81
2014,2,16,6,22,5,54,59
2014,2,16,6,23,1,49,50
2014,2,17,0,0,0,23,23
2014,2,17,0,1,0,24,24
2014,2,17,0,2,1,9,10
2014,2,17,0,3,0,10,10
2014,2,17,0,4,0,2,2
2014,2,17,0,5,1,8,9
2014,2,17,0,6,0,32,32
2014,2,17,0,7,2,63,65
2014,2,17,0,8,8,163,171
2014,2,17,0,9,27,151,178
2014,2,17,0,10,25,148,173
2014,2,17,0,11,31,200,231
2014,2,17,0,12,44,221,265
2014,2,17,0,13,28,248,276
2014,2,17,0,14,26,230,256
2014,2,17,0,15,31,250,281
2014,2,17,0,16,28,244,272
2014,2,17,0,17,41,253,294
2014,2,17,0,18,16,272,288
2014,2,17,0,19,6,166,172
2014,2,17,0,20,7,118,125
2014,2,17,0,21,2,88,90
2014,2,17,0,22,2,53,55
2014,2,17,0,23,4,43,47
2014,2,18,1,0,0,19,19
2014,2,18,1,1,0,4,4
2014,2,18,1,2,0,1,1
2014,2,18,1,3,0,1,1
2014,2,18,1,4,0,1,1
2014,2,18,1,5,1,24,25
2014,2,18,1,6,0,86,86
2014,2,18,1,7,3,219,222
2014,2,18,1,8,5,521,526
2014,2,18,1,9,13,255,268
2014,2,18,1,10,12,128,140
2014,2,18,1,11,16,147,163
2014,2,18,1,12,23,180,203
2014,2,18,1,13,14,212,226
2014,2,18,1,14,27,188,215
2014,2,18,1,15,23,214,237
2014,2,18,1,16,33,337,370
2014,2,18,1,17,48,681,729
2014,2,18,1,18,22,626,648
2014,2,18,1,19,4,389,393
2014,2,18,1,20,10,272,282
2014,2,18,1,21,8,203,211
2014,2,18,1,22,6,118,124
2014,2,18,1,23,1,59,60
2014,2,19,2,0,0,23,23
2014,2,19,2,1,0,17,17
2014,2,19,2,2,0,4,4
2014,2,19,2,3,0,1,1
2014,2,19,2,4,0,4,4
2014,2,19,2,5,1,32,33
2014,2,19,2,6,2,145,147
2014,2,19,2,7,3,378,381
2014,2,19,2,8,9,665,674
2014,2,19,2,9,5,110,115
2014,2,19,2,10,6,57,63
2014,2,19,2,11,11,119,130
2014,2,19,2,12,17,221,238
2014,2,19,2,13,25,192,217
2014,2,19,2,14,17,228,245
2014,2,19,2,15,21,229,250
2014,2,19,2,16,30,336,366
2014,2,19,2,17,28,775,803
2014,2,19,2,18,24,635,659
2014,2,19,2,19,12,457,469
2014,2,19,2,20,8,355,363
2014,2,19,2,21,12,228,240
2014,2,19,2,22,9,150,159
2014,2,19,2,23,4,77,81
2014,2,20,3,0,1,34,35
2014,2,20,3,1,0,13,13
2014,2,20,3,2,0,7,7
2014,2,20,3,3,0,1,1
2014,2,20,3,4,0,1,1
2014,2,20,3,5,0,53,53
2014,2,20,3,6,1,150,151
2014,2,20,3,7,4,436,440
2014,2,20,3,8,12,834,846
2014,2,20,3,9,19,366,385
2014,2,20,3,10,34,159,193
2014,2,20,3,11,37,187,224
2014,2,20,3,12,30,214,244
2014,2,20,3,13,22,203,225
2014,2,20,3,14,37,173,210
2014,2,20,3,15,52,246,298
2014,2,20,3,16,44,348,392
2014,2,20,3,17,45,776,821
2014,2,20,3,18,22,675,697
2014,2,20,3,19,19,463,482
2014,2,20,3,20,11,330,341
2014,2,20,3,21,7,249,256
2014,2,20,3,22,6,180,186
2014,2,20,3,23,26,104,130
2014,2,21,4,0,5,42,47
2014,2,21,4,1,0,18,18
2014,2,21,4,2,1,11,12
2014,2,21,4,3,1,4,5
2014,2,21,4,4,0,8,8
2014,2,21,4,5,0,49,49
2014,2,21,4,6,10,134,144
2014,2,21,4,7,4,417,421
2014,2,21,4,8,18,843,861
2014,2,21,4,9,22,388,410
2014,2,21,4,10,25,171,196
2014,2,21,4,11,24,183,207
2014,2,21,4,12,18,130,148
2014,2,21,4,13,16,82,98
2014,2,21,4,14,11,115,126
2014,2,21,4,15,20,190,210
2014,2,21,4,16,28,314,342
2014,2,21,4,17,43,712,755
2014,2,21,4,18,32,554,586
2014,2,21,4,19,15,408,423
2014,2,21,4,20,20,243,263
2014,2,21,4,21,15,197,212
2014,2,21,4,22,6,149,155
2014,2,21,4,23,12,136,148
2014,2,22,5,0,7,78,85
2014,2,22,5,1,5,73,78
2014,2,22,5,2,3,54,57
2014,2,22,5,3,3,20,23
2014,2,22,5,4,0,5,5
2014,2,22,5,5,3,8,11
2014,2,22,5,6,2,17,19
2014,2,22,5,7,9,57,66
2014,2,22,5,8,22,162,184
2014,2,22,5,9,35,229,264
2014,2,22,5,10,95,301,396
2014,2,22,5,11,138,406,544
2014,2,22,5,12,280,526,806
2014,2,22,5,13,297,540,837
2014,2,22,5,14,414,576,990
2014,2,22,5,15,279,587,866
2014,2,22,5,16,142,535,677
2014,2,22,5,17,105,453,558
2014,2,22,5,18,48,409,457
2014,2,22,5,19,23,272,295
2014,2,22,5,20,18,220,238
2014,2,22,5,21,12,153,165
2014,2,22,5,22,6,137,143
2014,2,22,5,23,8,124,132
2014,2,23,6,0,5,131,136
2014,2,23,6,1,0,77,77
2014,2,23,6,2,1,82,83
2014,2,23,6,3,4,34,38
2014,2,23,6,4,1,6,7
2014,2,23,6,5,0,10,10
2014,2,23,6,6,1,9,10
2014,2,23,6,7,3,58,61
2014,2,23,6,8,10,117,127
2014,2,23,6,9,21,179,200
2014,2,23,6,10,29,300,329
2014,2,23,6,11,27,332,359
2014,2,23,6,12,40,430,470
2014,2,23,6,13,17,510,527
2014,2,23,6,14,85,548,633
2014,2,23,6,15,173,536,709
2014,2,23,6,16,192,531,723
2014,2,23,6,17,116,443,559
2014,2,23,6,18,58,336,394
2014,2,23,6,19,27,237,264
2014,2,23,6,20,12,152,164
2014,2,23,6,21,11,121,132
2014,2,23,6,22,4,74,78
2014,2,23,6,23,4,58,62
2014,2,24,0,0,1,22,23
2014,2,24,0,1,1,7,8
2014,2,24,0,2,0,4,4
2014,2,24,0,3,1,4,5
2014,2,24,0,4,0,3,3
2014,2,24,0,5,0,39,39
2014,2,24,0,6,7,148,155
2014,2,24,0,7,6,414,420
2014,2,24,0,8,4,745,749
2014,2,24,0,9,10,320,330
2014,2,24,0,10,21,153,174
2014,2,24,0,11,25,150,175
2014,2,24,0,12,33,171,204
2014,2,24,0,13,18,185,203
2014,2,24,0,14,37,130,167
2014,2,24,0,15,25,189,214
2014,2,24,0,16,32,329,361
2014,2,24,0,17,27,624,651
2014,2,24,0,18,11,563,574
2014,2,24,0,19,13,362,375
2014,2,24,0,20,6,257,263
2014,2,24,0,21,10,161,171
2014,2,24,0,22,5,118,123
2014,2,24,0,23,2,66,68
2014,2,25,1,0,1,16,17
2014,2,25,1,1,0,6,6
2014,2,25,1,2,1,4,5
2014,2,25,1,3,0,2,2
2014,2,25,1,4,0,5,5
2014,2,25,1,5,0,34,34
2014,2,25,1,6,2,169,171
2014,2,25,1,7,6,396,402
2014,2,25,1,8,15,702,717
2014,2,25,1,9,6,215,221
2014,2,25,1,10,0,57,57
2014,2,25,1,11,6,40,46
2014,2,25,1,12,5,57,62
2014,2,25,1,13,13,91,104
2014,2,25,1,14,10,91,101
2014,2,25,1,15,11,174,185
2014,2,25,1,16,19,257,276
2014,2,25,1,17,21,582,603
2014,2,25,1,18,19,541,560
2014,2,25,1,19,9,394,403
2014,2,25,1,20,2,245,247
2014,2,25,1,21,6,208,214
2014,2,25,1,22,4,104,108
2014,2,25,1,23,1,48,49
2014,2,26,2,0,1,23,24
2014,2,26,2,1,0,6,6
2014,2,26,2,2,0,3,3
2014,2,26,2,3,1,2,3
2014,2,26,2,4,0,8,8
2014,2,26,2,5,0,42,42
2014,2,26,2,6,1,90,91
2014,2,26,2,7,4,167,171
2014,2,26,2,8,1,272,273
2014,2,26,2,9,2,150,152
2014,2,26,2,10,2,73,75
2014,2,26,2,11,4,97,101
2014,2,26,2,12,10,144,154
2014,2,26,2,13,14,158,172
2014,2,26,2,14,6,150,156
2014,2,26,2,15,17,156,173
2014,2,26,2,16,9,282,291
2014,2,26,2,17,15,580,595
2014,2,26,2,18,7,522,529
2014,2,26,2,19,3,369,372
2014,2,26,2,20,2,231,233
2014,2,26,2,21,0,164,164
2014,2,26,2,22,3,112,115
2014,2,26,2,23,0,55,55
2014,2,27,3,0,1,28,29
2014,2,27,3,1,0,7,7
2014,2,27,3,2,0,4,4
2014,2,27,3,3,0,3,3
2014,2,27,3,4,0,5,5
2014,2,27,3,5,0,31,31
2014,2,27,3,6,2,115,117
2014,2,27,3,7,5,358,363
2014,2,27,3,8,6,703,709
2014,2,27,3,9,4,349,353
2014,2,27,3,10,6,164,170
2014,2,27,3,11,17,166,183
2014,2,27,3,12,10,184,194
2014,2,27,3,13,18,174,192
2014,2,27,3,14,14,166,180
2014,2,27,3,15,10,197,207
2014,2,27,3,16,6,275,281
2014,2,27,3,17,27,544,571
2014,2,27,3,18,15,475,490
2014,2,27,3,19,8,327,335
2014,2,27,3,20,7,228,235
2014,2,27,3,21,3,145,148
2014,2,27,3,22,0,88,88
2014,2,27,3,23,0,45,45
2014,2,28,4,0,0,17,17
2014,2,28,4,1,1,14,15
2014,2,28,4,2,0,6,6
2014,2,28,4,3,0,2,2
2014,2,28,4,4,0,3,3
2014,2,28,4,5,1,27,28
2014,2,28,4,6,2,84,86
2014,2,28,4,7,2,244,246
2014,2,28,4,8,14,527,541
2014,2,28,4,9,9,296,305
2014,2,28,4,10,6,145,151
2014,2,28,4,11,21,141,162
2014,2,28,4,12,10,171,181
2014,2,28,4,13,16,187,203
2014,2,28,4,14,17,154,171
2014,2,28,4,15,19,166,185
2014,2,28,4,16,28,266,294
2014,2,28,4,17,11,497,508
2014,2,28,4,18,4,382,386
2014,2,28,4,19,6,245,251
2014,2,28,4,20,1,149,150
2014,2,28,4,21,1,96,97
2014,2,28,4,22,2,90,92
2014,2,28,4,23,2,61,63
2014,3,1,5,0,2,59,61
2014,3,1,5,1,0,45,45
2014,3,1,5,2,0,26,26
2014,3,1,5,3,1,7,8
2014,3,1,5,4,0,4,4
2014,3,1,5,5,0,2,2
2014,3,1,5,6,0,19,19
2014,3,1,5,7,2,44,46
2014,3,1,5,8,5,100,105
2014,3,1,5,9,28,162,190
2014,3,1,5,10,45,214,259
2014,3,1,5,11,49,281,330
2014,3,1,5,12,69,291,360
2014,3,1,5,13,60,304,364
2014,3,1,5,14,107,299,406
2014,3,1,5,15,105,308,413
2014,3,1,5,16,106,323,429
2014,3,1,5,17,100,292,392
2014,3,1,5,18,64,268,332
2014,3,1,5,19,31,220,251
2014,3,1,5,20,16,176,192
2014,3,1,5,21,9,136,145
2014,3,1,5,22,3,105,108
2014,3,1,5,23,6,111,117
2014,3,2,6,0,3,95,98
2014,3,2,6,1,0,72,72
2014,3,2,6,2,6,48,54
2014,3,2,6,3,8,29,37
2014,3,2,6,4,0,12,12
2014,3,2,6,5,0,7,7
2014,3,2,6,6,2,9,11
2014,3,2,6,7,3,25,28
2014,3,2,6,8,18,75,93
2014,3,2,6,9,25,162,187
2014,3,2,6,10,54,270,324
2014,3,2,6,11,59,374,433
2014,3,2,6,12,99,429,528
2014,3,2,6,13,92,371,463
2014,3,2,6,14,91,359,450
2014,3,2,6,15,32,133,165
2014,3,2,6,16,13,90,103
2014,3,2,6,17,21,100,121
2014,3,2,6,18,3,92,95
2014,3,2,6,19,5,76,81
2014,3,2,6,20,4,75,79
2014,3,2,6,21,2,40,42
2014,3,2,6,22,0,38,38
2014,3,2,6,23,0,10,10
2014,3,3,0,0,0,17,17
2014,3,3,0,1,0,8,8
2014,3,3,0,2,0,5,5
2014,3,3,0,4,0,2,2
2014,3,3,0,5,0,8,8
2014,3,3,0,6,0,5,5
2014,3,3,0,7,3,10,13
2014,3,3,0,8,1,10,11
2014,3,3,0,9,1,10,11
2014,3,3,0,10,0,12,12
2014,3,3,0,11,1,15,16
2014,3,3,0,12,0,11,11
2014,3,3,0,13,0,11,11
2014,3,3,0,14,0,21,21
2014,3,3,0,15,0,34,34
2014,3,3,0,16,3,35,38
2014,3,3,0,17,0,47,47
2014,3,3,0,18,1,45,46
2014,3,3,0,19,0,44,44
2014,3,3,0,20,2,18,20
2014,3,3,0,21,1,19,20
2014,3,3,0,22,2,15,17
2014,3,3,0,23,1,11,12
2014,3,4,1,0,2,8,10
2014,3,4,1,1,0,2,2
2014,3,4,1,2,0,1,1
2014,3,4,1,3,0,1,1
2014,3,4,1,4,1,2,3
2014,3,4,1,5,0,17,17
2014,3,4,1,6,1,31,32
2014,3,4,1,7,3,56,59
2014,3,4,1,8,1,149,150
2014,3,4,1,9,5,118,123
2014,3,4,1,10,3,116,119
2014,3,4,1,11,1,58,59
2014,3,4,1,12,4,81,85
2014,3,4,1,13,0,93,93
2014,3,4,1,14,4,66,70
2014,3,4,1,15,6,93,99
2014,3,4,1,16,2,145,147
2014,3,4,1,17,3,277,280
2014,3,4,1,18,9,279,288
2014,3,4,1,19,4,231,235
2014,3,4,1,20,7,158,165
2014,3,4,1,21,2,126,128
2014,3,4,1,22,5,75,80
2014,3,4,1,23,0,33,33
2014,3,5,2,0,0,15,15
2014,3,5,2,1,0,4,4
2014,3,5,2,2,0,2,2
2014,3,5,2,3,0,3,3
2014,3,5,2,4,0,5,5
2014,3,5,2,5,0,26,26
2014,3,5,2,6,1,95,96
2014,3,5,2,7,5,254,259
2014,3,5,2,8,10,512,522
2014,3,5,2,9,7,261,268
2014,3,5,2,10,14,103,117
2014,3,5,2,11,11,129,140
2014,3,5,2,12,16,152,168
2014,3,5,2,13,17,169,186
2014,3,5,2,14,16,137,153
2014,3,5,2,15,29,165,194
2014,3,5,2,16,35,290,325
2014,3,5,2,17,29,550,579
2014,3,5,2,18,6,516,522
2014,3,5,2,19,18,334,352
2014,3,5,2,20,11,259,270
2014,3,5,2,21,6,169,175
2014,3,5,2,22,0,113,113
2014,3,5,2,23,6,54,60
2014,3,6,3,0,6,25,31
2014,3,6,3,1,6,6,12
2014,3,6,3,2,0,1,1
2014,3,6,3,4,0,2,2
2014,3,6,3,5,0,31,31
2014,3,6,3,6,1,111,112
2014,3,6,3,7,6,326,332
2014,3,6,3,8,12,679,691
2014,3,6,3,9,4,312,316
2014,3,6,3,10,16,121,137
2014,3,6,3,11,22,129,151
2014,3,6,3,12,28,185,213
2014,3,6,3,13,18,157,175
2014,3,6,3,14,21,118,139
2014,3,6,3,15,19,182,201
2014,3,6,3,16,10,240,250
2014,3,6,3,17,24,601,625
2014,3,6,3,18,18,564,582
2014,3,6,3,19,3,292,295
2014,3,6,3,20,5,238,243
2014,3,6,3,21,2,171,173
2014,3,6,3,22,14,75,89
2014,3,6,3,23,5,69,74
2014,3,7,4,0,0,34,34
2014,3,7,4,1,0,16,16
2014,3,7,4,2,11,7,18
2014,3,7,4,3,1,2,3
2014,3,7,4,4,0,7,7
2014,3,7,4,5,0,34,34
2014,3,7,4,6,0,105,105
2014,3,7,4,7,5,313,318
2014,3,7,4,8,6,634,640
2014,3,7,4,9,5,304,309
2014,3,7,4,10,12,150,162
2014,3,7,4,11,21,163,184
2014,3,7,4,12,19,208,227
2014,3,7,4,13,17,220,237
2014,3,7,4,14,21,212,233
2014,3,7,4,15,29,232,261
2014,3,7,4,16,27,326,353
2014,3,7,4,17,21,556,577
2014,3,7,4,18,15,470,485
2014,3,7,4,19,9,305,314
2014,3,7,4,20,10,223,233
2014,3,7,4,21,12,143,155
2014,3,7,4,22,9,95,104
2014,3,7,4,23,6,99,105
2014,3,8,5,0,2,71,73
2014,3,8,5,1,2,52,54
2014,3,8,5,2,4,28,32
2014,3,8,5,3,2,18,20
2014,3,8,5,4,1,5,6
2014,3,8,5,5,0,6,6
2014,3,8,5,6,1,14,15
2014,3,8,5,7,1,49,50
2014,3,8,5,8,12,167,179
2014,3,8,5,9,38,238,276
2014,3,8,5,10,89,312,401
2014,3,8,5,11,175,409,584
2014,3,8,5,12,236,463,699
2014,3,8,5,13,335,468,803
2014,3,8,5,14,375,551,926
2014,3,8,5,15,407,560,967
2014,3,8,5,16,410,523,933
2014,3,8,5,17,301,456,757
2014,3,8,5,18,180,399,579
2014,3,8,5,19,84,267,351
2014,3,8,5,20,47,171,218
2014,3,8,5,21,41,174,215
2014,3,8,5,22,41,151,192
2014,3,8,5,23,27,131,158
2014,3,9,6,0,17,118,135
2014,3,9,6,1,4,77,81
2014,3,9,6,3,6,71,77
2014,3,9,6,4,6,35,41
2014,3,9,6,5,2,5,7
2014,3,9,6,6,0,9,9
2014,3,9,6,7,2,36,38
2014,3,9,6,8,15,87,102
2014,3,9,6,9,21,126,147
2014,3,9,6,10,101,250,351
2014,3,9,6,11,96,329,425
2014,3,9,6,12,130,392,522
2014,3,9,6,13,180,436,616
2014,3,9,6,14,163,386,549
2014,3,9,6,15,185,430,615
2014,3,9,6,16,195,402,597
2014,3,9,6,17,184,376,560
2014,3,9,6,18,89,317,406
2014,3,9,6,19,37,216,253
2014,3,9,6,20,22,141,163
2014,3,9,6,21,12,106,118
2014,3,9,6,22,13,85,98
2014,3,9,6,23,8,61,69
2014,3,10,0,0,6,24,30
2014,3,10,0,1,4,8,12
2014,3,10,0,2,0,6,6
2014,3,10,0,3,0,5,5
2014,3,10,0,4,0,11,11
2014,3,10,0,5,0,33,33
2014,3,10,0,6,3,144,147
2014,3,10,0,7,6,346,352
2014,3,10,0,8,23,753,776
2014,3,10,0,9,35,383,418
2014,3,10,0,10,36,135,171
2014,3,10,0,11,46,136,182
2014,3,10,0,12,48,187,235
2014,3,10,0,13,47,198,245
2014,3,10,0,14,58,165,223
2014,3,10,0,15,110,217,327
2014,3,10,0,16,98,388,486
2014,3,10,0,17,110,780,890
2014,3,10,0,18,76,803,879
2014,3,10,0,19,55,528,583
2014,3,10,0,20,19,300,319
2014,3,10,0,21,28,233,261
2014,3,10,0,22,17,128,145
2014,3,10,0,23,19,76,95
2014,3,11,1,0,6,28,34
2014,3,11,1,1,0,4,4
2014,3,11,1,2,0,6,6
2014,3,11,1,3,0,3,3
2014,3,11,1,4,0,10,10
2014,3,11,1,5,0,34,34
2014,3,11,1,6,1,180,181
2014,3,11,1,7,16,470,486
2014,3,11,1,8,21,947,968
2014,3,11,1,9,32,422,454
2014,3,11,1,10,30,158,188
2014,3,11,1,11,74,167,241
2014,3,11,1,12,85,223,308
2014,3,11,1,13,120,249,369
2014,3,11,1,14,109,161,270
2014,3,11,1,15,123,277,400
2014,3,11,1,16,149,401,550
2014,3,11,1,17,151,902,1053
2014,3,11,1,18,153,914,1067
2014,3,11,1,19,90,621,711
2014,3,11,1,20,61,380,441
2014,3,11,1,21,33,297,330
2014,3,11,1,22,35,183,218
2014,3,11,1,23,18,102,120
2014,3,12,2,0,2,34,36
2014,3,12,2,1,6,15,21
2014,3,12,2,2,2,11,13
2014,3,12,2,3,0,3,3
2014,3,12,2,4,0,8,8
2014,3,12,2,5,0,49,49
2014,3,12,2,6,4,189,193
2014,3,12,2,7,8,469,477
2014,3,12,2,8,19,942,961
2014,3,12,2,9,44,376,420
2014,3,12,2,10,53,146,199
2014,3,12,2,11,71,200,271
2014,3,12,2,12,51,245,296
2014,3,12,2,13,75,229,304
2014,3,12,2,14,60,163,223
2014,3,12,2,15,49,158,207
2014,3,12,2,16,97,365,462
2014,3,12,2,17,84,762,846
2014,3,12,2,18,30,447,477
2014,3,12,2,19,27,273,300
2014,3,12,2,20,6,206,212
2014,3,12,2,21,11,143,154
2014,3,12,2,22,0,106,106
2014,3,12,2,23,3,47,50
2014,3,13,3,0,1,10,11
2014,3,13,3,1,1,5,6
2014,3,13,3,2,1,2,3
2014,3,13,3,3,1,0,1
2014,3,13,3,4,0,2,2
2014,3,13,3,5,0,31,31
2014,3,13,3,6,0,84,84
2014,3,13,3,7,4,245,249
2014,3,13,3,8,10,525,535
2014,3,13,3,9,8,290,298
2014,3,13,3,10,15,88,103
2014,3,13,3,11,13,104,117
2014,3,13,3,12,14,120,134
2014,3,13,3,13,18,123,141
2014,3,13,3,14,16,134,150
2014,3,13,3,15,24,140,164
2014,3,13,3,16,15,205,220
2014,3,13,3,17,20,437,457
2014,3,13,3,18,23,475,498
2014,3,13,3,19,5,269,274
2014,3,13,3,20,7,196,203
2014,3,13,3,21,5,158,163
2014,3,13,3,22,8,103,111
2014,3,13,3,23,4,63,67
2014,3,14,4,0,1,31,32
2014,3,14,4,1,0,13,13
2014,3,14,4,2,0,7,7
2014,3,14,4,3,0,1,1
2014,3,14,4,4,0,4,4
2014,3,14,4,5,0,38,38
2014,3,14,4,6,1,103,104
2014,3,14,4,7,5,276,281
2014,3,14,4,8,14,709,723
2014,3,14,4,9,18,362,380
2014,3,14,4,10,25,155,180
2014,3,14,4,11,49,159,208
2014,3,14,4,12,69,229,298
2014,3,14,4,13,102,247,349
2014,3,14,4,14,145,216,361
2014,3,14,4,15,122,318,440
2014,3,14,4,16,144,408,552
2014,3,14,4,17,131,739,870
2014,3,14,4,18,83,697,780
2014,3,14,4,19,55,452,507
2014,3,14,4,20,54,258,312
2014,3,14,4,21,69,204,273
2014,3,14,4,22,23,165,188
2014,3,14,4,23,10,124,134
2014,3,15,5,0,12,113,125
2014,3,15,5,1,6,82,88
2014,3,15,5,2,2,40,42
2014,3,15,5,3,1,16,17
2014,3,15,5,4,4,14,18
2014,3,15,5,5,2,16,18
2014,3,15,5,6,13,116,129
2014,3,15,5,7,28,105,133
2014,3,15,5,8,77,193,270
2014,3,15,5,9,110,348,458
2014,3,15,5,10,160,411,571
2014,3,15,5,11,265,441,706
2014,3,15,5,12,326,532,858
2014,3,15,5,13,412,575,987
2014,3,15,5,14,382,572,954
2014,3,15,5,15,450,547,997
2014,3,15,5,16,432,546,978
2014,3,15,5,17,402,500,902
2014,3,15,5,18,296,451,747
2014,3,15,5,19,153,348,501
2014,3,15,5,20,88,222,310
2014,3,15,5,21,64,203,267
2014,3,15,5,22,36,165,201
2014,3,15,5,23,34,160,194
2014,3,16,6,0,20,106,126
2014,3,16,6,1,7,102,109
2014,3,16,6,2,11,70,81
2014,3,16,6,3,14,20,34
2014,3,16,6,4,0,4,4
2014,3,16,6,5,0,5,5
2014,3,16,6,6,2,8,10
2014,3,16,6,7,15,25,40
2014,3,16,6,8,21,74,95
2014,3,16,6,9,52,195,247
2014,3,16,6,10,103,262,365
2014,3,16,6,11,128,345,473
2014,3,16,6,12,184,362,546
2014,3,16,6,13,188,394,582
2014,3,16,6,14,140,363,503
2014,3,16,6,15,134,317,451
2014,3,16,6,16,85,298,383
2014,3,16,6,17,90,239,329
2014,3,16,6,18,41,210,251
2014,3,16,6,19,17,93,110
2014,3,16,6,20,7,54,61
2014,3,16,6,21,4,33,37
2014,3,16,6,22,0,16,16
2014,3,16,6,23,0,13,13
2014,3,17,0,0,1,4,5
2014,3,17,0,1,0,4,4
2014,3,17,0,2,0,1,1
2014,3,17,0,3,0,3,3
2014,3,17,0,4,0,1,1
2014,3,17,0,5,0,3,3
2014,3,17,0,6,0,4,4
2014,3,17,0,7,0,8,8
2014,3,17,0,8,0,20,20
2014,3,17,0,9,2,28,30
2014,3,17,0,10,7,24,31
2014,3,17,0,11,3,38,41
2014,3,17,0,12,4,34,38
2014,3,17,0,13,3,60,63
2014,3,17,0,14,9,71,80
2014,3,17,0,15,5,79,84
2014,3,17,0,16,7,105,112
2014,3,17,0,17,4,141,145
2014,3,17,0,18,5,163,168
2014,3,17,0,19,4,174,178
2014,3,17,0,20,3,100,103
2014,3,17,0,21,2,77,79
2014,3,17,0,22,1,53,54
2014,3,17,0,23,1,40,41
2014,3,18,1,0,1,16,17
2014,3,18,1,1,0,8,8
2014,3,18,1,2,0,4,4
2014,3,18,1,4,0,2,2
2014,3,18,1,5,0,19,19
2014,3,18,1,6,0,100,100
2014,3,18,1,7,3,231,234
2014,3,18,1,8,3,504,507
2014,3,18,1,9,2,289,291
2014,3,18,1,10,10,120,130
2014,3,18,1,11,7,80,87
2014,3,18,1,12,20,139,159
2014,3,18,1,13,20,129,149
2014,3,18,1,14,24,142,166
2014,3,18,1,15,28,182,210
2014,3,18,1,16,27,259,286
2014,3,18,1,17,25,606,631
2014,3,18,1,18,19,597,616
2014,3,18,1,19,14,407,421
2014,3,18,1,20,5,287,292
2014,3,18,1,21,8,194,202
2014,3,18,1,22,3,121,124
2014,3,18,1,23,0,52,52
2014,3,19,2,0,0,19,19
2014,3,19,2,1,0,13,13
2014,3,19,2,2,0,3,3
2014,3,19,2,3,0,2,2
2014,3,19,2,4,0,4,4
2014,3,19,2,5,0,27,27
2014,3,19,2,6,0,136,136
2014,3,19,2,7,2,387,389
2014,3,19,2,8,4,791,795
2014,3,19,2,9,12,362,374
2014,3,19,2,10,10,149,159
2014,3,19,2,11,8,89,97
2014,3,19,2,12,8,77,85
2014,3,19,2,13,8,109,117
2014,3,19,2,14,20,85,105
2014,3,19,2,15,6,84,90
2014,3,19,2,16,6,124,130
2014,3,19,2,17,8,180,188
2014,3,19,2,18,4,200,204
2014,3,19,2,19,3,293,296
2014,3,19,2,20,0,219,219
2014,3,19,2,21,6,154,160
2014,3,19,2,22,1,116,117
2014,3,19,2,23,6,56,62
2014,3,20,3,0,4,27,31
2014,3,20,3,1,0,8,8
2014,3,20,3,2,1,7,8
2014,3,20,3,3,0,4,4
2014,3,20,3,4,1,5,6
2014,3,20,3,5,0,30,30
2014,3,20,3,6,2,138,140
2014,3,20,3,7,3,406,409
2014,3,20,3,8,15,833,848
2014,3,20,3,9,15,420,435
2014,3,20,3,10,22,189,211
2014,3,20,3,11,42,182,224
2014,3,20,3,12,84,246,330
2014,3,20,3,13,86,260,346
2014,3,20,3,14,74,235,309
2014,3,20,3,15,91,260,351
2014,3,20,3,16,83,424,507
2014,3,20,3,17,84,838,922
2014,3,20,3,18,62,812,874
2014,3,20,3,19,50,530,580
2014,3,20,3,20,21,371,392
2014,3,20,3,21,22,271,293
2014,3,20,3,22,21,197,218
2014,3,20,3,23,15,111,126
2014,3,21,4,0,8,61,69
2014,3,21,4,1,2,24,26
2014,3,21,4,2,2,9,11
2014,3,21,4,3,0,7,7
2014,3,21,4,4,0,8,8
2014,3,21,4,5,1,36,37
2014,3,21,4,6,1,127,128
2014,3,21,4,7,9,412,421
2014,3,21,4,8,15,871,886
2014,3,21,4,9,28,375,403
2014,3,21,4,10,49,227,276
2014,3,21,4,11,64,204,268
2014,3,21,4,12,68,266,334
2014,3,21,4,13,104,258,362
2014,3,21,4,14,114,219,333
2014,3,21,4,15,75,285,360
2014,3,21,4,16,114,461,575
2014,3,21,4,17,117,832,949
2014,3,21,4,18,84,728,812
2014,3,21,4,19,65,472,537
2014,3,21,4,20,35,306,341
2014,3,21,4,21,19,241,260
2014,3,21,4,22,19,173,192
2014,3,21,4,23,14,148,162
2014,3,22,5,0,10,103,113
2014,3,22,5,1,9,83,92
2014,3,22,5,2,12,51,63
2014,3,22,5,3,1,26,27
2014,3,22,5,4,1,9,10
2014,3,22,5,5,0,8,8
2014,3,22,5,6,5,22,27
2014,3,22,5,7,2,64,66
2014,3,22,5,8,31,164,195
2014,3,22,5,9,72,251,323
2014,3,22,5,10,160,343,503
2014,3,22,5,11,311,452,763
2014,3,22,5,12,346,476,822
2014,3,22,5,13,415,509,924
2014,3,22,5,14,573,553,1126
2014,3,22,5,15,593,520,1113
2014,3,22,5,16,602,497,1099
2014,3,22,5,17,519,471,990
2014,3,22,5,18,436,472,908
2014,3,22,5,19,282,353,635
2014,3,22,5,20,131,286,417
2014,3,22,5,21,91,209,300
2014,3,22,5,22,56,178,234
2014,3,22,5,23,54,157,211
2014,3,23,6,0,24,119,143
2014,3,23,6,1,17,75,92
2014,3,23,6,2,15,55,70
2014,3,23,6,3,6,21,27
2014,3,23,6,4,1,9,10
2014,3,23,6,5,5,7,12
2014,3,23,6,6,1,17,18
2014,3,23,6,7,7,45,52
2014,3,23,6,8,20,96,116
2014,3,23,6,9,61,165,226
2014,3,23,6,10,95,300,395
2014,3,23,6,11,115,338,453
2014,3,23,6,12,134,359,493
2014,3,23,6,13,137,357,494
2014,3,23,6,14,127,344,471
2014,3,23,6,15,88,348,436
2014,3,23,6,16,105,286,391
2014,3,23,6,17,65,303,368
2014,3,23,6,18,55,347,402
2014,3,23,6,19,54,237,291
2014,3,23,6,20,22,143,165
2014,3,23,6,21,13,103,116
2014,3,23,6,22,14,68,82
2014,3,23,6,23,5,36,41
2014,3,24,0,0,4,15,19
2014,3,24,0,1,2,8,10
2014,3,24,0,2,0,3,3
2014,3,24,0,3,0,1,1
2014,3,24,0,4,1,4,5
2014,3,24,0,5,0,39,39
2014,3,24,0,6,2,115,117
2014,3,24,0,7,5,324,329
2014,3,24,0,8,16,636,652
2014,3,24,0,9,13,361,374
2014,3,24,0,10,46,123,169
2014,3,24,0,11,34,111,145
2014,3,24,0,12,49,189,238
2014,3,24,0,13,45,160,205
2014,3,24,0,14,46,151,197
2014,3,24,0,15,42,172,214
2014,3,24,0,16,42,264,306
2014,3,24,0,17,54,631,685
2014,3,24,0,18,41,603,644
2014,3,24,0,19,42,416,458
2014,3,24,0,20,18,255,273
2014,3,24,0,21,11,193,204
2014,3,24,0,22,4,86,90
2014,3,24,0,23,2,56,58
2014,3,25,1,0,0,27,27
2014,3,25,1,1,0,9,9
2014,3,25,1,2,0,4,4
2014,3,25,1,3,0,3,3
2014,3,25,1,4,0,7,7
2014,3,25,1,5,0,33,33
2014,3,25,1,6,6,125,131
2014,3,25,1,7,8,390,398
2014,3,25,1,8,9,423,432
2014,3,25,1,9,4,183,187
2014,3,25,1,10,6,70,76
2014,3,25,1,11,2,47,49
2014,3,25,1,12,1,47,48
2014,3,25,1,13,6,51,57
2014,3,25,1,14,4,51,55
2014,3,25,1,15,5,87,92
2014,3,25,1,16,6,184,190
2014,3,25,1,17,15,363,378
2014,3,25,1,18,6,283,289
2014,3,25,1,19,6,205,211
2014,3,25,1,20,4,157,161
2014,3,25,1,21,3,120,123
2014,3,25,1,22,8,95,103
2014,3,25,1,23,6,50,56
2014,3,26,2,0,0,20,20
2014,3,26,2,1,0,4,4
2014,3,26,2,2,0,3,3
2014,3,26,2,4,0,7,7
2014,3,26,2,5,2,32,34
2014,3,26,2,6,3,109,112
2014,3,26,2,7,10,328,338
2014,3,26,2,8,7,638,645
2014,3,26,2,9,12,312,324
2014,3,26,2,10,7,116,123
2014,3,26,2,11,12,111,123
2014,3,26,2,12,20,174,194
2014,3,26,2,13,9,163,172
2014,3,26,2,14,16,121,137
2014,3,26,2,15,19,175,194
2014,3,26,2,16,19,275,294
2014,3,26,2,17,39,557,596
2014,3,26,2,18,31,564,595
2014,3,26,2,19,5,353,358
2014,3,26,2,20,16,262,278
2014,3,26,2,21,10,204,214
2014,3,26,2,22,7,153,160
2014,3,26,2,23,4,51,55
2014,3,27,3,0,1,22,23
2014,3,27,3,1,0,8,8
2014,3,27,3,2,1,5,6
2014,3,27,3,3,0,1,1
2014,3,27,3,4,0,7,7
2014,3,27,3,5,1,35,36
2014,3,27,3,6,2,107,109
2014,3,27,3,7,6,376,382
2014,3,27,3,8,22,779,801
2014,3,27,3,9,21,388,409
2014,3,27,3,10,29,150,179
2014,3,27,3,11,42,179,221
2014,3,27,3,12,56,216,272
2014,3,27,3,13,56,204,260
2014,3,27,3,14,39,150,189
2014,3,27,3,15,54,242,296
2014,3,27,3,16,57,322,379
2014,3,27,3,17,71,680,751
2014,3,27,3,18,57,755,812
2014,3,27,3,19,33,472,505
2014,3,27,3,20,24,303,327
2014,3,27,3,21,19,239,258
2014,3,27,3,22,18,140,158
2014,3,27,3,23,12,111,123
2014,3,28,4,0,10,61,71
2014,3,28,4,1,6,27,33
2014,3,28,4,2,6,14,20
2014,3,28,4,3,0,4,4
2014,3,28,4,4,0,5,5
2014,3,28,4,5,1,38,39
2014,3,28,4,6,2,146,148
2014,3,28,4,7,3,311,314
2014,3,28,4,8,12,497,509
2014,3,28,4,9,14,348,362
2014,3,28,4,10,19,141,160
2014,3,28,4,11,21,117,138
2014,3,28,4,12,19,156,175
2014,3,28,4,13,52,210,262
2014,3,28,4,14,87,220,307
2014,3,28,4,15,101,282,383
2014,3,28,4,16,118,428,546
2014,3,28,4,17,123,756,879
2014,3,28,4,18,83,715,798
2014,3,28,4,19,53,443,496
2014,3,28,4,20,59,309,368
2014,3,28,4,21,46,245,291
2014,3,28,4,22,37,218,255
2014,3,28,4,23,25,153,178
2014,3,29,5,0,10,176,186
2014,3,29,5,1,13,85,98
2014,3,29,5,2,8,73,81
2014,3,29,5,3,2,17,19
2014,3,29,5,4,1,12,13
2014,3,29,5,5,1,7,8
2014,3,29,5,6,2,8,10
2014,3,29,5,7,5,34,39
2014,3,29,5,8,9,101,110
2014,3,29,5,9,18,116,134
2014,3,29,5,10,17,140,157
2014,3,29,5,11,42,194,236
2014,3,29,5,12,49,229,278
2014,3,29,5,13,37,161,198
2014,3,29,5,14,17,90,107
2014,3,29,5,15,9,77,86
2014,3,29,5,16,13,54,67
2014,3,29,5,17,6,55,61
2014,3,29,5,18,6,72,78
2014,3,29,5,19,2,42,44
2014,3,29,5,20,6,53,59
2014,3,29,5,21,5,61,66
2014,3,29,5,22,4,65,69
2014,3,29,5,23,5,89,94
2014,3,30,6,0,7,51,58
2014,3,30,6,1,9,54,63
2014,3,30,6,2,1,36,37
2014,3,30,6,3,3,17,20
2014,3,30,6,4,0,3,3
2014,3,30,6,5,1,1,2
2014,3,30,6,6,0,5,5
2014,3,30,6,7,1,11,12
2014,3,30,6,8,2,56,58
2014,3,30,6,9,3,54,57
2014,3,30,6,10,2,61,63
2014,3,30,6,11,2,44,46
2014,3,30,6,12,4,52,56
2014,3,30,6,13,3,51,54
2014,3,30,6,14,0,40,40
2014,3,30,6,15,1,67,68
2014,3,30,6,16,1,47,48
2014,3,30,6,17,6,34,40
2014,3,30,6,18,3,31,34
2014,3,30,6,19,2,22,24
2014,3,30,6,20,0,28,28
2014,3,30,6,21,3,31,34
2014,3,30,6,22,1,28,29
2014,3,30,6,23,3,24,27
2014,3,31,0,0,1,16,17
2014,3,31,0,1,4,7,11
2014,3,31,0,2,1,5,6
2014,3,31,0,3,1,2,3
2014,3,31,0,4,0,7,7
2014,3,31,0,5,1,27,28
2014,3,31,0,6,4,122,126
2014,3,31,0,7,7,431,438
2014,3,31,0,8,22,801,823
2014,3,31,0,9,43,352,395
2014,3,31,0,10,63,127,190
2014,3,31,0,11,119,193,312
2014,3,31,0,12,115,268,383
2014,3,31,0,13,124,263,387
2014,3,31,0,14,166,233,399
2014,3,31,0,15,154,263,417
2014,3,31,0,16,150,456,606
2014,3,31,0,17,135,927,1062
2014,3,31,0,18,107,890,997
2014,3,31,0,19,67,627,694
2014,3,31,0,20,51,386,437
2014,3,31,0,21,17,249,266
2014,3,31,0,22,28,157,185
2014,3,31,0,23,12,67,79
2014,4,1,1,0,1,29,30
2014,4,1,1,1,4,12,16
2014,4,1,1,2,3,9,12
2014,4,1,1,4,0,8,8
2014,4,1,1,5,4,51,55
2014,4,1,1,6,8,173,181
2014,4,1,1,7,18,562,580
2014,4,1,1,8,19,986,1005
2014,4,1,1,9,43,413,456
2014,4,1,1,10,75,195,270
2014,4,1,1,11,112,180,292
2014,4,1,1,12,100,258,358
2014,4,1,1,13,150,281,431
2014,4,1,1,14,114,253,367
2014,4,1,1,15,171,279,450
2014,4,1,1,16,143,446,589
2014,4,1,1,17,154,1087,1241
2014,4,1,1,18,143,1018,1161
2014,4,1,1,19,105,662,767
2014,4,1,1,20,53,455,508
2014,4,1,1,21,50,297,347
2014,4,1,1,22,27,211,238
2014,4,1,1,23,10,104,114
2014,4,2,2,0,6,44,50
2014,4,2,2,1,2,25,27
2014,4,2,2,2,3,7,10
2014,4,2,2,3,1,4,5
2014,4,2,2,4,0,7,7
2014,4,2,2,5,2,46,48
2014,4,2,2,6,8,210,218
2014,4,2,2,7,23,552,575
2014,4,2,2,8,24,979,1003
2014,4,2,2,9,42,397,439
2014,4,2,2,10,64,167,231
2014,4,2,2,11,68,181,249
2014,4,2,2,12,74,275,349
2014,4,2,2,13,98,264,362
2014,4,2,2,14,135,237,372
2014,4,2,2,15,144,270,414
2014,4,2,2,16,111,425,536
2014,4,2,2,17,158,967,1125
2014,4,2,2,18,128,934,1062
2014,4,2,2,19,107,637,744
2014,4,2,2,20,54,407,461
2014,4,2,2,21,34,346,380
2014,4,2,2,22,35,176,211
2014,4,2,2,23,7,102,109
2014,4,3,3,0,3,39,42
2014,4,3,3,1,1,19,20
2014,4,3,3,2,0,6,6
2014,4,3,3,3,1,3,4
2014,4,3,3,4,1,7,8
2014,4,3,3,5,1,39,40
2014,4,3,3,6,6,174,180
2014,4,3,3,7,18,559,577
2014,4,3,3,8,26,964,990
2014,4,3,3,9,75,496,571
2014,4,3,3,10,116,203,319
2014,4,3,3,11,93,226,319
2014,4,3,3,12,123,319,442
2014,4,3,3,13,108,307,415
2014,4,3,3,14,137,268,405
2014,4,3,3,15,145,322,467
2014,4,3,3,16,130,412,542
2014,4,3,3,17,128,886,1014
2014,4,3,3,18,101,912,1013
2014,4,3,3,19,84,576,660
2014,4,3,3,20,47,381,428
2014,4,3,3,21,43,302,345
2014,4,3,3,22,34,209,243
2014,4,3,3,23,11,127,138
2014,4,4,4,0,4,47,51
2014,4,4,4,1,1,34,35
2014,4,4,4,2,0,11,11
2014,4,4,4,3,7,5,12
2014,4,4,4,4,3,8,11
2014,4,4,4,5,2,51,53
2014,4,4,4,6,5,149,154
2014,4,4,4,7,10,447,457
2014,4,4,4,8,37,925,962
2014,4,4,4,9,48,423,471
2014,4,4,4,10,80,249,329
2014,4,4,4,11,105,277,382
2014,4,4,4,12,147,357,504
2014,4,4,4,13,94,316,410
2014,4,4,4,14,165,254,419
2014,4,4,4,15,152,339,491
2014,4,4,4,16,170,576,746
2014,4,4,4,17,154,901,1055
2014,4,4,4,18,97,708,805
2014,4,4,4,19,83,476,559
2014,4,4,4,20,52,351,403
2014,4,4,4,21,43,251,294
2014,4,4,4,22,37,217,254
2014,4,4,4,23,9,95,104
2014,4,5,5,0,9,74,83
2014,4,5,5,1,8,68,76
2014,4,5,5,2,16,60,76
2014,4,5,5,3,12,24,36
2014,4,5,5,4,0,8,8
2014,4,5,5,5,2,17,19
2014,4,5,5,6,10,25,35
2014,4,5,5,7,18,85,103
2014,4,5,5,8,54,241,295
2014,4,5,5,9,156,324,480
2014,4,5,5,10,267,369,636
2014,4,5,5,11,419,474,893
2014,4,5,5,12,541,518,1059
2014,4,5,5,13,571,524,1095
2014,4,5,5,14,534,539,1073
2014,4,5,5,15,516,508,1024
2014,4,5,5,16,481,454,935
2014,4,5,5,17,381,493,874
2014,4,5,5,18,263,414,677
2014,4,5,5,19,145,293,438
2014,4,5,5,20,64,219,283
2014,4,5,5,21,78,187,265
2014,4,5,5,22,60,151,211
2014,4,5,5,23,21,146,167
2014,4,6,6,0,16,97,113
2014,4,6,6,1,14,63,77
2014,4,6,6,2,10,59,69
2014,4,6,6,3,6,24,30
2014,4,6,6,4,0,7,7
2014,4,6,6,5,2,20,22
2014,4,6,6,6,15,113,128
2014,4,6,6,7,19,88,107
2014,4,6,6,8,50,147,197
2014,4,6,6,9,114,286,400
2014,4,6,6,10,228,382,610
2014,4,6,6,11,278,479,757
2014,4,6,6,12,366,555,921
2014,4,6,6,13,424,518,942
2014,4,6,6,14,441,505,946
2014,4,6,6,15,447,540,987
2014,4,6,6,16,445,608,1053
2014,4,6,6,17,335,502,837
2014,4,6,6,18,231,415,646
2014,4,6,6,19,111,325,436
2014,4,6,6,20,47,230,277
2014,4,6,6,21,20,107,127
2014,4,6,6,22,40,119,159
2014,4,6,6,23,19,65,84
2014,4,7,0,0,11,25,36
2014,4,7,0,1,10,4,14
2014,4,7,0,2,2,4,6
2014,4,7,0,3,1,2,3
2014,4,7,0,4,0,12,12
2014,4,7,0,5,0,40,40
2014,4,7,0,6,7,112,119
2014,4,7,0,7,6,271,277
2014,4,7,0,8,15,454,469
2014,4,7,0,9,6,138,144
2014,4,7,0,10,7,50,57
2014,4,7,0,11,6,36,42
2014,4,7,0,12,5,54,59
2014,4,7,0,13,4,43,47
2014,4,7,0,14,8,72,80
2014,4,7,0,15,4,36,40
2014,4,7,0,16,8,80,88
2014,4,7,0,17,8,263,271
2014,4,7,0,18,13,247,260
2014,4,7,0,19,9,263,272
2014,4,7,0,20,7,189,196
2014,4,7,0,21,7,124,131
2014,4,7,0,22,0,94,94
2014,4,7,0,23,5,80,85
2014,4,8,1,0,5,30,35
2014,4,8,1,1,3,9,12
2014,4,8,1,2,0,4,4
2014,4,8,1,3,0,2,2
2014,4,8,1,4,0,5,5
2014,4,8,1,5,1,40,41
2014,4,8,1,6,6,168,174
2014,4,8,1,7,12,483,495
2014,4,8,1,8,10,892,902
2014,4,8,1,9,23,380,403
2014,4,8,1,10,52,198,250
2014,4,8,1,11,74,196,270
2014,4,8,1,12,88,308,396
2014,4,8,1,13,87,305,392
2014,4,8,1,14,113,255,368
2014,4,8,1,15,98,329,427
2014,4,8,1,16,108,483,591
2014,4,8,1,17,120,1058,1178
2014,4,8,1,18,107,996,1103
2014,4,8,1,19,93,675,768
2014,4,8,1,20,43,432,475
2014,4,8,1,21,39,306,345
2014,4,8,1,22,9,194,203
2014,4,8,1,23,7,111,118
2014,4,9,2,0,5,27,32
2014,4,9,2,1,5,18,23
2014,4,9,2,2,5,1,6
2014,4,9,2,3,1,6,7
2014,4,9,2,4,0,9,9
2014,4,9,2,5,2,67,69
2014,4,9,2,6,15,195,210
2014,4,9,2,7,28,613,641
2014,4,9,2,8,41,1017,1058
2014,4,9,2,9,57,437,494
2014,4,9,2,10,89,207,296
2014,4,9,2,11,120,264,384
2014,4,9,2,12,109,292,401
2014,4,9,2,13,117,293,410
2014,4,9,2,14,122,274,396
2014,4,9,2,15,114,291,405
2014,4,9,2,16,128,476,604
2014,4,9,2,17,154,1058,1212
2014,4,9,2,18,121,1067,1188
2014,4,9,2,19,118,733,851
2014,4,9,2,20,65,465,530
2014,4,9,2,21,27,332,359
2014,4,9,2,22,23,237,260
2014,4,9,2,23,19,129,148
2014,4,10,3,0,11,48,59
2014,4,10,3,1,5,15,20
2014,4,10,3,2,0,6,6
2014,4,10,3,3,1,7,8
2014,4,10,3,4,0,8,8
2014,4,10,3,5,2,61,63
2014,4,10,3,6,20,219,239
2014,4,10,3,7,33,613,646
2014,4,10,3,8,37,959,996
2014,4,10,3,9,64,442,506
2014,4,10,3,10,109,217,326
2014,4,10,3,11,124,235,359
2014,4,10,3,12,178,363,541
2014,4,10,3,13,235,345,580
2014,4,10,3,14,218,318,536
2014,4,10,3,15,245,364,609
2014,4,10,3,16,206,531,737
2014,4,10,3,17,249,1070,1319
2014,4,10,3,18,214,1092,1306
2014,4,10,3,19,152,799,951
2014,4,10,3,20,108,505,613
2014,4,10,3,21,58,374,432
2014,4,10,3,22,46,256,302
2014,4,10,3,23,33,160,193
2014,4,11,4,0,16,56,72
2014,4,11,4,1,10,38,48
2014,4,11,4,2,4,12,16
2014,4,11,4,3,3,5,8
2014,4,11,4,4,1,5,6
2014,4,11,4,5,4,65,69
2014,4,11,4,6,32,216,248
2014,4,11,4,7,28,564,592
2014,4,11,4,8,49,948,997
2014,4,11,4,9,96,484,580
2014,4,11,4,10,150,239,389
2014,4,11,4,11,171,313,484
2014,4,11,4,12,225,385,610
2014,4,11,4,13,220,389,609
2014,4,11,4,14,310,353,663
2014,4,11,4,15,298,436,734
2014,4,11,4,16,362,672,1034
2014,4,11,4,17,326,1040,1366
2014,4,11,4,18,275,908,1183
2014,4,11,4,19,187,562,749
2014,4,11,4,20,75,293,368
2014,4,11,4,21,55,166,221
2014,4,11,4,22,51,230,281
2014,4,11,4,23,34,178,212
2014,4,12,5,0,22,122,144
2014,4,12,5,1,16,94,110
2014,4,12,5,2,12,68,80
2014,4,12,5,3,6,14,20
2014,4,12,5,4,1,4,5
2014,4,12,5,5,9,17,26
2014,4,12,5,6,38,57,95
2014,4,12,5,7,90,146,236
2014,4,12,5,8,151,288,439
2014,4,12,5,9,234,425,659
2014,4,12,5,10,443,514,957
2014,4,12,5,11,547,568,1115
2014,4,12,5,12,755,580,1335
2014,4,12,5,13,791,622,1413
2014,4,12,5,14,817,616,1433
2014,4,12,5,15,814,565,1379
2014,4,12,5,16,766,568,1334
2014,4,12,5,17,707,562,1269
2014,4,12,5,18,611,560,1171
2014,4,12,5,19,421,457,878
2014,4,12,5,20,275,322,597
2014,4,12,5,21,181,292,473
2014,4,12,5,22,140,196,336
2014,4,12,5,23,76,175,251
2014,4,13,6,0,58,137,195
2014,4,13,6,1,19,104,123
2014,4,13,6,2,15,72,87
2014,4,13,6,3,19,26,45
2014,4,13,6,4,5,12,17
2014,4,13,6,5,9,15,24
2014,4,13,6,6,31,28,59
2014,4,13,6,7,92,97,189
2014,4,13,6,8,168,195,363
2014,4,13,6,9,290,363,653
2014,4,13,6,10,519,456,975
2014,4,13,6,11,700,553,1253
2014,4,13,6,12,722,563,1285
2014,4,13,6,13,814,534,1348
2014,4,13,6,14,784,547,1331
2014,4,13,6,15,684,547,1231
2014,4,13,6,16,652,563,1215
2014,4,13,6,17,515,581,1096
2014,4,13,6,18,453,504,957
2014,4,13,6,19,389,436,825
2014,4,13,6,20,216,364,580
2014,4,13,6,21,148,188,336
2014,4,13,6,22,81,169,250
2014,4,13,6,23,65,76,141
2014,4,14,0,0,21,41,62
2014,4,14,0,1,10,18,28
2014,4,14,0,2,2,0,2
2014,4,14,0,3,0,1,1
2014,4,14,0,4,2,6,8
2014,4,14,0,5,6,48,54
2014,4,14,0,6,14,204,218
2014,4,14,0,7,29,610,639
2014,4,14,0,8,85,820,905
2014,4,14,0,9,157,378,535
2014,4,14,0,10,231,164,395
2014,4,14,0,11,252,225,477
2014,4,14,0,12,264,296,560
2014,4,14,0,13,267,300,567
2014,4,14,0,14,279,241,520
2014,4,14,0,15,316,289,605
2014,4,14,0,16,299,499,798
2014,4,14,0,17,247,1080,1327
2014,4,14,0,18,210,921,1131
2014,4,14,0,19,144,550,694
2014,4,14,0,20,109,388,497
2014,4,14,0,21,85,295,380
2014,4,14,0,22,34,161,195
2014,4,14,0,23,22,104,126
2014,4,15,1,0,5,20,25
2014,4,15,1,1,8,9,17
2014,4,15,1,2,8,3,11
2014,4,15,1,3,3,3,6
2014,4,15,1,4,3,8,11
2014,4,15,1,5,1,45,46
2014,4,15,1,6,6,130,136
2014,4,15,1,7,7,170,177
2014,4,15,1,8,8,138,146
2014,4,15,1,9,6,62,68
2014,4,15,1,10,22,52,74
2014,4,15,1,11,19,127,146
2014,4,15,1,12,40,142,182
2014,4,15,1,13,12,47,59
2014,4,15,1,14,9,25,34
2014,4,15,1,15,2,39,41
2014,4,15,1,16,16,76,92
2014,4,15,1,17,3,126,129
2014,4,15,1,18,6,150,156
2014,4,15,1,19,2,69,71
2014,4,15,1,20,2,63,65
2014,4,15,1,21,1,59,60
2014,4,15,1,22,1,41,42
2014,4,15,1,23,1,47,48
2014,4,16,2,0,0,14,14
2014,4,16,2,1,3,7,10
2014,4,16,2,2,0,7,7
2014,4,16,2,3,0,2,2
2014,4,16,2,4,0,9,9
2014,4,16,2,5,1,38,39
2014,4,16,2,6,2,136,138
2014,4,16,2,7,2,393,395
2014,4,16,2,8,29,716,745
2014,4,16,2,9,35,360,395
2014,4,16,2,10,49,180,229
2014,4,16,2,11,79,181,260
2014,4,16,2,12,82,266,348
2014,4,16,2,13,94,241,335
2014,4,16,2,14,146,211,357
2014,4,16,2,15,185,225,410
2014,4,16,2,16,161,412,573
2014,4,16,2,17,175,888,1063
2014,4,16,2,18,124,789,913
2014,4,16,2,19,87,574,661
2014,4,16,2,20,40,349,389
2014,4,16,2,21,33,251,284
2014,4,16,2,22,23,144,167
2014,4,16,2,23,6,102,108
2014,4,17,3,0,1,38,39
2014,4,17,3,1,7,11,18
2014,4,17,3,2,1,10,11
2014,4,17,3,3,0,4,4
2014,4,17,3,4,1,7,8
2014,4,17,3,5,2,39,41
2014,4,17,3,6,5,171,176
2014,4,17,3,7,7,468,475
2014,4,17,3,8,42,879,921
2014,4,17,3,9,70,369,439
2014,4,17,3,10,101,184,285
2014,4,17,3,11,96,215,311
2014,4,17,3,12,129,277,406
2014,4,17,3,13,143,305,448
2014,4,17,3,14,137,264,401
2014,4,17,3,15,172,289,461
2014,4,17,3,16,161,459,620
2014,4,17,3,17,156,918,1074
2014,4,17,3,18,111,883,994
2014,4,17,3,19,91,545,636
2014,4,17,3,20,26,362,388
2014,4,17,3,21,34,261,295
2014,4,17,3,22,15,149,164
2014,4,17,3,23,7,91,98
2014,4,18,4,0,2,53,55
2014,4,18,4,1,4,23,27
2014,4,18,4,2,0,10,10
2014,4,18,4,3,0,5,5
2014,4,18,4,4,1,10,11
2014,4,18,4,5,3,46,49
2014,4,18,4,6,5,146,151
2014,4,18,4,7,8,361,369
2014,4,18,4,8,48,761,809
2014,4,18,4,9,80,401,481
2014,4,18,4,10,146,253,399
2014,4,18,4,11,138,253,391
2014,4,18,4,12,200,330,530
2014,4,18,4,13,218,337,555
2014,4,18,4,14,234,337,571
2014,4,18,4,15,249,437,686
2014,4,18,4,16,267,550,817
2014,4,18,4,17,229,801,1030
2014,4,18,4,18,165,642,807
2014,4,18,4,19,114,471,585
2014,4,18,4,20,66,289,355
2014,4,18,4,21,75,254,329
2014,4,18,4,22,38,204,242
2014,4,18,4,23,33,131,164
2014,4,19,5,0,16,84,100
2014,4,19,5,1,18,61,79
2014,4,19,5,2,3,45,48
2014,4,19,5,3,2,25,27
2014,4,19,5,4,3,5,8
2014,4,19,5,5,3,11,14
2014,4,19,5,6,8,14,22
2014,4,19,5,7,22,75,97
2014,4,19,5,8,71,184,255
2014,4,19,5,9,141,295,436
2014,4,19,5,10,302,339,641
2014,4,19,5,11,477,440,917
2014,4,19,5,12,518,543,1061
2014,4,19,5,13,550,454,1004
2014,4,19,5,14,669,460,1129
2014,4,19,5,15,736,528,1264
2014,4,19,5,16,666,523,1189
2014,4,19,5,17,575,462,1037
2014,4,19,5,18,435,425,860
2014,4,19,5,19,285,333,618
2014,4,19,5,20,182,267,449
2014,4,19,5,21,112,198,310
2014,4,19,5,22,73,179,252
2014,4,19,5,23,46,161,207
2014,4,20,6,0,27,113,140
2014,4,20,6,1,13,81,94
2014,4,20,6,2,11,63,74
2014,4,20,6,3,2,24,26
2014,4,20,6,4,2,8,10
2014,4,20,6,5,14,12,26
2014,4,20,6,6,18,21,39
2014,4,20,6,7,34,72,106
2014,4,20,6,8,61,157,218
2014,4,20,6,9,120,239,359
2014,4,20,6,10,234,364,598
2014,4,20,6,11,342,367,709
2014,4,20,6,12,388,470,858
2014,4,20,6,13,454,475,929
2014,4,20,6,14,426,434,860
2014,4,20,6,15,487,461,948
2014,4,20,6,16,419,412,831
2014,4,20,6,17,382,452,834
2014,4,20,6,18,239,412,651
2014,4,20,6,19,201,365,566
2014,4,20,6,20,86,222,308
2014,4,20,6,21,75,162,237
2014,4,20,6,22,50,100,150
2014,4,20,6,23,14,42,56
2014,4,21,0,0,6,22,28
2014,4,21,0,1,2,11,13
2014,4,21,0,2,0,11,11
2014,4,21,0,3,0,1,1
2014,4,21,0,4,1,8,9
2014,4,21,0,5,2,48,50
2014,4,21,0,6,10,175,185
2014,4,21,0,7,23,503,526
2014,4,21,0,8,34,849,883
2014,4,21,0,9,80,364,444
2014,4,21,0,10,121,205,326
2014,4,21,0,11,143,201,344
2014,4,21,0,12,152,315,467
2014,4,21,0,13,145,268,413
2014,4,21,0,14,193,230,423
2014,4,21,0,15,221,293,514
2014,4,21,0,16,205,505,710
2014,4,21,0,17,228,1095,1323
2014,4,21,0,18,157,984,1141
2014,4,21,0,19,115,649,764
2014,4,21,0,20,78,410,488
2014,4,21,0,21,65,292,357
2014,4,21,0,22,36,180,216
2014,4,21,0,23,12,102,114
2014,4,22,1,0,15,38,53
2014,4,22,1,1,14,12,26
2014,4,22,1,2,9,4,13
2014,4,22,1,3,9,1,10
2014,4,22,1,4,0,5,5
2014,4,22,1,5,4,55,59
2014,4,22,1,6,8,232,240
2014,4,22,1,7,16,676,692
2014,4,22,1,8,48,1041,1089
2014,4,22,1,9,57,409,466
2014,4,22,1,10,90,222,312
2014,4,22,1,11,95,221,316
2014,4,22,1,12,148,352,500
2014,4,22,1,13,97,222,319
2014,4,22,1,14,25,109,134
2014,4,22,1,15,87,222,309
2014,4,22,1,16,112,433,545
2014,4,22,1,17,145,997,1142
2014,4,22,1,18,77,912,989
2014,4,22,1,19,71,619,690
2014,4,22,1,20,53,469,522
2014,4,22,1,21,30,341,371
2014,4,22,1,22,35,228,263
2014,4,22,1,23,17,123,140
2014,4,23,2,0,4,44,48
2014,4,23,2,1,2,22,24
2014,4,23,2,2,0,1,1
2014,4,23,2,3,0,5,5
2014,4,23,2,4,1,7,8
2014,4,23,2,5,3,57,60
2014,4,23,2,6,8,206,214
2014,4,23,2,7,24,656,680
2014,4,23,2,8,33,978,1011
2014,4,23,2,9,58,391,449
2014,4,23,2,10,74,172,246
2014,4,23,2,11,99,221,320
2014,4,23,2,12,85,274,359
2014,4,23,2,13,128,265,393
2014,4,23,2,14,107,263,370
2014,4,23,2,15,98,273,371
2014,4,23,2,16,122,471,593
2014,4,23,2,17,118,1031,1149
2014,4,23,2,18,91,969,1060
2014,4,23,2,19,68,562,630
2014,4,23,2,20,37,387,424
2014,4,23,2,21,26,277,303
2014,4,23,2,22,13,201,214
2014,4,23,2,23,3,94,97
2014,4,24,3,0,2,39,41
2014,4,24,3,1,0,15,15
2014,4,24,3,2,0,7,7
2014,4,24,3,3,0,1,1
2014,4,24,3,4,0,4,4
2014,4,24,3,5,4,45,49
2014,4,24,3,6,4,212,216
2014,4,24,3,7,15,567,582
2014,4,24,3,8,31,966,997
2014,4,24,3,9,66,424,490
2014,4,24,3,10,80,210,290
2014,4,24,3,11,107,246,353
2014,4,24,3,12,151,346,497
2014,4,24,3,13,130,318,448
2014,4,24,3,14,111,314,425
2014,4,24,3,15,162,326,488
2014,4,24,3,16,173,507,680
2014,4,24,3,17,138,1017,1155
2014,4,24,3,18,122,961,1083
2014,4,24,3,19,99,682,781
2014,4,24,3,20,65,438,503
2014,4,24,3,21,65,318,383
2014,4,24,3,22,51,248,299
2014,4,24,3,23,33,165,198
2014,4,25,4,0,24,81,105
2014,4,25,4,1,5,24,29
2014,4,25,4,2,10,8,18
2014,4,25,4,3,0,8,8
2014,4,25,4,4,0,5,5
2014,4,25,4,5,3,47,50
2014,4,25,4,6,8,171,179
2014,4,25,4,7,23,537,560
2014,4,25,4,8,49,975,1024
2014,4,25,4,9,69,438,507
2014,4,25,4,10,98,240,338
2014,4,25,4,11,135,280,415
2014,4,25,4,12,169,360,529
2014,4,25,4,13,159,366,525
2014,4,25,4,14,203,307,510
2014,4,25,4,15,170,429,599
2014,4,25,4,16,163,522,685
2014,4,25,4,17,23,142,165
2014,4,25,4,18,13,132,145
2014,4,25,4,19,47,289,336
2014,4,25,4,20,50,232,282
2014,4,25,4,21,41,173,214
2014,4,25,4,22,52,198,250
2014,4,25,4,23,34,146,180
2014,4,26,5,0,11,113,124
2014,4,26,5,1,19,63,82
2014,4,26,5,2,11,50,61
2014,4,26,5,3,3,16,19
2014,4,26,5,4,3,7,10
2014,4,26,5,5,2,12,14
2014,4,26,5,6,7,33,40
2014,4,26,5,7,29,110,139
2014,4,26,5,8,58,226,284
2014,4,26,5,9,169,353,522
2014,4,26,5,10,299,464,763
2014,4,26,5,11,454,541,995
2014,4,26,5,12,476,574,1050
2014,4,26,5,13,541,549,1090
2014,4,26,5,14,529,493,1022
2014,4,26,5,15,535,525,1060
2014,4,26,5,16,500,533,1033
2014,4,26,5,17,462,546,1008
2014,4,26,5,18,340,453,793
2014,4,26,5,19,216,362,578
2014,4,26,5,20,126,224,350
2014,4,26,5,21,63,137,200
2014,4,26,5,22,64,147,211
2014,4,26,5,23,44,135,179
2014,4,27,6,0,38,144,182
2014,4,27,6,1,38,100,138
2014,4,27,6,2,22,55,77
2014,4,27,6,3,19,20,39
2014,4,27,6,4,2,11,13
2014,4,27,6,5,11,27,38
2014,4,27,6,6,58,33,91
2014,4,27,6,7,151,104,255
2014,4,27,6,8,166,232,398
2014,4,27,6,9,204,294,498
2014,4,27,6,10,243,423,666
2014,4,27,6,11,324,521,845
2014,4,27,6,12,411,622,1033
2014,4,27,6,13,425,558,983
2014,4,27,6,14,404,462,866
2014,4,27,6,15,381,510,891
2014,4,27,6,16,352,505,857
2014,4,27,6,17,397,536,933
2014,4,27,6,18,296,483,779
2014,4,27,6,19,193,372,565
2014,4,27,6,20,136,292,428
2014,4,27,6,21,89,164,253
2014,4,27,6,22,83,120,203
2014,4,27,6,23,53,77,130
2014,4,28,0,0,25,49,74
2014,4,28,0,1,15,11,26
2014,4,28,0,2,7,9,16
2014,4,28,0,3,0,3,3
2014,4,28,0,4,0,2,2
2014,4,28,0,5,5,57,62
2014,4,28,0,6,4,202,206
2014,4,28,0,7,17,595,612
2014,4,28,0,8,46,936,982
2014,4,28,0,9,100,361,461
2014,4,28,0,10,140,178,318
2014,4,28,0,11,148,212,360
2014,4,28,0,12,168,283,451
2014,4,28,0,13,139,292,431
2014,4,28,0,14,150,253,403
2014,4,28,0,15,108,261,369
2014,4,28,0,16,63,246,309
2014,4,28,0,17,48,439,487
2014,4,28,0,18,38,273,311
2014,4,28,0,19,10,230,240
2014,4,28,0,20,6,94,100
2014,4,28,0,21,7,101,108
2014,4,28,0,22,4,93,97
2014,4,28,0,23,5,54,59
2014,4,29,1,0,2,16,18
2014,4,29,1,1,1,4,5
2014,4,29,1,2,0,10,10
2014,4,29,1,3,0,2,2
2014,4,29,1,4,0,2,2
2014,4,29,1,5,0,52,52
2014,4,29,1,6,3,156,159
2014,4,29,1,7,13,323,336
2014,4,29,1,8,26,558,584
2014,4,29,1,9,5,123,128
2014,4,29,1,10,11,66,77
2014,4,29,1,11,6,62,68
2014,4,29,1,12,7,59,66
2014,4,29,1,13,10,84,94
2014,4,29,1,14,10,56,66
2014,4,29,1,15,12,53,65
2014,4,29,1,16,13,89,102
2014,4,29,1,17,31,292,323
2014,4,29,1,18,18,339,357
2014,4,29,1,19,16,308,324
2014,4,29,1,20,17,193,210
2014,4,29,1,21,5,45,50
2014,4,29,1,22,0,29,29
2014,4,29,1,23,2,19,21
2014,4,30,2,0,1,15,16
2014,4,30,2,1,1,11,12
2014,4,30,2,2,0,7,7
2014,4,30,2,4,0,3,3
2014,4,30,2,5,0,32,32
2014,4,30,2,6,6,84,90
2014,4,30,2,7,1,103,104
2014,4,30,2,8,3,153,156
2014,4,30,2,9,0,56,56
2014,4,30,2,10,4,31,35
2014,4,30,2,11,2,45,47
2014,4,30,2,12,1,25,26
2014,4,30,2,13,4,47,51
2014,4,30,2,14,3,39,42
2014,4,30,2,15,6,45,51
2014,4,30,2,16,8,132,140
2014,4,30,2,17,1,127,128
2014,4,30,2,18,3,92,95
2014,4,30,2,19,2,161,163
2014,4,30,2,20,4,205,209
2014,4,30,2,21,4,150,154
2014,4,30,2,22,3,122,125
2014,4,30,2,23,0,74,74
2014,5,1,3,0,0,36,36
2014,5,1,3,1,0,11,11
2014,5,1,3,2,1,3,4
2014,5,1,3,3,0,4,4
2014,5,1,3,4,1,5,6
2014,5,1,3,5,1,37,38
2014,5,1,3,6,3,179,182
2014,5,1,3,7,16,484,500
2014,5,1,3,8,25,856,881
2014,5,1,3,9,36,433,469
2014,5,1,3,10,55,253,308
2014,5,1,3,11,71,251,322
2014,5,1,3,12,99,342,441
2014,5,1,3,13,108,341,449
2014,5,1,3,14,94,284,378
2014,5,1,3,15,116,291,407
2014,5,1,3,16,112,529,641
2014,5,1,3,17,133,1040,1173
2014,5,1,3,18,136,1074,1210
2014,5,1,3,19,105,695,800
2014,5,1,3,20,65,532,597
2014,5,1,3,21,52,343,395
2014,5,1,3,22,25,222,247
2014,5,1,3,23,18,174,192
2014,5,2,4,0,5,74,79
2014,5,2,4,1,4,34,38
2014,5,2,4,2,3,24,27
2014,5,2,4,3,0,5,5
2014,5,2,4,4,0,7,7
2014,5,2,4,5,1,67,68
2014,5,2,4,6,3,158,161
2014,5,2,4,7,22,538,560
2014,5,2,4,8,40,979,1019
2014,5,2,4,9,72,459,531
2014,5,2,4,10,103,217,320
2014,5,2,4,11,137,276,413
2014,5,2,4,12,134,389,523
2014,5,2,4,13,149,365,514
2014,5,2,4,14,175,338,513
2014,5,2,4,15,160,381,541
2014,5,2,4,16,148,615,763
2014,5,2,4,17,158,1029,1187
2014,5,2,4,18,149,888,1037
2014,5,2,4,19,151,578,729
2014,5,2,4,20,105,384,489
2014,5,2,4,21,65,312,377
2014,5,2,4,22,52,270,322
2014,5,2,4,23,45,181,226
2014,5,3,5,0,25,154,179
2014,5,3,5,1,18,78,96
2014,5,3,5,2,10,69,79
2014,5,3,5,3,3,22,25
2014,5,3,5,4,3,7,10
2014,5,3,5,5,7,9,16
2014,5,3,5,6,2,39,41
2014,5,3,5,7,21,113,134
2014,5,3,5,8,35,231,266
2014,5,3,5,9,134,414,548
2014,5,3,5,10,237,420,657
2014,5,3,5,11,300,495,795
2014,5,3,5,12,383,546,929
2014,5,3,5,13,425,565,990
2014,5,3,5,14,447,519,966
2014,5,3,5,15,458,496,954
2014,5,3,5,16,421,538,959
2014,5,3,5,17,402,533,935
2014,5,3,5,18,284,440,724
2014,5,3,5,19,225,410,635
2014,5,3,5,20,115,306,421
2014,5,3,5,21,113,268,381
2014,5,3,5,22,91,230,321
2014,5,3,5,23,51,190,241
2014,5,4,6,0,46,137,183
2014,5,4,6,1,13,105,118
2014,5,4,6,2,12,61,73
2014,5,4,6,3,2,30,32
2014,5,4,6,4,5,8,13
2014,5,4,6,5,3,3,6
2014,5,4,6,6,7,16,23
2014,5,4,6,7,21,82,103
2014,5,4,6,8,65,171,236
2014,5,4,6,9,155,275,430
2014,5,4,6,10,272,477,749
2014,5,4,6,11,366,516,882
2014,5,4,6,12,436,568,1004
2014,5,4,6,13,363,608,971
2014,5,4,6,14,373,529,902
2014,5,4,6,15,347,524,871
2014,5,4,6,16,347,538,885
2014,5,4,6,17,315,549,864
2014,5,4,6,18,244,511,755
2014,5,4,6,19,160,423,583
2014,5,4,6,20,100,285,385
2014,5,4,6,21,75,172,247
2014,5,4,6,22,54,167,221
2014,5,4,6,23,29,77,106
2014,5,5,0,0,9,26,35
2014,5,5,0,1,4,9,13
2014,5,5,0,2,0,3,3
2014,5,5,0,3,0,3,3
2014,5,5,0,4,0,3,3
2014,5,5,0,5,2,43,45
2014,5,5,0,6,8,214,222
2014,5,5,0,7,41,589,630
2014,5,5,0,8,30,906,936
2014,5,5,0,9,84,392,476
2014,5,5,0,10,103,204,307
2014,5,5,0,11,135,215,350
2014,5,5,0,12,143,289,432
2014,5,5,0,13,119,316,435
2014,5,5,0,14,106,261,367
2014,5,5,0,15,138,300,438
2014,5,5,0,16,147,466,613
2014,5,5,0,17,168,1026,1194
2014,5,5,0,18,101,933,1034
2014,5,5,0,19,39,333,372
2014,5,5,0,20,10,85,95
2014,5,5,0,21,5,55,60
2014,5,5,0,22,4,38,42
2014,5,5,0,23,2,62,64
2014,5,6,1,0,5,14,19
2014,5,6,1,1,6,19,25
2014,5,6,1,2,0,10,10
2014,5,6,1,3,2,1,3
2014,5,6,1,4,0,4,4
2014,5,6,1,5,2,58,60
2014,5,6,1,6,14,202,216
2014,5,6,1,7,29,631,660
2014,5,6,1,8,43,1007,1050
2014,5,6,1,9,55,399,454
2014,5,6,1,10,88,201,289
2014,5,6,1,11,82,251,333
2014,5,6,1,12,101,324,425
2014,5,6,1,13,114,302,416
2014,5,6,1,14,133,294,427
2014,5,6,1,15,119,278,397
2014,5,6,1,16,166,554,720
2014,5,6,1,17,232,1167,1399
2014,5,6,1,18,154,1086,1240
2014,5,6,1,19,127,703,830
2014,5,6,1,20,98,509,607
2014,5,6,1,21,83,359,442
2014,5,6,1,22,55,273,328
2014,5,6,1,23,37,139,176
2014,5,7,2,0,24,50,74
2014,5,7,2,1,11,23,34
2014,5,7,2,2,9,7,16
2014,5,7,2,3,1,1,2
2014,5,7,2,4,0,4,4
2014,5,7,2,5,4,74,78
2014,5,7,2,6,17,243,260
2014,5,7,2,7,40,677,717
2014,5,7,2,8,50,1082,1132
2014,5,7,2,9,63,421,484
2014,5,7,2,10,63,198,261
2014,5,7,2,11,75,224,299
2014,5,7,2,12,16,67,83
2014,5,7,2,13,18,63,81
2014,5,7,2,14,44,163,207
2014,5,7,2,15,60,257,317
2014,5,7,2,16,66,460,526
2014,5,7,2,17,85,998,1083
2014,5,7,2,18,97,963,1060
2014,5,7,2,19,67,613,680
2014,5,7,2,20,36,467,503
2014,5,7,2,21,34,325,359
2014,5,7,2,22,28,221,249
2014,5,7,2,23,23,117,140
2014,5,8,3,0,11,50,61
2014,5,8,3,1,7,18,25
2014,5,8,3,2,3,10,13
2014,5,8,3,3,0,6,6
2014,5,8,3,4,8,5,13
2014,5,8,3,5,0,53,53
2014,5,8,3,6,12,225,237
2014,5,8,3,7,16,616,632
2014,5,8,3,8,48,936,984
2014,5,8,3,9,70,418,488
2014,5,8,3,10,57,203,260
2014,5,8,3,11,92,244,336
2014,5,8,3,12,103,353,456
2014,5,8,3,13,127,315,442
2014,5,8,3,14,134,259,393
2014,5,8,3,15,101,321,422
2014,5,8,3,16,108,534,642
2014,5,8,3,17,149,1157,1306
2014,5,8,3,18,138,1089,1227
2014,5,8,3,19,127,766,893
2014,5,8,3,20,91,502,593
2014,5,8,3,21,53,406,459
2014,5,8,3,22,72,294,366
2014,5,8,3,23,33,183,216
2014,5,9,4,0,24,79,103
2014,5,9,4,1,9,42,51
2014,5,9,4,2,7,14,21
2014,5,9,4,3,2,11,13
2014,5,9,4,4,0,8,8
2014,5,9,4,5,1,50,51
2014,5,9,4,6,12,212,224
2014,5,9,4,7,14,548,562
2014,5,9,4,8,36,935,971
2014,5,9,4,9,59,411,470
2014,5,9,4,10,90,202,292
2014,5,9,4,11,149,284,433
2014,5,9,4,12,183,403,586
2014,5,9,4,13,168,363,531
2014,5,9,4,14,185,364,549
2014,5,9,4,15,226,438,664
2014,5,9,4,16,194,574,768
2014,5,9,4,17,193,989,1182
2014,5,9,4,18,135,871,1006
2014,5,9,4,19,88,555,643
2014,5,9,4,20,80,389,469
2014,5,9,4,21,61,310,371
2014,5,9,4,22,50,274,324
2014,5,9,4,23,42,205,247
2014,5,10,5,0,10,149,159
2014,5,10,5,1,12,117,129
2014,5,10,5,2,11,63,74
2014,5,10,5,3,12,25,37
2014,5,10,5,4,3,12,15
2014,5,10,5,5,3,15,18
2014,5,10,5,6,8,48,56
2014,5,10,5,7,18,120,138
2014,5,10,5,8,44,252,296
2014,5,10,5,9,106,370,476
2014,5,10,5,10,262,472,734
2014,5,10,5,11,265,479,744
2014,5,10,5,12,215,415,630
2014,5,10,5,13,125,251,376
2014,5,10,5,14,190,385,575
2014,5,10,5,15,226,349,575
2014,5,10,5,16,174,226,400
2014,5,10,5,17,205,375,580
2014,5,10,5,18,246,388,634
2014,5,10,5,19,180,383,563
2014,5,10,5,20,86,241,327
2014,5,10,5,21,58,235,293
2014,5,10,5,22,58,205,263
2014,5,10,5,23,73,164,237
2014,5,11,6,0,23,121,144
2014,5,11,6,1,24,113,137
2014,5,11,6,2,14,106,120
2014,5,11,6,3,9,38,47
2014,5,11,6,4,2,9,11
2014,5,11,6,5,0,11,11
2014,5,11,6,6,7,27,34
2014,5,11,6,7,22,78,100
2014,5,11,6,8,71,178,249
2014,5,11,6,9,127,317,444
2014,5,11,6,10,229,440,669
2014,5,11,6,11,286,525,811
2014,5,11,6,12,354,542,896
2014,5,11,6,13,424,529,953
2014,5,11,6,14,405,513,918
2014,5,11,6,15,462,522,984
2014,5,11,6,16,385,556,941
2014,5,11,6,17,371,507,878
2014,5,11,6,18,260,527,787
2014,5,11,6,19,220,456,676
2014,5,11,6,20,169,338,507
2014,5,11,6,21,141,195,336
2014,5,11,6,22,76,179,255
2014,5,11,6,23,42,142,184
2014,5,12,0,0,17,34,51
2014,5,12,0,1,7,16,23
2014,5,12,0,2,1,13,14
2014,5,12,0,3,2,7,9
2014,5,12,0,4,0,7,7
2014,5,12,0,5,0,61,61
2014,5,12,0,6,4,226,230
2014,5,12,0,7,23,633,656
2014,5,12,0,8,64,907,971
2014,5,12,0,9,83,382,465
2014,5,12,0,10,116,191,307
2014,5,12,0,11,146,223,369
2014,5,12,0,12,154,293,447
2014,5,12,0,13,154,276,430
2014,5,12,0,14,151,245,396
2014,5,12,0,15,123,283,406
2014,5,12,0,16,158,496,654
2014,5,12,0,17,162,1018,1180
2014,5,12,0,18,121,1006,1127
2014,5,12,0,19,125,634,759
2014,5,12,0,20,50,270,320
2014,5,12,0,21,31,274,305
2014,5,12,0,22,29,188,217
2014,5,12,0,23,16,96,112
2014,5,13,1,0,8,31,39
2014,5,13,1,1,13,13,26
2014,5,13,1,2,9,11,20
2014,5,13,1,3,0,4,4
2014,5,13,1,4,0,9,9
2014,5,13,1,5,1,76,77
2014,5,13,1,6,6,263,269
2014,5,13,1,7,29,733,762
2014,5,13,1,8,48,935,983
2014,5,13,1,9,62,407,469
2014,5,13,1,10,104,174,278
2014,5,13,1,11,98,206,304
2014,5,13,1,12,128,302,430
2014,5,13,1,13,186,334,520
2014,5,13,1,14,128,220,348
2014,5,13,1,15,119,244,363
2014,5,13,1,16,127,479,606
2014,5,13,1,17,145,1061,1206
2014,5,13,1,18,159,1007,1166
2014,5,13,1,19,115,724,839
2014,5,13,1,20,93,485,578
2014,5,13,1,21,30,338,368
2014,5,13,1,22,31,230,261
2014,5,13,1,23,22,99,121
2014,5,14,2,0,5,49,54
2014,5,14,2,1,7,27,34
2014,5,14,2,2,2,10,12
2014,5,14,2,3,0,3,3
2014,5,14,2,4,1,7,8
2014,5,14,2,5,3,61,64
2014,5,14,2,6,9,238,247
2014,5,14,2,7,29,629,658
2014,5,14,2,8,57,935,992
2014,5,14,2,9,61,449,510
2014,5,14,2,10,94,210,304
2014,5,14,2,11,106,226,332
2014,5,14,2,12,110,289,399
2014,5,14,2,13,131,306,437
2014,5,14,2,14,147,282,429
2014,5,14,2,15,114,300,414
2014,5,14,2,16,144,523,667
2014,5,14,2,17,142,1057,1199
2014,5,14,2,18,123,974,1097
2014,5,14,2,19,92,612,704
2014,5,14,2,20,55,436,491
2014,5,14,2,21,53,296,349
2014,5,14,2,22,28,246,274
2014,5,14,2,23,20,117,137
2014,5,15,3,0,6,34,40
2014,5,15,3,1,16,27,43
2014,5,15,3,2,4,12,16
2014,5,15,3,3,14,2,16
2014,5,15,3,4,2,7,9
2014,5,15,3,5,1,48,49
2014,5,15,3,6,15,262,277
2014,5,15,3,7,26,686,712
2014,5,15,3,8,47,992,1039
2014,5,15,3,9,47,443,490
2014,5,15,3,10,99,194,293
2014,5,15,3,11,124,242,366
2014,5,15,3,12,95,292,387
2014,5,15,3,13,119,298,417
2014,5,15,3,14,154,253,407
2014,5,15,3,15,140,334,474
2014,5,15,3,16,146,582,728
2014,5,15,3,17,167,1056,1223
2014,5,15,3,18,106,783,889
2014,5,15,3,19,71,567,638
2014,5,15,3,20,57,372,429
2014,5,15,3,21,36,312,348
2014,5,15,3,22,13,87,100
2014,5,15,3,23,13,84,97
2014,5,16,4,0,0,37,37
2014,5,16,4,1,0,7,7
2014,5,16,4,2,1,4,5
2014,5,16,4,3,0,4,4
2014,5,16,4,4,0,3,3
2014,5,16,4,5,0,14,14
2014,5,16,4,6,2,23,25
2014,5,16,4,7,9,91,100
2014,5,16,4,8,8,164,172
2014,5,16,4,9,26,319,345
2014,5,16,4,10,21,186,207
2014,5,16,4,11,54,236,290
2014,5,16,4,12,103,340,443
2014,5,16,4,13,143,344,487
2014,5,16,4,14,122,347,469
2014,5,16,4,15,175,361,536
2014,5,16,4,16,199,589,788
2014,5,16,4,17,173,958,1131
2014,5,16,4,18,158,830,988
2014,5,16,4,19,97,582,679
2014,5,16,4,20,99,404,503
2014,5,16,4,21,79,321,400
2014,5,16,4,22,46,216,262
2014,5,16,4,23,33,189,222
2014,5,17,5,0,26,112,138
2014,5,17,5,1,17,107,124
2014,5,17,5,2,12,72,84
2014,5,17,5,3,5,26,31
2014,5,17,5,4,7,10,17
2014,5,17,5,5,1,12,13
2014,5,17,5,6,5,38,43
2014,5,17,5,7,16,107,123
2014,5,17,5,8,57,229,286
2014,5,17,5,9,125,320,445
2014,5,17,5,10,197,411,608
2014,5,17,5,11,304,468,772
2014,5,17,5,12,372,564,936
2014,5,17,5,13,435,558,993
2014,5,17,5,14,450,546,996
2014,5,17,5,15,486,577,1063
2014,5,17,5,16,414,521,935
2014,5,17,5,17,386,471,857
2014,5,17,5,18,292,478,770
2014,5,17,5,19,214,440,654
2014,5,17,5,20,160,299,459
2014,5,17,5,21,127,295,422
2014,5,17,5,22,89,240,329
2014,5,17,5,23,57,179,236
2014,5,18,6,0,30,146,176
2014,5,18,6,1,17,116,133
2014,5,18,6,2,12,80,92
2014,5,18,6,3,10,50,60
2014,5,18,6,4,4,11,15
2014,5,18,6,5,9,12,21
2014,5,18,6,6,4,28,32
2014,5,18,6,7,19,79,98
2014,5,18,6,8,48,174,222
2014,5,18,6,9,131,289,420
2014,5,18,6,10,208,425,633
2014,5,18,6,11,316,465,781
2014,5,18,6,12,344,627,971
2014,5,18,6,13,400,574,974
2014,5,18,6,14,371,524,895
2014,5,18,6,15,382,489,871
2014,5,18,6,16,326,531,857
2014,5,18,6,17,329,514,843
2014,5,18,6,18,200,481,681
2014,5,18,6,19,157,364,521
2014,5,18,6,20,100,313,413
2014,5,18,6,21,89,192,281
2014,5,18,6,22,71,155,226
2014,5,18,6,23,32,80,112
2014,5,19,0,0,13,33,46
2014,5,19,0,1,1,10,11
2014,5,19,0,2,4,9,13
2014,5,19,0,3,0,2,2
2014,5,19,0,4,0,7,7
2014,5,19,0,5,8,55,63
2014,5,19,0,6,10,202,212
2014,5,19,0,7,40,644,684
2014,5,19,0,8,48,856,904
2014,5,19,0,9,84,335,419
2014,5,19,0,10,159,206,365
2014,5,19,0,11,173,218,391
2014,5,19,0,12,146,319,465
2014,5,19,0,13,172,329,501
2014,5,19,0,14,195,295,490
2014,5,19,0,15,171,335,506
2014,5,19,0,16,171,538,709
2014,5,19,0,17,229,1105,1334
2014,5,19,0,18,163,1014,1177
2014,5,19,0,19,130,678,808
2014,5,19,0,20,80,507,587
2014,5,19,0,21,67,368,435
2014,5,19,0,22,41,212,253
2014,5,19,0,23,34,118,152
2014,5,20,1,0,16,48,64
2014,5,20,1,1,3,19,22
2014,5,20,1,2,0,6,6
2014,5,20,1,3,2,6,8
2014,5,20,1,4,0,5,5
2014,5,20,1,5,4,70,74
2014,5,20,1,6,13,247,260
2014,5,20,1,7,28,723,751
2014,5,20,1,8,50,1052,1102
2014,5,20,1,9,65,412,477
2014,5,20,1,10,100,182,282
2014,5,20,1,11,129,205,334
2014,5,20,1,12,146,343,489
2014,5,20,1,13,158,341,499
2014,5,20,1,14,117,302,419
2014,5,20,1,15,130,326,456
2014,5,20,1,16,173,572,745
2014,5,20,1,17,217,1069,1286
2014,5,20,1,18,194,1032,1226
2014,5,20,1,19,170,655,825
2014,5,20,1,20,137,491,628
2014,5,20,1,21,107,387,494
2014,5,20,1,22,81,267,348
2014,5,20,1,23,27,129,156
2014,5,21,2,0,17,51,68
2014,5,21,2,1,6,11,17
2014,5,21,2,2,4,9,13
2014,5,21,2,3,0,4,4
2014,5,21,2,4,5,9,14
2014,5,21,2,5,2,66,68
2014,5,21,2,6,15,254,269
2014,5,21,2,7,33,694,727
2014,5,21,2,8,48,960,1008
2014,5,21,2,9,58,437,495
2014,5,21,2,10,58,214,272
2014,5,21,2,11,100,240,340
2014,5,21,2,12,105,282,387
2014,5,21,2,13,110,310,420
2014,5,21,2,14,93,278,371
2014,5,21,2,15,119,366,485
2014,5,21,2,16,138,539,677
2014,5,21,2,17,116,753,869
2014,5,21,2,18,50,439,489
2014,5,21,2,19,75,485,560
2014,5,21,2,20,69,462,531
2014,5,21,2,21,32,195,227
2014,5,21,2,22,32,154,186
2014,5,21,2,23,16,88,104
2014,5,22,3,0,8,50,58
2014,5,22,3,1,22,18,40
2014,5,22,3,2,6,14,20
2014,5,22,3,3,0,7,7
2014,5,22,3,4,0,9,9
2014,5,22,3,5,0,48,48
2014,5,22,3,6,7,157,164
2014,5,22,3,7,25,563,588
2014,5,22,3,8,45,1003,1048
2014,5,22,3,9,65,438,503
2014,5,22,3,10,119,216,335
2014,5,22,3,11,157,227,384
2014,5,22,3,12,166,348,514
2014,5,22,3,13,126,323,449
2014,5,22,3,14,104,287,391
2014,5,22,3,15,117,324,441
2014,5,22,3,16,163,506,669
2014,5,22,3,17,149,1072,1221
2014,5,22,3,18,148,968,1116
2014,5,22,3,19,135,655,790
2014,5,22,3,20,102,523,625
2014,5,22,3,21,84,408,492
2014,5,22,3,22,56,283,339
2014,5,22,3,23,42,157,199
2014,5,23,4,0,36,77,113
2014,5,23,4,1,16,47,63
2014,5,23,4,2,6,19,25
2014,5,23,4,3,5,10,15
2014,5,23,4,4,1,6,7
2014,5,23,4,5,0,53,53
2014,5,23,4,6,5,178,183
2014,5,23,4,7,28,563,591
2014,5,23,4,8,63,846,909
2014,5,23,4,9,88,467,555
2014,5,23,4,10,112,248,360
2014,5,23,4,11,156,308,464
2014,5,23,4,12,185,358,543
2014,5,23,4,13,165,417,582
2014,5,23,4,14,179,482,661
2014,5,23,4,15,229,625,854
2014,5,23,4,16,195,669,864
2014,5,23,4,17,197,763,960
2014,5,23,4,18,148,678,826
2014,5,23,4,19,146,567,713
2014,5,23,4,20,84,356,440
2014,5,23,4,21,57,247,304
2014,5,23,4,22,46,195,241
2014,5,23,4,23,31,175,206
2014,5,24,5,0,22,99,121
2014,5,24,5,1,7,75,82
2014,5,24,5,2,5,36,41
2014,5,24,5,3,16,11,27
2014,5,24,5,4,0,12,12
2014,5,24,5,5,7,10,17
2014,5,24,5,6,11,34,45
2014,5,24,5,7,21,83,104
2014,5,24,5,8,54,169,223
2014,5,24,5,9,132,297,429
2014,5,24,5,10,231,324,555
2014,5,24,5,11,369,392,761
2014,5,24,5,12,509,413,922
2014,5,24,5,13,485,454,939
2014,5,24,5,14,524,425,949
2014,5,24,5,15,526,407,933
2014,5,24,5,16,479,381,860
2014,5,24,5,17,449,379,828
2014,5,24,5,18,438,368,806
2014,5,24,5,19,323,311,634
2014,5,24,5,20,225,283,508
2014,5,24,5,21,136,212,348
2014,5,24,5,22,110,191,301
2014,5,24,5,23,63,136,199
2014,5,25,6,0,39,109,148
2014,5,25,6,1,23,62,85
2014,5,25,6,2,7,37,44
2014,5,25,6,3,1,20,21
2014,5,25,6,4,4,8,12
2014,5,25,6,5,1,7,8
2014,5,25,6,6,10,21,31
2014,5,25,6,7,32,54,86
2014,5,25,6,8,105,136,241
2014,5,25,6,9,263,247,510
2014,5,25,6,10,408,323,731
2014,5,25,6,11,531,391,922
2014,5,25,6,12,509,452,961
2014,5,25,6,13,562,444,1006
2014,5,25,6,14,565,458,1023
2014,5,25,6,15,638,426,1064
2014,5,25,6,16,645,376,1021
2014,5,25,6,17,500,377,877
2014,5,25,6,18,520,345,865
2014,5,25,6,19,433,350,783
2014,5,25,6,20,321,259,580
2014,5,25,6,21,277,246,523
2014,5,25,6,22,207,164,371
2014,5,25,6,23,144,149,293
2014,5,26,0,0,77,119,196
2014,5,26,0,1,47,74,121
2014,5,26,0,2,13,45,58
2014,5,26,0,3,1,17,18
2014,5,26,0,4,1,8,9
2014,5,26,0,5,2,18,20
2014,5,26,0,6,16,28,44
2014,5,26,0,7,36,60,96
2014,5,26,0,8,85,114,199
2014,5,26,0,9,224,217,441
2014,5,26,0,10,389,328,717
2014,5,26,0,11,468,385,853
2014,5,26,0,12,474,492,966
2014,5,26,0,13,507,479,986
2014,5,26,0,14,425,417,842
2014,5,26,0,15,506,402,908
2014,5,26,0,16,415,491,906
2014,5,26,0,17,333,434,767
2014,5,26,0,18,337,401,738
2014,5,26,0,19,243,389,632
2014,5,26,0,20,181,363,544
2014,5,26,0,21,156,269,425
2014,5,26,0,22,46,127,173
2014,5,26,0,23,48,102,150
2014,5,27,1,0,13,27,40
2014,5,27,1,1,5,25,30
2014,5,27,1,2,1,11,12
2014,5,27,1,3,1,5,6
2014,5,27,1,4,1,6,7
2014,5,27,1,5,4,54,58
2014,5,27,1,6,11,243,254
2014,5,27,1,7,35,675,710
2014,5,27,1,8,71,904,975
2014,5,27,1,9,94,407,501
2014,5,27,1,10,135,181,316
2014,5,27,1,11,185,224,409
2014,5,27,1,12,159,302,461
2014,5,27,1,13,106,313,419
2014,5,27,1,14,138,237,375
2014,5,27,1,15,141,302,443
2014,5,27,1,16,141,480,621
2014,5,27,1,17,202,1078,1280
2014,5,27,1,18,86,545,631
2014,5,27,1,19,22,67,89
2014,5,27,1,20,22,198,220
2014,5,27,1,21,33,210,243
2014,5,27,1,22,18,129,147
2014,5,27,1,23,8,72,80
2014,5,28,2,0,3,27,30
2014,5,28,2,1,0,11,11
2014,5,28,2,2,0,8,8
2014,5,28,2,3,6,1,7
2014,5,28,2,4,2,9,11
2014,5,28,2,5,3,58,61
2014,5,28,2,6,10,268,278
2014,5,28,2,7,36,744,780
2014,5,28,2,8,49,916,965
2014,5,28,2,9,56,421,477
2014,5,28,2,10,100,201,301
2014,5,28,2,11,146,212,358
2014,5,28,2,12,113,320,433
2014,5,28,2,13,130,301,431
2014,5,28,2,14,109,268,377
2014,5,28,2,15,80,298,378
2014,5,28,2,16,114,437,551
2014,5,28,2,17,153,1077,1230
2014,5,28,2,18,124,1063,1187
2014,5,28,2,19,105,722,827
2014,5,28,2,20,66,533,599
2014,5,28,2,21,36,292,328
2014,5,28,2,22,34,218,252
2014,5,28,2,23,25,125,150
2014,5,29,3,0,11,44,55
2014,5,29,3,1,1,16,17
2014,5,29,3,2,1,3,4
2014,5,29,3,4,0,5,5
2014,5,29,3,5,4,46,50
2014,5,29,3,6,15,137,152
2014,5,29,3,7,28,340,368
2014,5,29,3,8,31,729,760
2014,5,29,3,9,50,377,427
2014,5,29,3,10,33,185,218
2014,5,29,3,11,51,170,221
2014,5,29,3,12,40,192,232
2014,5,29,3,13,25,120,145
2014,5,29,3,14,25,78,103
2014,5,29,3,15,11,54,65
2014,5,29,3,16,29,109,138
2014,5,29,3,17,29,443,472
2014,5,29,3,18,34,486,520
2014,5,29,3,19,49,485,534
2014,5,29,3,20,28,334,362
2014,5,29,3,21,36,263,299
2014,5,29,3,22,12,137,149
2014,5,29,3,23,5,65,70
2014,5,30,4,0,1,47,48
2014,5,30,4,1,3,17,20
2014,5,30,4,2,2,8,10
2014,5,30,4,3,1,4,5
2014,5,30,4,4,0,6,6
2014,5,30,4,5,4,48,52
2014,5,30,4,6,8,175,183
2014,5,30,4,7,20,560,580
2014,5,30,4,8,31,921,952
2014,5,30,4,9,51,434,485
2014,5,30,4,10,90,223,313
2014,5,30,4,11,142,278,420
2014,5,30,4,12,156,383,539
2014,5,30,4,13,156,375,531
2014,5,30,4,14,173,356,529
2014,5,30,4,15,175,374,549
2014,5,30,4,16,171,654,825
2014,5,30,4,17,190,1074,1264
2014,5,30,4,18,168,917,1085
2014,5,30,4,19,150,670,820
2014,5,30,4,20,98,453,551
2014,5,30,4,21,68,395,463
2014,5,30,4,22,82,335,417
2014,5,30,4,23,74,209,283
2014,5,31,5,0,44,156,200
2014,5,31,5,1,21,115,136
2014,5,31,5,2,23,85,108
2014,5,31,5,3,7,44,51
2014,5,31,5,4,1,17,18
2014,5,31,5,5,3,10,13
2014,5,31,5,6,11,42,53
2014,5,31,5,7,20,110,130
2014,5,31,5,8,60,250,310
2014,5,31,5,9,130,373,503
2014,5,31,5,10,233,515,748
2014,5,31,5,11,264,561,825
2014,5,31,5,12,385,556,941
2014,5,31,5,13,408,587,995
2014,5,31,5,14,504,571,1075
2014,5,31,5,15,456,611,1067
2014,5,31,5,16,398,534,932
2014,5,31,5,17,427,546,973
2014,5,31,5,18,371,486,857
2014,5,31,5,19,260,423,683
2014,5,31,5,20,194,381,575
2014,5,31,5,21,150,281,431
2014,5,31,5,22,107,240,347
2014,5,31,5,23,49,189,238
2014,6,1,6,0,32,180,212
2014,6,1,6,1,18,94,112
2014,6,1,6,2,15,77,92
2014,6,1,6,3,18,38,56
2014,6,1,6,4,8,8,16
2014,6,1,6,5,0,10,10
2014,6,1,6,6,12,19,31
2014,6,1,6,7,28,66,94
2014,6,1,6,8,75,163,238
2014,6,1,6,9,166,316,482
2014,6,1,6,10,206,483,689
2014,6,1,6,11,268,552,820
2014,6,1,6,12,363,594,957
2014,6,1,6,13,384,589,973
2014,6,1,6,14,403,538,941
2014,6,1,6,15,332,557,889
2014,6,1,6,16,342,612,954
2014,6,1,6,17,309,561,870
2014,6,1,6,18,242,530,772
2014,6,1,6,19,193,445,638
2014,6,1,6,20,178,362,540
2014,6,1,6,21,98,241,339
2014,6,1,6,22,67,165,232
2014,6,1,6,23,29,89,118
2014,6,2,0,0,17,27,44
2014,6,2,0,1,3,9,12
2014,6,2,0,2,9,10,19
2014,6,2,0,3,1,2,3
2014,6,2,0,4,1,5,6
2014,6,2,0,5,3,70,73
2014,6,2,0,6,12,254,266
2014,6,2,0,7,33,678,711
2014,6,2,0,8,57,963,1020
2014,6,2,0,9,72,383,455
2014,6,2,0,10,109,177,286
2014,6,2,0,11,144,214,358
2014,6,2,0,12,164,319,483
2014,6,2,0,13,135,306,441
2014,6,2,0,14,152,288,440
2014,6,2,0,15,141,316,457
2014,6,2,0,16,142,519,661
2014,6,2,0,17,181,1168,1349
2014,6,2,0,18,174,1081,1255
2014,6,2,0,19,117,680,797
2014,6,2,0,20,66,460,526
2014,6,2,0,21,58,375,433
2014,6,2,0,22,40,203,243
2014,6,2,0,23,32,96,128
2014,6,3,1,0,23,36,59
2014,6,3,1,1,1,15,16
2014,6,3,1,2,1,11,12
2014,6,3,1,3,0,3,3
2014,6,3,1,4,1,5,6
2014,6,3,1,5,3,66,69
2014,6,3,1,6,19,292,311
2014,6,3,1,7,26,792,818
2014,6,3,1,8,53,1030,1083
2014,6,3,1,9,60,426,486
2014,6,3,1,10,97,213,310
2014,6,3,1,11,109,259,368
2014,6,3,1,12,97,341,438
2014,6,3,1,13,84,187,271
2014,6,3,1,14,66,137,203
2014,6,3,1,15,107,284,391
2014,6,3,1,16,118,500,618
2014,6,3,1,17,160,1100,1260
2014,6,3,1,18,170,1128,1298
2014,6,3,1,19,113,722,835
2014,6,3,1,20,109,494,603
2014,6,3,1,21,85,437,522
2014,6,3,1,22,80,287,367
2014,6,3,1,23,36,136,172
2014,6,4,2,0,15,69,84
2014,6,4,2,1,0,18,18
2014,6,4,2,2,0,6,6
2014,6,4,2,3,3,4,7
2014,6,4,2,4,7,4,11
2014,6,4,2,5,9,69,78
2014,6,4,2,6,20,288,308
2014,6,4,2,7,38,779,817
2014,6,4,2,8,49,1013,1062
2014,6,4,2,9,69,485,554
2014,6,4,2,10,97,215,312
2014,6,4,2,11,112,242,354
2014,6,4,2,12,96,307,403
2014,6,4,2,13,110,271,381
2014,6,4,2,14,132,307,439
2014,6,4,2,15,108,318,426
2014,6,4,2,16,121,566,687
2014,6,4,2,17,147,1176,1323
2014,6,4,2,18,142,1098,1240
2014,6,4,2,19,121,706,827
2014,6,4,2,20,66,467,533
2014,6,4,2,21,22,174,196
2014,6,4,2,22,9,89,98
2014,6,4,2,23,18,94,112
2014,6,5,3,0,9,32,41
2014,6,5,3,1,5,14,19
2014,6,5,3,2,6,6,12
2014,6,5,3,3,3,1,4
2014,6,5,3,4,0,8,8
2014,6,5,3,5,2,45,47
2014,6,5,3,6,9,244,253
2014,6,5,3,7,29,592,621
2014,6,5,3,8,42,989,1031
2014,6,5,3,9,51,477,528
2014,6,5,3,10,69,201,270
2014,6,5,3,11,84,260,344
2014,6,5,3,12,97,355,452
2014,6,5,3,13,91,332,423
2014,6,5,3,14,119,298,417
2014,6,5,3,15,113,403,516
2014,6,5,3,16,111,573,684
2014,6,5,3,17,168,1096,1264
2014,6,5,3,18,138,1083,1221
2014,6,5,3,19,119,752,871
2014,6,5,3,20,121,623,744
2014,6,5,3,21,68,459,527
2014,6,5,3,22,41,299,340
2014,6,5,3,23,23,194,217
2014,6,6,4,0,17,93,110
2014,6,6,4,1,3,39,42
2014,6,6,4,2,3,14,17
2014,6,6,4,3,2,4,6
2014,6,6,4,4,2,3,5
2014,6,6,4,5,6,57,63
2014,6,6,4,6,9,227,236
2014,6,6,4,7,38,691,729
2014,6,6,4,8,64,995,1059
2014,6,6,4,9,85,527,612
2014,6,6,4,10,74,265,339
2014,6,6,4,11,113,286,399
2014,6,6,4,12,164,391,555
2014,6,6,4,13,180,419,599
2014,6,6,4,14,181,436,617
2014,6,6,4,15,141,438,579
2014,6,6,4,16,202,722,924
2014,6,6,4,17,199,1164,1363
2014,6,6,4,18,151,896,1047
2014,6,6,4,19,129,688,817
2014,6,6,4,20,135,496,631
2014,6,6,4,21,126,330,456
2014,6,6,4,22,86,327,413
2014,6,6,4,23,74,264,338
2014,6,7,5,0,49,160,209
2014,6,7,5,1,20,128,148
2014,6,7,5,2,21,92,113
2014,6,7,5,3,14,40,54
2014,6,7,5,4,4,11,15
2014,6,7,5,5,7,17,24
2014,6,7,5,6,14,42,56
2014,6,7,5,7,25,118,143
2014,6,7,5,8,58,222,280
2014,6,7,5,9,132,379,511
2014,6,7,5,10,238,494,732
2014,6,7,5,11,374,584,958
2014,6,7,5,12,341,597,938
2014,6,7,5,13,384,619,1003
2014,6,7,5,14,425,595,1020
2014,6,7,5,15,364,538,902
2014,6,7,5,16,323,499,822
2014,6,7,5,17,319,456,775
2014,6,7,5,18,271,408,679
2014,6,7,5,19,274,508,782
2014,6,7,5,20,219,384,603
2014,6,7,5,21,167,295,462
2014,6,7,5,22,130,307,437
2014,6,7,5,23,104,232,336
2014,6,8,6,0,85,178,263
2014,6,8,6,1,38,113,151
2014,6,8,6,2,30,100,130
2014,6,8,6,3,21,37,58
2014,6,8,6,4,6,10,16
2014,6,8,6,5,1,13,14
2014,6,8,6,6,9,19,28
2014,6,8,6,7,26,74,100
2014,6,8,6,8,70,163,233
2014,6,8,6,9,154,275,429
2014,6,8,6,10,254,410,664
2014,6,8,6,11,308,515,823
2014,6,8,6,12,377,579,956
2014,6,8,6,13,370,593,963
2014,6,8,6,14,364,551,915
2014,6,8,6,15,345,574,919
2014,6,8,6,16,306,557,863
2014,6,8,6,17,292,530,822
2014,6,8,6,18,245,549,794
2014,6,8,6,19,234,401,635
2014,6,8,6,20,143,300,443
2014,6,8,6,21,96,196,292
2014,6,8,6,22,54,122,176
2014,6,8,6,23,16,37,53
2014,6,9,0,0,1,5,6
2014,6,9,0,1,1,5,6
2014,6,9,0,2,0,8,8
2014,6,9,0,3,0,5,5
2014,6,9,0,4,2,6,8
2014,6,9,0,5,1,56,57
2014,6,9,0,6,11,265,276
2014,6,9,0,7,38,667,705
2014,6,9,0,8,53,947,1000
2014,6,9,0,9,101,405,506
2014,6,9,0,10,116,190,306
2014,6,9,0,11,167,243,410
2014,6,9,0,12,164,288,452
2014,6,9,0,13,176,279,455
2014,6,9,0,14,148,268,416
2014,6,9,0,15,156,290,446
2014,6,9,0,16,145,497,642
2014,6,9,0,17,179,1156,1335
2014,6,9,0,18,154,1054,1208
2014,6,9,0,19,141,735,876
2014,6,9,0,20,97,550,647
2014,6,9,0,21,76,379,455
2014,6,9,0,22,52,215,267
2014,6,9,0,23,25,106,131
2014,6,10,1,0,8,35,43
2014,6,10,1,1,1,17,18
2014,6,10,1,2,3,3,6
2014,6,10,1,3,3,3,6
2014,6,10,1,4,0,10,10
2014,6,10,1,5,7,71,78
2014,6,10,1,6,15,255,270
2014,6,10,1,7,41,751,792
2014,6,10,1,8,42,907,949
2014,6,10,1,9,39,349,388
2014,6,10,1,10,66,155,221
2014,6,10,1,11,93,160,253
2014,6,10,1,12,78,194,272
2014,6,10,1,13,63,191,254
2014,6,10,1,14,108,212,320
2014,6,10,1,15,104,272,376
2014,6,10,1,16,117,548,665
2014,6,10,1,17,163,1074,1237
2014,6,10,1,18,149,961,1110
2014,6,10,1,19,106,656,762
2014,6,10,1,20,72,549,621
2014,6,10,1,21,96,353,449
2014,6,10,1,22,66,268,334
2014,6,10,1,23,30,155,185
2014,6,11,2,0,23,43,66
2014,6,11,2,1,6,16,22
2014,6,11,2,2,4,9,13
2014,6,11,2,3,1,1,2
2014,6,11,2,4,1,9,10
2014,6,11,2,5,2,66,68
2014,6,11,2,6,8,103,111
2014,6,11,2,7,20,451,471
2014,6,11,2,8,39,1000,1039
2014,6,11,2,9,48,452,500
2014,6,11,2,10,62,246,308
2014,6,11,2,11,87,261,348
2014,6,11,2,12,103,326,429
2014,6,11,2,13,95,309,404
2014,6,11,2,14,87,245,332
2014,6,11,2,15,131,325,456
2014,6,11,2,16,126,535,661
2014,6,11,2,17,139,1176,1315
2014,6,11,2,18,109,876,985
2014,6,11,2,19,65,593,658
2014,6,11,2,20,38,274,312
2014,6,11,2,21,9,55,64
2014,6,11,2,22,2,91,93
2014,6,11,2,23,9,58,67
2014,6,12,3,0,2,44,46
2014,6,12,3,1,2,11,13
2014,6,12,3,2,4,3,7
2014,6,12,3,3,0,2,2
2014,6,12,3,4,1,5,6
2014,6,12,3,5,1,51,52
2014,6,12,3,6,11,196,207
2014,6,12,3,7,17,565,582
2014,6,12,3,8,39,928,967
2014,6,12,3,9,45,389,434
2014,6,12,3,10,60,218,278
2014,6,12,3,11,84,237,321
2014,6,12,3,12,94,309,403
2014,6,12,3,13,82,318,400
2014,6,12,3,14,87,244,331
2014,6,12,3,15,65,238,303
2014,6,12,3,16,55,367,422
2014,6,12,3,17,115,934,1049
2014,6,12,3,18,122,984,1106
2014,6,12,3,19,97,682,779
2014,6,12,3,20,80,557,637
2014,6,12,3,21,51,415,466
2014,6,12,3,22,35,252,287
2014,6,12,3,23,18,198,216
2014,6,13,4,0,21,88,109
2014,6,13,4,1,5,41,46
2014,6,13,4,2,4,15,19
2014,6,13,4,3,1,2,3
2014,6,13,4,4,2,5,7
2014,6,13,4,5,5,61,66
2014,6,13,4,6,10,240,250
2014,6,13,4,7,17,594,611
2014,6,13,4,8,60,1013,1073
2014,6,13,4,9,89,517,606
2014,6,13,4,10,108,252,360
2014,6,13,4,11,121,273,394
2014,6,13,4,12,167,367,534
2014,6,13,4,13,80,225,305
2014,6,13,4,14,43,135,178
2014,6,13,4,15,95,356,451
2014,6,13,4,16,140,496,636
2014,6,13,4,17,163,1054,1217
2014,6,13,4,18,85,684,769
2014,6,13,4,19,98,512,610
2014,6,13,4,20,68,417,485
2014,6,13,4,21,54,299,353
2014,6,13,4,22,50,229,279
2014,6,13,4,23,36,193,229
2014,6,14,5,0,26,143,169
2014,6,14,5,1,18,89,107
2014,6,14,5,2,13,54,67
2014,6,14,5,3,3,31,34
2014,6,14,5,4,4,10,14
2014,6,14,5,5,3,10,13
2014,6,14,5,6,15,80,95
2014,6,14,5,7,34,160,194
2014,6,14,5,8,77,230,307
2014,6,14,5,9,139,427,566
2014,6,14,5,10,204,467,671
2014,6,14,5,11,333,531,864
2014,6,14,5,12,334,550,884
2014,6,14,5,13,365,526,891
2014,6,14,5,14,438,603,1041
2014,6,14,5,15,431,559,990
2014,6,14,5,16,387,545,932
2014,6,14,5,17,419,609,1028
2014,6,14,5,18,302,441,743
2014,6,14,5,19,226,374,600
2014,6,14,5,20,240,457,697
2014,6,14,5,21,128,336,464
2014,6,14,5,22,99,243,342
2014,6,14,5,23,80,253,333
2014,6,15,6,0,30,145,175
2014,6,15,6,1,18,100,118
2014,6,15,6,2,22,77,99
2014,6,15,6,3,9,36,45
2014,6,15,6,4,1,11,12
2014,6,15,6,5,1,12,13
2014,6,15,6,6,10,28,38
2014,6,15,6,7,26,68,94
2014,6,15,6,8,61,188,249
2014,6,15,6,9,151,303,454
2014,6,15,6,10,223,427,650
2014,6,15,6,11,305,572,877
2014,6,15,6,12,370,604,974
2014,6,15,6,13,403,520,923
2014,6,15,6,14,407,573,980
2014,6,15,6,15,428,527,955
2014,6,15,6,16,315,594,909
2014,6,15,6,17,298,576,874
2014,6,15,6,18,251,476,727
2014,6,15,6,19,244,373,617
2014,6,15,6,20,183,421,604
2014,6,15,6,21,91,255,346
2014,6,15,6,22,86,204,290
2014,6,15,6,23,50,114,164
2014,6,16,0,0,21,42,63
2014,6,16,0,1,5,15,20
2014,6,16,0,2,0,2,2
2014,6,16,0,3,0,2,2
2014,6,16,0,4,2,10,12
2014,6,16,0,5,4,64,68
2014,6,16,0,6,10,263,273
2014,6,16,0,7,35,662,697
2014,6,16,0,8,72,934,1006
2014,6,16,0,9,61,402,463
2014,6,16,0,10,160,217,377
2014,6,16,0,11,160,225,385
2014,6,16,0,12,115,275,390
2014,6,16,0,13,131,272,403
2014,6,16,0,14,144,263,407
2014,6,16,0,15,124,296,420
2014,6,16,0,16,162,552,714
2014,6,16,0,17,158,1311,1469
2014,6,16,0,18,122,914,1036
2014,6,16,0,19,121,510,631
2014,6,16,0,20,147,715,862
2014,6,16,0,21,96,412,508
2014,6,16,0,22,57,227,284
2014,6,16,0,23,16,116,132
2014,6,17,1,0,7,36,43
2014,6,17,1,1,1,15,16
2014,6,17,1,2,1,5,6
2014,6,17,1,3,1,3,4
2014,6,17,1,4,3,11,14
2014,6,17,1,5,6,78,84
2014,6,17,1,6,16,284,300
2014,6,17,1,7,41,782,823
2014,6,17,1,8,58,1058,1116
2014,6,17,1,9,72,398,470
2014,6,17,1,10,109,194,303
2014,6,17,1,11,103,212,315
2014,6,17,1,12,84,271,355
2014,6,17,1,13,93,230,323
2014,6,17,1,14,116,268,384
2014,6,17,1,15,124,277,401
2014,6,17,1,16,123,486,609
2014,6,17,1,17,170,1102,1272
2014,6,17,1,18,153,1052,1205
2014,6,17,1,19,119,713,832
2014,6,17,1,20,138,610,748
2014,6,17,1,21,85,384,469
2014,6,17,1,22,57,286,343
2014,6,17,1,23,43,146,189
2014,6,18,2,0,23,54,77
2014,6,18,2,1,7,15,22
2014,6,18,2,2,1,8,9
2014,6,18,2,3,0,5,5
2014,6,18,2,4,2,6,8
2014,6,18,2,5,6,72,78
2014,6,18,2,6,22,292,314
2014,6,18,2,7,40,738,778
2014,6,18,2,8,62,989,1051
2014,6,18,2,9,59,407,466
2014,6,18,2,10,82,192,274
2014,6,18,2,11,79,212,291
2014,6,18,2,12,86,288,374
2014,6,18,2,13,117,273,390
2014,6,18,2,14,85,247,332
2014,6,18,2,15,134,272,406
2014,6,18,2,16,79,474,553
2014,6,18,2,17,128,1017,1145
2014,6,18,2,18,144,964,1108
2014,6,18,2,19,110,660,770
2014,6,18,2,20,104,526,630
2014,6,18,2,21,84,418,502
2014,6,18,2,22,46,261,307
2014,6,18,2,23,36,180,216
2014,6,19,3,0,8,53,61
2014,6,19,3,1,0,15,15
2014,6,19,3,2,2,10,12
2014,6,19,3,3,0,3,3
2014,6,19,3,4,0,7,7
2014,6,19,3,5,5,61,66
2014,6,19,3,6,17,265,282
2014,6,19,3,7,26,734,760
2014,6,19,3,8,57,1017,1074
2014,6,19,3,9,57,421,478
2014,6,19,3,10,70,197,267
2014,6,19,3,11,106,231,337
2014,6,19,3,12,121,308,429
2014,6,19,3,13,134,290,424
2014,6,19,3,14,112,279,391
2014,6,19,3,15,136,327,463
2014,6,19,3,16,145,500,645
2014,6,19,3,17,125,1117,1242
2014,6,19,3,18,123,937,1060
2014,6,19,3,19,156,680,836
2014,6,19,3,20,137,519,656
2014,6,19,3,21,80,392,472
2014,6,19,3,22,70,317,387
2014,6,19,3,23,30,173,203
2014,6,20,4,0,22,68,90
2014,6,20,4,1,10,36,46
2014,6,20,4,2,2,24,26
2014,6,20,4,3,0,7,7
2014,6,20,4,4,0,12,12
2014,6,20,4,5,7,56,63
2014,6,20,4,6,17,245,262
2014,6,20,4,7,37,673,710
2014,6,20,4,8,58,964,1022
2014,6,20,4,9,92,430,522
2014,6,20,4,10,125,277,402
2014,6,20,4,11,153,321,474
2014,6,20,4,12,149,369,518
2014,6,20,4,13,188,349,537
2014,6,20,4,14,156,372,528
2014,6,20,4,15,217,413,630
2014,6,20,4,16,177,644,821
2014,6,20,4,17,224,1098,1322
2014,6,20,4,18,194,939,1133
2014,6,20,4,19,173,609,782
2014,6,20,4,20,125,459,584
2014,6,20,4,21,122,380,502
2014,6,20,4,22,100,313,413
2014,6,20,4,23,96,278,374
2014,6,21,5,0,39,140,179
2014,6,21,5,1,22,104,126
2014,6,21,5,2,16,58,74
2014,6,21,5,3,8,24,32
2014,6,21,5,4,10,16,26
2014,6,21,5,5,5,17,22
2014,6,21,5,6,9,30,39
2014,6,21,5,7,23,104,127
2014,6,21,5,8,39,181,220
2014,6,21,5,9,98,177,275
2014,6,21,5,10,103,291,394
2014,6,21,5,11,235,416,651
2014,6,21,5,12,276,491,767
2014,6,21,5,13,275,450,725
2014,6,21,5,14,334,534,868
2014,6,21,5,15,356,426,782
2014,6,21,5,16,293,416,709
2014,6,21,5,17,390,511,901
2014,6,21,5,18,313,450,763
2014,6,21,5,19,241,420,661
2014,6,21,5,20,172,326,498
2014,6,21,5,21,170,284,454
2014,6,21,5,22,133,273,406
2014,6,21,5,23,80,160,240
2014,6,22,6,0,65,158,223
2014,6,22,6,1,22,116,138
2014,6,22,6,2,17,99,116
2014,6,22,6,3,10,41,51
2014,6,22,6,4,1,17,18
2014,6,22,6,5,7,9,16
2014,6,22,6,6,10,21,31
2014,6,22,6,7,23,57,80
2014,6,22,6,8,81,143,224
2014,6,22,6,9,146,246,392
2014,6,22,6,10,229,431,660
2014,6,22,6,11,282,521,803
2014,6,22,6,12,375,588,963
2014,6,22,6,13,389,499,888
2014,6,22,6,14,349,564,913
2014,6,22,6,15,381,544,925
2014,6,22,6,16,327,625,952
2014,6,22,6,17,253,674,927
2014,6,22,6,18,215,380,595
2014,6,22,6,19,156,230,386
2014,6,22,6,20,198,582,780
2014,6,22,6,21,134,297,431
2014,6,22,6,22,90,185,275
2014,6,22,6,23,54,107,161
2014,6,23,0,0,11,44,55
2014,6,23,0,1,7,16,23
2014,6,23,0,2,2,9,11
2014,6,23,0,3,0,4,4
2014,6,23,0,4,1,9,10
2014,6,23,0,5,10,57,67
2014,6,23,0,6,25,242,267
2014,6,23,0,7,40,687,727
2014,6,23,0,8,51,986,1037
2014,6,23,0,9,96,399,495
2014,6,23,0,10,136,196,332
2014,6,23,0,11,150,248,398
2014,6,23,0,12,176,323,499
2014,6,23,0,13,135,302,437
2014,6,23,0,14,155,274,429
2014,6,23,0,15,148,328,476
2014,6,23,0,16,185,497,682
2014,6,23,0,17,162,1138,1300
2014,6,23,0,18,170,1066,1236
2014,6,23,0,19,207,725,932
2014,6,23,0,20,161,538,699
2014,6,23,0,21,93,364,457
2014,6,23,0,22,70,209,279
2014,6,23,0,23,22,110,132
2014,6,24,1,0,11,48,59
2014,6,24,1,1,7,20,27
2014,6,24,1,2,4,5,9
2014,6,24,1,3,0,3,3
2014,6,24,1,4,2,17,19
2014,6,24,1,5,5,78,83
2014,6,24,1,6,28,287,315
2014,6,24,1,7,38,793,831
2014,6,24,1,8,76,1034,1110
2014,6,24,1,9,116,472,588
2014,6,24,1,10,90,189,279
2014,6,24,1,11,118,247,365
2014,6,24,1,12,113,295,408
2014,6,24,1,13,118,303,421
2014,6,24,1,14,137,280,417
2014,6,24,1,15,124,334,458
2014,6,24,1,16,108,566,674
2014,6,24,1,17,177,1093,1270
2014,6,24,1,18,182,1107,1289
2014,6,24,1,19,174,776,950
2014,6,24,1,20,127,579,706
2014,6,24,1,21,112,429,541
2014,6,24,1,22,62,247,309
2014,6,24,1,23,29,141,170
2014,6,25,2,0,29,55,84
2014,6,25,2,1,7,17,24
2014,6,25,2,2,9,6,15
2014,6,25,2,3,4,3,7
2014,6,25,2,4,5,10,15
2014,6,25,2,5,7,72,79
2014,6,25,2,6,20,280,300
2014,6,25,2,7,42,758,800
2014,6,25,2,8,79,1021,1100
2014,6,25,2,9,94,454,548
2014,6,25,2,10,110,220,330
2014,6,25,2,11,117,245,362
2014,6,25,2,12,108,308,416
2014,6,25,2,13,108,308,416
2014,6,25,2,14,116,272,388
2014,6,25,2,15,111,294,405
2014,6,25,2,16,100,519,619
2014,6,25,2,17,191,1065,1256
2014,6,25,2,18,163,989,1152
2014,6,25,2,19,146,720,866
2014,6,25,2,20,83,485,568
2014,6,25,2,21,31,274,305
2014,6,25,2,22,14,128,142
2014,6,25,2,23,11,103,114
2014,6,26,3,0,5,36,41
2014,6,26,3,1,1,15,16
2014,6,26,3,2,0,3,3
2014,6,26,3,3,0,2,2
2014,6,26,3,4,1,6,7
2014,6,26,3,5,1,48,49
2014,6,26,3,6,17,286,303
2014,6,26,3,7,31,719,750
2014,6,26,3,8,66,980,1046
2014,6,26,3,9,84,467,551
2014,6,26,3,10,79,258,337
2014,6,26,3,11,130,436,566
2014,6,26,3,12,93,292,385
2014,6,26,3,13,73,261,334
2014,6,26,3,14,116,361,477
2014,6,26,3,15,117,338,455
2014,6,26,3,16,123,517,640
2014,6,26,3,17,168,1035,1203
2014,6,26,3,18,144,1022,1166
2014,6,26,3,19,127,759,886
2014,6,26,3,20,118,627,745
2014,6,26,3,21,114,432,546
2014,6,26,3,22,91,280,371
2014,6,26,3,23,38,170,208
2014,6,27,4,0,18,62,80
2014,6,27,4,1,3,36,39
2014,6,27,4,2,5,12,17
2014,6,27,4,3,1,5,6
2014,6,27,4,4,2,6,8
2014,6,27,4,5,8,48,56
2014,6,27,4,6,22,203,225
2014,6,27,4,7,30,623,653
2014,6,27,4,8,73,904,977
2014,6,27,4,9,96,450,546
2014,6,27,4,10,110,213,323
2014,6,27,4,11,140,290,430
2014,6,27,4,12,149,348,497
2014,6,27,4,13,136,332,468
2014,6,27,4,14,177,308,485
2014,6,27,4,15,173,372,545
2014,6,27,4,16,183,583,766
2014,6,27,4,17,202,996,1198
2014,6,27,4,18,167,797,964
2014,6,27,4,19,188,582,770
2014,6,27,4,20,152,460,612
2014,6,27,4,21,97,345,442
2014,6,27,4,22,98,284,382
2014,6,27,4,23,44,216,260
2014,6,28,5,0,27,148,175
2014,6,28,5,1,14,107,121
2014,6,28,5,2,10,65,75
2014,6,28,5,3,10,28,38
2014,6,28,5,4,1,11,12
2014,6,28,5,5,3,31,34
2014,6,28,5,6,19,54,73
2014,6,28,5,7,29,127,156
2014,6,28,5,8,71,217,288
2014,6,28,5,9,143,331,474
2014,6,28,5,10,223,470,693
2014,6,28,5,11,296,533,829
2014,6,28,5,12,283,522,805
2014,6,28,5,13,320,440,760
2014,6,28,5,14,250,422,672
2014,6,28,5,15,390,644,1034
2014,6,28,5,16,340,468,808
2014,6,28,5,17,335,460,795
2014,6,28,5,18,313,446,759
2014,6,28,5,19,267,436,703
2014,6,28,5,20,244,319,563
2014,6,28,5,21,177,309,486
2014,6,28,5,22,99,236,335
2014,6,28,5,23,72,214,286
2014,6,29,6,0,49,162,211
2014,6,29,6,1,18,102,120
2014,6,29,6,2,19,106,125
2014,6,29,6,3,13,32,45
2014,6,29,6,4,2,13,15
2014,6,29,6,5,6,11,17
2014,6,29,6,6,14,20,34
2014,6,29,6,7,33,74,107
2014,6,29,6,8,90,140,230
2014,6,29,6,9,152,310,462
2014,6,29,6,10,282,432,714
2014,6,29,6,11,386,591,977
2014,6,29,6,12,333,528,861
2014,6,29,6,13,341,435,776
2014,6,29,6,14,350,559,909
2014,6,29,6,15,344,529,873
2014,6,29,6,16,299,519,818
2014,6,29,6,17,298,416,714
2014,6,29,6,18,242,443,685
2014,6,29,6,19,277,514,791
2014,6,29,6,20,247,359,606
2014,6,29,6,21,165,266,431
2014,6,29,6,22,94,149,243
2014,6,29,6,23,65,106,171
2014,6,30,0,0,36,41,77
2014,6,30,0,1,11,8,19
2014,6,30,0,2,0,11,11
2014,6,30,0,3,1,7,8
2014,6,30,0,4,2,5,7
2014,6,30,0,5,4,76,80
2014,6,30,0,6,16,245,261
2014,6,30,0,7,43,668,711
2014,6,30,0,8,56,936,992
2014,6,30,0,9,87,448,535
2014,6,30,0,10,101,166,267
2014,6,30,0,11,157,216,373
2014,6,30,0,12,159,287,446
2014,6,30,0,13,149,272,421
2014,6,30,0,14,139,248,387
2014,6,30,0,15,159,322,481
2014,6,30,0,16,180,525,705
2014,6,30,0,17,159,1083,1242
2014,6,30,0,18,145,1024,1169
2014,6,30,0,19,133,679,812
2014,6,30,0,20,129,495,624
2014,6,30,0,21,94,364,458
2014,6,30,0,22,80,291,371
2014,6,30,0,23,29,108,137
2014,7,1,1,0,22,39,61
2014,7,1,1,1,7,12,19
2014,7,1,1,2,0,8,8
2014,7,1,1,3,0,3,3
2014,7,1,1,4,1,6,7
2014,7,1,1,5,2,71,73
2014,7,1,1,6,24,311,335
2014,7,1,1,7,46,756,802
2014,7,1,1,8,73,953,1026
2014,7,1,1,9,102,416,518
2014,7,1,1,10,114,191,305
2014,7,1,1,11,108,210,318
2014,7,1,1,12,128,252,380
2014,7,1,1,13,152,265,417
2014,7,1,1,14,112,328,440
2014,7,1,1,15,121,599,720
2014,7,1,1,16,85,500,585
2014,7,1,1,17,101,654,755
2014,7,1,1,18,137,954,1091
2014,7,1,1,19,171,819,990
2014,7,1,1,20,137,540,677
2014,7,1,1,21,116,375,491
2014,7,1,1,22,89,306,395
2014,7,1,1,23,50,134,184
2014,7,2,2,0,28,62,90
2014,7,2,2,1,11,15,26
2014,7,2,2,2,0,10,10
2014,7,2,2,3,0,2,2
2014,7,2,2,4,3,3,6
2014,7,2,2,5,5,69,74
2014,7,2,2,6,20,269,289
2014,7,2,2,7,48,715,763
2014,7,2,2,8,72,975,1047
2014,7,2,2,9,80,429,509
2014,7,2,2,10,113,221,334
2014,7,2,2,11,123,232,355
2014,7,2,2,12,101,283,384
2014,7,2,2,13,98,252,350
2014,7,2,2,14,101,259,360
2014,7,2,2,15,112,287,399
2014,7,2,2,16,130,455,585
2014,7,2,2,17,127,988,1115
2014,7,2,2,18,130,805,935
2014,7,2,2,19,100,576,676
2014,7,2,2,20,100,468,568
2014,7,2,2,21,96,343,439
2014,7,2,2,22,83,222,305
2014,7,2,2,23,10,68,78
2014,7,3,3,0,15,40,55
2014,7,3,3,1,7,18,25
2014,7,3,3,2,8,17,25
2014,7,3,3,3,8,2,10
2014,7,3,3,4,0,9,9
2014,7,3,3,5,2,45,47
2014,7,3,3,6,14,223,237
2014,7,3,3,7,43,545,588
2014,7,3,3,8,80,888,968
2014,7,3,3,9,118,450,568
2014,7,3,3,10,130,243,373
2014,7,3,3,11,192,250,442
2014,7,3,3,12,162,350,512
2014,7,3,3,13,152,377,529
2014,7,3,3,14,173,437,610
2014,7,3,3,15,186,629,815
2014,7,3,3,16,110,496,606
2014,7,3,3,17,51,266,317
2014,7,3,3,18,115,381,496
2014,7,3,3,19,85,317,402
2014,7,3,3,20,87,226,313
2014,7,3,3,21,97,241,338
2014,7,3,3,22,54,164,218
2014,7,3,3,23,36,157,193
2014,7,4,4,0,29,90,119
2014,7,4,4,1,13,48,61
2014,7,4,4,2,8,36,44
2014,7,4,4,3,5,26,31
2014,7,4,4,4,5,9,14
2014,7,4,4,5,12,17,29
2014,7,4,4,6,14,36,50
2014,7,4,4,7,25,87,112
2014,7,4,4,8,52,138,190
2014,7,4,4,9,166,257,423
2014,7,4,4,10,302,366,668
2014,7,4,4,11,356,499,855
2014,7,4,4,12,384,408,792
2014,7,4,4,13,443,367,810
2014,7,4,4,14,532,523,1055
2014,7,4,4,15,558,447,1005
2014,7,4,4,16,498,357,855
2014,7,4,4,17,412,286,698
2014,7,4,4,18,451,426,877
2014,7,4,4,19,463,316,779
2014,7,4,4,20,413,324,737
2014,7,4,4,21,398,392,790
2014,7,4,4,22,329,335,664
2014,7,4,4,23,133,233,366
2014,7,5,5,0,65,156,221
2014,7,5,5,1,50,80,130
2014,7,5,5,2,30,39,69
2014,7,5,5,3,9,26,35
2014,7,5,5,4,0,3,3
2014,7,5,5,5,3,10,13
2014,7,5,5,6,18,23,41
2014,7,5,5,7,30,71,101
2014,7,5,5,8,89,116,205
2014,7,5,5,9,192,188,380
2014,7,5,5,10,368,308,676
2014,7,5,5,11,515,414,929
2014,7,5,5,12,548,459,1007
2014,7,5,5,13,601,434,1035
2014,7,5,5,14,687,505,1192
2014,7,5,5,15,665,505,1170
2014,7,5,5,16,594,420,1014
2014,7,5,5,17,536,351,887
2014,7,5,5,18,427,357,784
2014,7,5,5,19,530,433,963
2014,7,5,5,20,455,327,782
2014,7,5,5,21,317,248,565
2014,7,5,5,22,246,216,462
2014,7,5,5,23,123,141,264
2014,7,6,6,0,101,137,238
2014,7,6,6,1,45,79,124
2014,7,6,6,2,34,66,100
2014,7,6,6,3,17,31,48
2014,7,6,6,4,3,11,14
2014,7,6,6,5,3,10,13
2014,7,6,6,6,18,28,46
2014,7,6,6,7,42,50,92
2014,7,6,6,8,89,118,207
2014,7,6,6,9,184,237,421
2014,7,6,6,10,309,367,676
2014,7,6,6,11,445,427,872
2014,7,6,6,12,469,531,1000
2014,7,6,6,13,463,532,995
2014,7,6,6,14,427,446,873
2014,7,6,6,15,406,473,879
2014,7,6,6,16,415,522,937
2014,7,6,6,17,397,459,856
2014,7,6,6,18,298,390,688
2014,7,6,6,19,262,377,639
2014,7,6,6,20,212,323,535
2014,7,6,6,21,163,233,396
2014,7,6,6,22,116,159,275
2014,7,6,6,23,55,54,109
2014,7,7,0,0,19,40,59
2014,7,7,0,1,5,14,19
2014,7,7,0,2,0,8,8
2014,7,7,0,3,0,7,7
2014,7,7,0,4,1,10,11
2014,7,7,0,5,7,69,76
2014,7,7,0,6,10,266,276
2014,7,7,0,7,33,601,634
2014,7,7,0,8,60,880,940
2014,7,7,0,9,106,360,466
2014,7,7,0,10,138,161,299
2014,7,7,0,11,138,203,341
2014,7,7,0,12,110,262,372
2014,7,7,0,13,143,259,402
2014,7,7,0,14,151,254,405
2014,7,7,0,15,180,282,462
2014,7,7,0,16,136,514,650
2014,7,7,0,17,190,1023,1213
2014,7,7,0,18,172,942,1114
2014,7,7,0,19,181,726,907
2014,7,7,0,20,141,529,670
2014,7,7,0,21,106,322,428
2014,7,7,0,22,61,211,272
2014,7,7,0,23,23,111,134
2014,7,8,1,0,23,43,66
2014,7,8,1,1,21,27,48
2014,7,8,1,2,6,3,9
2014,7,8,1,3,1,0,1
2014,7,8,1,4,1,7,8
2014,7,8,1,5,6,57,63
2014,7,8,1,6,16,280,296
2014,7,8,1,7,44,700,744
2014,7,8,1,8,56,928,984
2014,7,8,1,9,78,398,476
2014,7,8,1,10,85,161,246
2014,7,8,1,11,143,164,307
2014,7,8,1,12,101,258,359
2014,7,8,1,13,97,262,359
2014,7,8,1,14,86,229,315
2014,7,8,1,15,112,347,459
2014,7,8,1,16,86,520,606
2014,7,8,1,17,119,960,1079
2014,7,8,1,18,182,993,1175
2014,7,8,1,19,53,353,406
2014,7,8,1,20,13,120,133
2014,7,8,1,21,13,172,185
2014,7,8,1,22,24,177,201
2014,7,8,1,23,17,87,104
2014,7,9,2,0,6,38,44
2014,7,9,2,1,2,14,16
2014,7,9,2,2,2,8,10
2014,7,9,2,3,0,1,1
2014,7,9,2,4,1,10,11
2014,7,9,2,5,3,80,83
2014,7,9,2,6,17,279,296
2014,7,9,2,7,43,732,775
2014,7,9,2,8,46,876,922
2014,7,9,2,9,62,408,470
2014,7,9,2,10,62,147,209
2014,7,9,2,11,120,200,320
2014,7,9,2,12,105,294,399
2014,7,9,2,13,129,271,400
2014,7,9,2,14,111,260,371
2014,7,9,2,15,138,350,488
2014,7,9,2,16,121,527,648
2014,7,9,2,17,84,420,504
2014,7,9,2,18,97,572,669
2014,7,9,2,19,132,703,835
2014,7,9,2,20,87,496,583
2014,7,9,2,21,76,344,420
2014,7,9,2,22,48,233,281
2014,7,9,2,23,24,121,145
2014,7,10,3,0,32,54,86
2014,7,10,3,1,6,28,34
2014,7,10,3,2,0,7,7
2014,7,10,3,3,0,4,4
2014,7,10,3,4,1,11,12
2014,7,10,3,5,6,68,74
2014,7,10,3,6,22,289,311
2014,7,10,3,7,42,684,726
2014,7,10,3,8,77,959,1036
2014,7,10,3,9,67,440,507
2014,7,10,3,10,99,209,308
2014,7,10,3,11,127,208,335
2014,7,10,3,12,152,264,416
2014,7,10,3,13,143,313,456
2014,7,10,3,14,129,258,387
2014,7,10,3,15,133,300,433
2014,7,10,3,16,137,529,666
2014,7,10,3,17,147,1072,1219
2014,7,10,3,18,112,624,736
2014,7,10,3,19,29,257,286
2014,7,10,3,20,41,253,294
2014,7,10,3,21,11,151,162
2014,7,10,3,22,19,165,184
2014,7,10,3,23,11,110,121
2014,7,11,4,0,3,61,64
2014,7,11,4,1,3,30,33
2014,7,11,4,2,5,15,20
2014,7,11,4,3,1,9,10
2014,7,11,4,4,1,5,6
2014,7,11,4,5,3,49,52
2014,7,11,4,6,22,243,265
2014,7,11,4,7,35,581,616
2014,7,11,4,8,92,906,998
2014,7,11,4,9,117,490,607
2014,7,11,4,10,136,232,368
2014,7,11,4,11,151,254,405
2014,7,11,4,12,154,381,535
2014,7,11,4,13,138,373,511
2014,7,11,4,14,135,318,453
2014,7,11,4,15,187,410,597
2014,7,11,4,16,181,613,794
2014,7,11,4,17,209,1010,1219
2014,7,11,4,18,226,855,1081
2014,7,11,4,19,233,656,889
2014,7,11,4,20,189,473,662
2014,7,11,4,21,159,338,497
2014,7,11,4,22,101,296,397
2014,7,11,4,23,65,202,267
2014,7,12,5,0,33,149,182
2014,7,12,5,1,13,108,121
2014,7,12,5,2,15,74,89
2014,7,12,5,3,7,32,39
2014,7,12,5,4,5,8,13
2014,7,12,5,5,3,18,21
2014,7,12,5,6,13,49,62
2014,7,12,5,7,33,101,134
2014,7,12,5,8,65,203,268
2014,7,12,5,9,178,330,508
2014,7,12,5,10,318,404,722
2014,7,12,5,11,390,466,856
2014,7,12,5,12,410,510,920
2014,7,12,5,13,464,491,955
2014,7,12,5,14,439,452,891
2014,7,12,5,15,493,492,985
2014,7,12,5,16,343,453,796
2014,7,12,5,17,354,393,747
2014,7,12,5,18,339,477,816
2014,7,12,5,19,299,415,714
2014,7,12,5,20,259,358,617
2014,7,12,5,21,209,286,495
2014,7,12,5,22,121,240,361
2014,7,12,5,23,91,208,299
2014,7,13,6,0,84,170,254
2014,7,13,6,1,40,126,166
2014,7,13,6,2,25,63,88
2014,7,13,6,3,13,28,41
2014,7,13,6,4,2,8,10
2014,7,13,6,5,2,14,16
2014,7,13,6,6,10,21,31
2014,7,13,6,7,26,69,95
2014,7,13,6,8,97,153,250
2014,7,13,6,9,189,279,468
2014,7,13,6,10,319,401,720
2014,7,13,6,11,356,461,817
2014,7,13,6,12,351,536,887
2014,7,13,6,13,288,564,852
2014,7,13,6,14,269,601,870
2014,7,13,6,15,239,335,574
2014,7,13,6,16,150,273,423
2014,7,13,6,17,201,357,558
2014,7,13,6,18,279,522,801
2014,7,13,6,19,243,386,629
2014,7,13,6,20,166,293,459
2014,7,13,6,21,99,202,301
2014,7,13,6,22,16,56,72
2014,7,13,6,23,11,42,53
2014,7,14,0,0,6,23,29
2014,7,14,0,1,5,6,11
2014,7,14,0,2,2,12,14
2014,7,14,0,3,1,2,3
2014,7,14,0,4,4,8,12
2014,7,14,0,5,4,45,49
2014,7,14,0,6,30,255,285
2014,7,14,0,7,50,627,677
2014,7,14,0,8,69,883,952
2014,7,14,0,9,86,376,462
2014,7,14,0,10,136,177,313
2014,7,14,0,11,150,191,341
2014,7,14,0,12,172,237,409
2014,7,14,0,13,116,229,345
2014,7,14,0,14,134,212,346
2014,7,14,0,15,129,266,395
2014,7,14,0,16,127,416,543
2014,7,14,0,17,74,450,524
2014,7,14,0,18,139,711,850
2014,7,14,0,19,131,580,711
2014,7,14,0,20,131,432,563
2014,7,14,0,21,91,306,397
2014,7,14,0,22,76,177,253
2014,7,14,0,23,22,104,126
2014,7,15,1,0,16,50,66
2014,7,15,1,1,3,10,13
2014,7,15,1,2,4,4,8
2014,7,15,1,3,1,3,4
2014,7,15,1,4,1,5,6
2014,7,15,1,5,5,63,68
2014,7,15,1,6,20,289,309
2014,7,15,1,7,47,709,756
2014,7,15,1,8,60,973,1033
2014,7,15,1,9,74,386,460
2014,7,15,1,10,97,181,278
2014,7,15,1,11,137,205,342
2014,7,15,1,12,118,267,385
2014,7,15,1,13,147,258,405
2014,7,15,1,14,90,219,309
2014,7,15,1,15,44,100,144
2014,7,15,1,16,124,403,527
2014,7,15,1,17,160,994,1154
2014,7,15,1,18,143,946,1089
2014,7,15,1,19,43,227,270
2014,7,15,1,20,23,79,102
2014,7,15,1,21,7,63,70
2014,7,15,1,22,3,46,49
2014,7,15,1,23,8,74,82
2014,7,16,2,0,2,28,30
2014,7,16,2,1,8,11,19
2014,7,16,2,2,4,7,11
2014,7,16,2,3,0,3,3
2014,7,16,2,4,2,12,14
2014,7,16,2,5,6,78,84
2014,7,16,2,6,22,283,305
2014,7,16,2,7,45,721,766
2014,7,16,2,8,83,982,1065
2014,7,16,2,9,72,403,475
2014,7,16,2,10,100,224,324
2014,7,16,2,11,112,237,349
2014,7,16,2,12,135,324,459
2014,7,16,2,13,141,310,451
2014,7,16,2,14,167,251,418
2014,7,16,2,15,179,322,501
2014,7,16,2,16,161,543,704
2014,7,16,2,17,256,1107,1363
2014,7,16,2,18,200,1028,1228
2014,7,16,2,19,180,773,953
2014,7,16,2,20,162,610,772
2014,7,16,2,21,133,412,545
2014,7,16,2,22,74,315,389
2014,7,16,2,23,38,159,197
2014,7,17,3,0,30,60,90
2014,7,17,3,1,15,20,35
2014,7,17,3,2,3,17,20
2014,7,17,3,3,3,3,6
2014,7,17,3,4,5,4,9
2014,7,17,3,5,4,73,77
2014,7,17,3,6,24,299,323
2014,7,17,3,7,57,708,765
2014,7,17,3,8,75,971,1046
2014,7,17,3,9,101,468,569
2014,7,17,3,10,161,211,372
2014,7,17,3,11,138,228,366
2014,7,17,3,12,150,315,465
2014,7,17,3,13,185,320,505
2014,7,17,3,14,203,255,458
2014,7,17,3,15,227,308,535
2014,7,17,3,16,222,536,758
2014,7,17,3,17,228,1118,1346
2014,7,17,3,18,220,1050,1270
2014,7,17,3,19,194,661,855
2014,7,17,3,20,134,590,724
2014,7,17,3,21,100,421,521
2014,7,17,3,22,73,294,367
2014,7,17,3,23,41,186,227
2014,7,18,4,0,17,47,64
2014,7,18,4,1,9,40,49
2014,7,18,4,2,3,21,24
2014,7,18,4,3,3,11,14
2014,7,18,4,4,3,7,10
2014,7,18,4,5,4,53,57
2014,7,18,4,6,23,204,227
2014,7,18,4,7,41,582,623
2014,7,18,4,8,89,966,1055
2014,7,18,4,9,119,435,554
2014,7,18,4,10,186,245,431
2014,7,18,4,11,189,258,447
2014,7,18,4,12,214,369,583
2014,7,18,4,13,203,362,565
2014,7,18,4,14,250,321,571
2014,7,18,4,15,230,411,641
2014,7,18,4,16,221,633,854
2014,7,18,4,17,290,1074,1364
2014,7,18,4,18,250,775,1025
2014,7,18,4,19,210,590,800
2014,7,18,4,20,188,385,573
2014,7,18,4,21,158,320,478
2014,7,18,4,22,98,308,406
2014,7,18,4,23,128,241,369
2014,7,19,5,0,59,175,234
2014,7,19,5,1,21,107,128
2014,7,19,5,2,9,65,74
2014,7,19,5,3,9,33,42
2014,7,19,5,4,1,17,18
2014,7,19,5,5,4,14,18
2014,7,19,5,6,11,33,44
2014,7,19,5,7,26,112,138
2014,7,19,5,8,85,208,293
2014,7,19,5,9,172,301,473
2014,7,19,5,10,289,390,679
2014,7,19,5,11,414,459,873
2014,7,19,5,12,415,491,906
2014,7,19,5,13,454,492,946
2014,7,19,5,14,458,484,942
2014,7,19,5,15,436,471,907
2014,7,19,5,16,486,494,980
2014,7,19,5,17,443,469,912
2014,7,19,5,18,419,448,867
2014,7,19,5,19,318,456,774
2014,7,19,5,20,271,318,589
2014,7,19,5,21,185,244,429
2014,7,19,5,22,168,188,356
2014,7,19,5,23,94,182,276
2014,7,20,6,0,86,133,219
2014,7,20,6,1,27,122,149
2014,7,20,6,2,30,99,129
2014,7,20,6,3,20,49,69
2014,7,20,6,4,6,12,18
2014,7,20,6,5,7,10,17
2014,7,20,6,6,21,19,40
2014,7,20,6,7,31,52,83
2014,7,20,6,8,84,137,221
2014,7,20,6,9,185,287,472
2014,7,20,6,10,294,394,688
2014,7,20,6,11,366,510,876
2014,7,20,6,12,416,545,961
2014,7,20,6,13,450,477,927
2014,7,20,6,14,459,484,943
2014,7,20,6,15,408,489,897
2014,7,20,6,16,437,426,863
2014,7,20,6,17,343,494,837
2014,7,20,6,18,284,470,754
2014,7,20,6,19,229,311,540
2014,7,20,6,20,197,291,488
2014,7,20,6,21,161,215,376
2014,7,20,6,22,82,153,235
2014,7,20,6,23,41,90,131
2014,7,21,0,0,12,33,45
2014,7,21,0,1,2,13,15
2014,7,21,0,2,0,6,6
2014,7,21,0,3,2,2,4
2014,7,21,0,4,0,7,7
2014,7,21,0,5,3,62,65
2014,7,21,0,6,16,253,269
2014,7,21,0,7,43,633,676
2014,7,21,0,8,93,887,980
2014,7,21,0,9,128,418,546
2014,7,21,0,10,185,181,366
2014,7,21,0,11,235,206,441
2014,7,21,0,12,210,266,476
2014,7,21,0,13,196,276,472
2014,7,21,0,14,222,264,486
2014,7,21,0,15,226,276,502
2014,7,21,0,16,213,456,669
2014,7,21,0,17,229,1087,1316
2014,7,21,0,18,246,996,1242
2014,7,21,0,19,196,713,909
2014,7,21,0,20,168,518,686
2014,7,21,0,21,102,357,459
2014,7,21,0,22,80,214,294
2014,7,21,0,23,45,151,196
2014,7,22,1,0,27,27,54
2014,7,22,1,1,5,13,18
2014,7,22,1,2,1,6,7
2014,7,22,1,3,2,3,5
2014,7,22,1,4,1,11,12
2014,7,22,1,5,7,64,71
2014,7,22,1,6,30,283,313
2014,7,22,1,7,46,715,761
2014,7,22,1,8,89,1000,1089
2014,7,22,1,9,116,413,529
2014,7,22,1,10,140,213,353
2014,7,22,1,11,182,220,402
2014,7,22,1,12,206,268,474
2014,7,22,1,13,183,302,485
2014,7,22,1,14,172,248,420
2014,7,22,1,15,157,269,426
2014,7,22,1,16,202,501,703
2014,7,22,1,17,232,1104,1336
2014,7,22,1,18,259,979,1238
2014,7,22,1,19,199,756,955
2014,7,22,1,20,166,551,717
2014,7,22,1,21,89,354,443
2014,7,22,1,22,74,245,319
2014,7,22,1,23,26,151,177
2014,7,23,2,0,8,54,62
2014,7,23,2,1,7,18,25
2014,7,23,2,2,7,4,11
2014,7,23,2,3,1,9,10
2014,7,23,2,4,3,14,17
2014,7,23,2,5,8,74,82
2014,7,23,2,6,37,284,321
2014,7,23,2,7,60,709,769
2014,7,23,2,8,90,984,1074
2014,7,23,2,9,141,393,534
2014,7,23,2,10,106,199,305
2014,7,23,2,11,133,197,330
2014,7,23,2,12,135,279,414
2014,7,23,2,13,169,250,419
2014,7,23,2,14,119,198,317
2014,7,23,2,15,160,249,409
2014,7,23,2,16,189,450,639
2014,7,23,2,17,171,1021,1192
2014,7,23,2,18,228,960,1188
2014,7,23,2,19,187,694,881
2014,7,23,2,20,86,400,486
2014,7,23,2,21,92,326,418
2014,7,23,2,22,34,231,265
2014,7,23,2,23,20,127,147
2014,7,24,3,0,9,41,50
2014,7,24,3,1,4,23,27
2014,7,24,3,2,5,11,16
2014,7,24,3,3,2,5,7
2014,7,24,3,4,3,8,11
2014,7,24,3,5,2,52,54
2014,7,24,3,6,27,225,252
2014,7,24,3,7,55,584,639
2014,7,24,3,8,92,954,1046
2014,7,24,3,9,91,444,535
2014,7,24,3,10,104,192,296
2014,7,24,3,11,134,212,346
2014,7,24,3,12,121,274,395
2014,7,24,3,13,164,268,432
2014,7,24,3,14,164,259,423
2014,7,24,3,15,179,313,492
2014,7,24,3,16,162,471,633
2014,7,24,3,17,211,1024,1235
2014,7,24,3,18,233,968,1201
2014,7,24,3,19,191,690,881
2014,7,24,3,20,173,554,727
2014,7,24,3,21,137,380,517
2014,7,24,3,22,90,286,376
2014,7,24,3,23,46,166,212
2014,7,25,4,0,19,84,103
2014,7,25,4,1,20,36,56
2014,7,25,4,2,5,25,30
2014,7,25,4,3,2,12,14
2014,7,25,4,4,5,9,14
2014,7,25,4,5,7,55,62
2014,7,25,4,6,30,223,253
2014,7,25,4,7,55,622,677
2014,7,25,4,8,123,916,1039
2014,7,25,4,9,124,473,597
2014,7,25,4,10,181,251,432
2014,7,25,4,11,226,313,539
2014,7,25,4,12,235,387,622
2014,7,25,4,13,255,379,634
2014,7,25,4,14,244,366,610
2014,7,25,4,15,291,386,677
2014,7,25,4,16,292,602,894
2014,7,25,4,17,310,1003,1313
2014,7,25,4,18,279,774,1053
2014,7,25,4,19,238,612,850
2014,7,25,4,20,235,442,677
2014,7,25,4,21,172,337,509
2014,7,25,4,22,152,281,433
2014,7,25,4,23,119,214,333
2014,7,26,5,0,65,166,231
2014,7,26,5,1,29,100,129
2014,7,26,5,2,14,85,99
2014,7,26,5,3,13,32,45
2014,7,26,5,4,0,12,12
2014,7,26,5,5,2,21,23
2014,7,26,5,6,12,42,54
2014,7,26,5,7,27,92,119
2014,7,26,5,8,95,192,287
2014,7,26,5,9,181,284,465
2014,7,26,5,10,282,392,674
2014,7,26,5,11,456,457,913
2014,7,26,5,12,499,499,998
2014,7,26,5,13,459,503,962
2014,7,26,5,14,471,479,950
2014,7,26,5,15,462,403,865
2014,7,26,5,16,467,404,871
2014,7,26,5,17,409,476,885
2014,7,26,5,18,399,434,833
2014,7,26,5,19,329,421,750
2014,7,26,5,20,295,330,625
2014,7,26,5,21,283,282,565
2014,7,26,5,22,180,230,410
2014,7,26,5,23,132,221,353
2014,7,27,6,0,65,163,228
2014,7,27,6,1,20,117,137
2014,7,27,6,2,22,72,94
2014,7,27,6,3,19,49,68
2014,7,27,6,4,5,7,12
2014,7,27,6,5,1,7,8
2014,7,27,6,6,10,11,21
2014,7,27,6,7,21,54,75
2014,7,27,6,8,79,115,194
2014,7,27,6,9,149,231,380
2014,7,27,6,10,215,339,554
2014,7,27,6,11,338,441,779
2014,7,27,6,12,426,506,932
2014,7,27,6,13,391,481,872
2014,7,27,6,14,433,497,930
2014,7,27,6,15,387,447,834
2014,7,27,6,16,320,435,755
2014,7,27,6,17,278,451,729
2014,7,27,6,18,261,423,684
2014,7,27,6,19,262,367,629
2014,7,27,6,20,198,302,500
2014,7,27,6,21,110,203,313
2014,7,27,6,22,96,121,217
2014,7,27,6,23,52,92,144
2014,7,28,0,0,14,39,53
2014,7,28,0,1,4,10,14
2014,7,28,0,2,1,8,9
2014,7,28,0,3,1,10,11
2014,7,28,0,4,3,8,11
2014,7,28,0,5,6,55,61
2014,7,28,0,6,22,235,257
2014,7,28,0,7,48,601,649
2014,7,28,0,8,95,899,994
2014,7,28,0,9,107,412,519
2014,7,28,0,10,162,199,361
2014,7,28,0,11,195,227,422
2014,7,28,0,12,193,262,455
2014,7,28,0,13,220,281,501
2014,7,28,0,14,181,214,395
2014,7,28,0,15,160,304,464
2014,7,28,0,16,208,471,679
2014,7,28,0,17,270,1132,1402
2014,7,28,0,18,218,955,1173
2014,7,28,0,19,160,719,879
2014,7,28,0,20,133,500,633
2014,7,28,0,21,99,309,408
2014,7,28,0,22,78,191,269
2014,7,28,0,23,44,111,155
2014,7,29,1,0,24,41,65
2014,7,29,1,1,11,10,21
2014,7,29,1,2,3,5,8
2014,7,29,1,3,2,6,8
2014,7,29,1,4,3,7,10
2014,7,29,1,5,6,67,73
2014,7,29,1,6,24,290,314
2014,7,29,1,7,65,708,773
2014,7,29,1,8,85,1069,1154
2014,7,29,1,9,104,447,551
2014,7,29,1,10,122,210,332
2014,7,29,1,11,150,268,418
2014,7,29,1,12,174,345,519
2014,7,29,1,13,193,343,536
2014,7,29,1,14,208,284,492
2014,7,29,1,15,188,295,483
2014,7,29,1,16,232,533,765
2014,7,29,1,17,213,1084,1297
2014,7,29,1,18,227,965,1192
2014,7,29,1,19,187,687,874
2014,7,29,1,20,136,517,653
2014,7,29,1,21,107,349,456
2014,7,29,1,22,71,235,306
2014,7,29,1,23,38,106,144
2014,7,30,2,0,9,49,58
2014,7,30,2,1,6,12,18
2014,7,30,2,2,0,11,11
2014,7,30,2,3,1,4,5
2014,7,30,2,4,4,11,15
2014,7,30,2,5,8,68,76
2014,7,30,2,6,14,267,281
2014,7,30,2,7,56,740,796
2014,7,30,2,8,95,1073,1168
2014,7,30,2,9,99,473,572
2014,7,30,2,10,131,213,344
2014,7,30,2,11,159,240,399
2014,7,30,2,12,212,324,536
2014,7,30,2,13,150,319,469
2014,7,30,2,14,227,264,491
2014,7,30,2,15,163,310,473
2014,7,30,2,16,210,512,722
2014,7,30,2,17,190,1115,1305
2014,7,30,2,18,254,1025,1279
2014,7,30,2,19,178,708,886
2014,7,30,2,20,120,464,584
2014,7,30,2,21,99,415,514
2014,7,30,2,22,65,258,323
2014,7,30,2,23,27,149,176
2014,7,31,3,0,22,55,77
2014,7,31,3,1,6,26,32
2014,7,31,3,2,3,13,16
2014,7,31,3,3,0,5,5
2014,7,31,3,4,2,12,14
2014,7,31,3,5,10,61,71
2014,7,31,3,6,25,233,258
2014,7,31,3,7,49,666,715
2014,7,31,3,8,85,988,1073
2014,7,31,3,9,107,468,575
2014,7,31,3,10,156,209,365
2014,7,31,3,11,180,218,398
2014,7,31,3,12,135,333,468
2014,7,31,3,13,180,301,481
2014,7,31,3,14,193,273,466
2014,7,31,3,15,181,299,480
2014,7,31,3,16,177,509,686
2014,7,31,3,17,243,1027,1270
2014,7,31,3,18,231,959,1190
2014,7,31,3,19,168,623,791
2014,7,31,3,20,119,475,594
2014,7,31,3,21,99,370,469
2014,7,31,3,22,89,288,377
2014,7,31,3,23,36,199,235
2014,8,1,4,0,28,78,106
2014,8,1,4,1,9,37,46
2014,8,1,4,2,9,17,26
2014,8,1,4,3,1,11,12
2014,8,1,4,4,1,15,16
2014,8,1,4,5,6,57,63
2014,8,1,4,6,18,226,244
2014,8,1,4,7,47,531,578
2014,8,1,4,8,97,904,1001
2014,8,1,4,9,107,443,550
2014,8,1,4,10,128,185,313
2014,8,1,4,11,156,184,340
2014,8,1,4,12,97,248,345
2014,8,1,4,13,126,338,464
2014,8,1,4,14,142,309,451
2014,8,1,4,15,127,322,449
2014,8,1,4,16,214,586,800
2014,8,1,4,17,224,925,1149
2014,8,1,4,18,173,801,974
2014,8,1,4,19,114,487,601
2014,8,1,4,20,107,372,479
2014,8,1,4,21,141,314,455
2014,8,1,4,22,90,252,342
2014,8,1,4,23,48,122,170
2014,8,2,5,0,9,43,52
2014,8,2,5,1,7,43,50
2014,8,2,5,2,5,38,43
2014,8,2,5,3,14,25,39
2014,8,2,5,4,5,7,12
2014,8,2,5,5,0,18,18
2014,8,2,5,6,5,34,39
2014,8,2,5,7,24,82,106
2014,8,2,5,8,77,190,267
2014,8,2,5,9,143,282,425
2014,8,2,5,10,232,375,607
2014,8,2,5,11,355,422,777
2014,8,2,5,12,450,456,906
2014,8,2,5,13,431,424,855
2014,8,2,5,14,508,449,957
2014,8,2,5,15,555,445,1000
2014,8,2,5,16,480,401,881
2014,8,2,5,17,482,426,908
2014,8,2,5,18,366,375,741
2014,8,2,5,19,316,340,656
2014,8,2,5,20,243,253,496
2014,8,2,5,21,232,204,436
2014,8,2,5,22,182,209,391
2014,8,2,5,23,93,164,257
2014,8,3,6,0,63,138,201
2014,8,3,6,1,49,108,157
2014,8,3,6,2,26,65,91
2014,8,3,6,3,8,35,43
2014,8,3,6,4,4,7,11
2014,8,3,6,5,3,7,10
2014,8,3,6,6,7,23,30
2014,8,3,6,7,26,51,77
2014,8,3,6,8,47,137,184
2014,8,3,6,9,136,229,365
2014,8,3,6,10,274,366,640
2014,8,3,6,11,292,414,706
2014,8,3,6,12,362,538,900
2014,8,3,6,13,374,486,860
2014,8,3,6,14,357,478,835
2014,8,3,6,15,325,534,859
2014,8,3,6,16,324,489,813
2014,8,3,6,17,336,450,786
2014,8,3,6,18,264,479,743
2014,8,3,6,19,246,347,593
2014,8,3,6,20,206,296,502
2014,8,3,6,21,133,197,330
2014,8,3,6,22,52,97,149
2014,8,3,6,23,11,23,34
2014,8,4,0,0,4,13,17
2014,8,4,0,1,1,11,12
2014,8,4,0,2,1,7,8
2014,8,4,0,3,2,7,9
2014,8,4,0,4,1,8,9
2014,8,4,0,5,7,63,70
2014,8,4,0,6,12,226,238
2014,8,4,0,7,52,575,627
2014,8,4,0,8,107,943,1050
2014,8,4,0,9,154,416,570
2014,8,4,0,10,217,180,397
2014,8,4,0,11,194,208,402
2014,8,4,0,12,188,290,478
2014,8,4,0,13,187,316,503
2014,8,4,0,14,227,231,458
2014,8,4,0,15,233,267,500
2014,8,4,0,16,250,485,735
2014,8,4,0,17,280,1029,1309
2014,8,4,0,18,274,929,1203
2014,8,4,0,19,179,660,839
2014,8,4,0,20,176,496,672
2014,8,4,0,21,93,338,431
2014,8,4,0,22,71,276,347
2014,8,4,0,23,28,88,116
2014,8,5,1,0,9,41,50
2014,8,5,1,1,5,15,20
2014,8,5,1,2,3,7,10
2014,8,5,1,3,1,0,1
2014,8,5,1,4,1,13,14
2014,8,5,1,5,5,77,82
2014,8,5,1,6,28,253,281
2014,8,5,1,7,47,664,711
2014,8,5,1,8,87,935,1022
2014,8,5,1,9,118,425,543
2014,8,5,1,10,134,187,321
2014,8,5,1,11,165,222,387
2014,8,5,1,12,158,317,475
2014,8,5,1,13,174,315,489
2014,8,5,1,14,171,259,430
2014,8,5,1,15,188,300,488
2014,8,5,1,16,197,495,692
2014,8,5,1,17,208,1000,1208
2014,8,5,1,18,223,909,1132
2014,8,5,1,19,194,595,789
2014,8,5,1,20,168,460,628
2014,8,5,1,21,137,367,504
2014,8,5,1,22,88,322,410
2014,8,5,1,23,37,104,141
2014,8,6,2,0,5,18,23
2014,8,6,2,1,2,19,21
2014,8,6,2,2,0,2,2
2014,8,6,2,3,0,3,3
2014,8,6,2,4,0,7,7
2014,8,6,2,5,7,65,72
2014,8,6,2,6,27,263,290
2014,8,6,2,7,42,620,662
2014,8,6,2,8,104,899,1003
2014,8,6,2,9,78,442,520
2014,8,6,2,10,115,209,324
2014,8,6,2,11,161,216,377
2014,8,6,2,12,166,357,523
2014,8,6,2,13,142,311,453
2014,8,6,2,14,187,292,479
2014,8,6,2,15,212,260,472
2014,8,6,2,16,226,484,710
2014,8,6,2,17,251,1055,1306
2014,8,6,2,18,231,1006,1237
2014,8,6,2,19,239,719,958
2014,8,6,2,20,150,473,623
2014,8,6,2,21,109,385,494
2014,8,6,2,22,90,272,362
2014,8,6,2,23,60,128,188
2014,8,7,3,0,15,49,64
2014,8,7,3,1,4,19,23
2014,8,7,3,2,6,6,12
2014,8,7,3,3,0,5,5
2014,8,7,3,4,4,14,18
2014,8,7,3,5,2,63,65
2014,8,7,3,6,27,258,285
2014,8,7,3,7,56,625,681
2014,8,7,3,8,111,984,1095
2014,8,7,3,9,89,458,547
2014,8,7,3,10,148,228,376
2014,8,7,3,11,175,251,426
2014,8,7,3,12,174,353,527
2014,8,7,3,13,173,323,496
2014,8,7,3,14,146,246,392
2014,8,7,3,15,203,270,473
2014,8,7,3,16,187,493,680
2014,8,7,3,17,221,988,1209
2014,8,7,3,18,223,997,1220
2014,8,7,3,19,192,703,895
2014,8,7,3,20,148,500,648
2014,8,7,3,21,124,349,473
2014,8,7,3,22,103,253,356
2014,8,7,3,23,47,162,209
2014,8,8,4,0,23,85,108
2014,8,8,4,1,11,33,44
2014,8,8,4,2,3,20,23
2014,8,8,4,3,5,4,9
2014,8,8,4,4,0,11,11
2014,8,8,4,5,5,53,58
2014,8,8,4,6,25,222,247
2014,8,8,4,7,62,563,625
2014,8,8,4,8,107,863,970
2014,8,8,4,9,154,436,590
2014,8,8,4,10,181,225,406
2014,8,8,4,11,237,277,514
2014,8,8,4,12,227,367,594
2014,8,8,4,13,208,334,542
2014,8,8,4,14,254,283,537
2014,8,8,4,15,223,329,552
2014,8,8,4,16,293,522,815
2014,8,8,4,17,292,959,1251
2014,8,8,4,18,226,801,1027
2014,8,8,4,19,203,597,800
2014,8,8,4,20,203,395,598
2014,8,8,4,21,147,253,400
2014,8,8,4,22,154,224,378
2014,8,8,4,23,84,188,272
2014,8,9,5,0,44,157,201
2014,8,9,5,1,27,96,123
2014,8,9,5,2,13,74,87
2014,8,9,5,3,11,22,33
2014,8,9,5,4,10,7,17
2014,8,9,5,5,8,14,22
2014,8,9,5,6,14,38,52
2014,8,9,5,7,24,68,92
2014,8,9,5,8,80,187,267
2014,8,9,5,9,197,314,511
2014,8,9,5,10,248,370,618
2014,8,9,5,11,288,460,748
2014,8,9,5,12,369,444,813
2014,8,9,5,13,433,467,900
2014,8,9,5,14,415,419,834
2014,8,9,5,15,479,392,871
2014,8,9,5,16,443,345,788
2014,8,9,5,17,424,329,753
2014,8,9,5,18,331,393,724
2014,8,9,5,19,289,332,621
2014,8,9,5,20,216,230,446
2014,8,9,5,21,155,214,369
2014,8,9,5,22,110,189,299
2014,8,9,5,23,96,172,268
2014,8,10,6,0,47,131,178
2014,8,10,6,1,45,95,140
2014,8,10,6,2,16,75,91
2014,8,10,6,3,13,36,49
2014,8,10,6,4,3,11,14
2014,8,10,6,5,6,14,20
2014,8,10,6,6,13,21,34
2014,8,10,6,7,36,41,77
2014,8,10,6,8,74,108,182
2014,8,10,6,9,171,270,441
2014,8,10,6,10,294,338,632
2014,8,10,6,11,369,437,806
2014,8,10,6,12,452,488,940
2014,8,10,6,13,505,463,968
2014,8,10,6,14,490,467,957
2014,8,10,6,15,466,480,946
2014,8,10,6,16,408,446,854
2014,8,10,6,17,409,396,805
2014,8,10,6,18,273,451,724
2014,8,10,6,19,332,388,720
2014,8,10,6,20,202,239,441
2014,8,10,6,21,139,200,339
2014,8,10,6,22,136,160,296
2014,8,10,6,23,61,67,128
2014,8,11,0,0,30,29,59
2014,8,11,0,1,2,11,13
2014,8,11,0,2,9,2,11
2014,8,11,0,3,4,9,13
2014,8,11,0,4,0,8,8
2014,8,11,0,5,9,55,64
2014,8,11,0,6,22,253,275
2014,8,11,0,7,63,592,655
2014,8,11,0,8,117,905,1022
2014,8,11,0,9,118,386,504
2014,8,11,0,10,217,216,433
2014,8,11,0,11,217,195,412
2014,8,11,0,12,194,250,444
2014,8,11,0,13,213,276,489
2014,8,11,0,14,208,250,458
2014,8,11,0,15,236,240,476
2014,8,11,0,16,288,483,771
2014,8,11,0,17,254,951,1205
2014,8,11,0,18,192,784,976
2014,8,11,0,19,176,481,657
2014,8,11,0,20,79,163,242
2014,8,11,0,21,71,167,238
2014,8,11,0,22,35,125,160
2014,8,11,0,23,22,80,102
2014,8,12,1,0,8,31,39
2014,8,12,1,1,11,7,18
2014,8,12,1,2,1,4,5
2014,8,12,1,3,0,1,1
2014,8,12,1,4,1,7,8
2014,8,12,1,5,6,64,70
2014,8,12,1,6,6,120,126
2014,8,12,1,7,29,389,418
2014,8,12,1,8,38,507,545
2014,8,12,1,9,38,265,303
2014,8,12,1,10,18,27,45
2014,8,12,1,11,6,32,38
2014,8,12,1,12,9,39,48
2014,8,12,1,13,5,29,34
2014,8,12,1,14,4,30,34
2014,8,12,1,15,21,118,139
2014,8,12,1,16,89,353,442
2014,8,12,1,17,123,806,929
2014,8,12,1,18,106,820,926
2014,8,12,1,19,122,568,690
2014,8,12,1,20,109,394,503
2014,8,12,1,21,69,256,325
2014,8,12,1,22,37,193,230
2014,8,12,1,23,24,90,114
2014,8,13,2,0,8,29,37
2014,8,13,2,1,8,20,28
2014,8,13,2,2,4,4,8
2014,8,13,2,3,0,7,7
2014,8,13,2,4,1,10,11
2014,8,13,2,5,6,79,85
2014,8,13,2,6,19,252,271
2014,8,13,2,7,52,660,712
2014,8,13,2,8,67,940,1007
2014,8,13,2,9,102,397,499
2014,8,13,2,10,143,203,346
2014,8,13,2,11,160,238,398
2014,8,13,2,12,160,344,504
2014,8,13,2,13,243,315,558
2014,8,13,2,14,180,249,429
2014,8,13,2,15,180,260,440
2014,8,13,2,16,206,476,682
2014,8,13,2,17,244,1076,1320
2014,8,13,2,18,206,962,1168
2014,8,13,2,19,165,724,889
2014,8,13,2,20,150,508,658
2014,8,13,2,21,121,338,459
2014,8,13,2,22,69,253,322
2014,8,13,2,23,38,143,181
2014,8,14,3,0,18,54,72
2014,8,14,3,1,12,24,36
2014,8,14,3,2,4,11,15
2014,8,14,3,3,2,10,12
2014,8,14,3,4,1,6,7
2014,8,14,3,5,4,68,72
2014,8,14,3,6,18,248,266
2014,8,14,3,7,46,598,644
2014,8,14,3,8,79,925,1004
2014,8,14,3,9,117,412,529
2014,8,14,3,10,147,238,385
2014,8,14,3,11,200,217,417
2014,8,14,3,12,179,333,512
2014,8,14,3,13,189,352,541
2014,8,14,3,14,187,269,456
2014,8,14,3,15,214,287,501
2014,8,14,3,16,202,526,728
2014,8,14,3,17,226,1039,1265
2014,8,14,3,18,211,996,1207
2014,8,14,3,19,195,661,856
2014,8,14,3,20,147,456,603
2014,8,14,3,21,121,350,471
2014,8,14,3,22,103,249,352
2014,8,14,3,23,39,141,180
2014,8,15,4,0,28,91,119
2014,8,15,4,1,5,28,33
2014,8,15,4,2,1,14,15
2014,8,15,4,3,0,7,7
2014,8,15,4,4,1,9,10
2014,8,15,4,5,4,59,63
2014,8,15,4,6,22,222,244
2014,8,15,4,7,35,554,589
2014,8,15,4,8,109,968,1077
2014,8,15,4,9,124,477,601
2014,8,15,4,10,163,244,407
2014,8,15,4,11,217,344,561
2014,8,15,4,12,278,369,647
2014,8,15,4,13,239,340,579
2014,8,15,4,14,297,342,639
2014,8,15,4,15,277,412,689
2014,8,15,4,16,308,594,902
2014,8,15,4,17,304,996,1300
2014,8,15,4,18,244,773,1017
2014,8,15,4,19,252,553,805
2014,8,15,4,20,237,419,656
2014,8,15,4,21,170,287,457
2014,8,15,4,22,114,246,360
2014,8,15,4,23,53,218,271
2014,8,16,5,0,53,147,200
2014,8,16,5,1,44,93,137
2014,8,16,5,2,12,71,83
2014,8,16,5,3,13,35,48
2014,8,16,5,4,4,18,22
2014,8,16,5,5,4,14,18
2014,8,16,5,6,13,42,55
2014,8,16,5,7,19,108,127
2014,8,16,5,8,75,200,275
2014,8,16,5,9,155,308,463
2014,8,16,5,10,306,350,656
2014,8,16,5,11,392,464,856
2014,8,16,5,12,494,481,975
2014,8,16,5,13,538,519,1057
2014,8,16,5,14,565,507,1072
2014,8,16,5,15,556,508,1064
2014,8,16,5,16,511,465,976
2014,8,16,5,17,494,437,931
2014,8,16,5,18,439,468,907
2014,8,16,5,19,350,377,727
2014,8,16,5,20,295,263,558
2014,8,16,5,21,179,240,419
2014,8,16,5,22,176,241,417
2014,8,16,5,23,141,176,317
2014,8,17,6,0,67,150,217
2014,8,17,6,1,42,90,132
2014,8,17,6,2,37,71,108
2014,8,17,6,3,27,32,59
2014,8,17,6,4,6,6,12
2014,8,17,6,5,19,10,29
2014,8,17,6,6,22,18,40
2014,8,17,6,7,23,59,82
2014,8,17,6,8,105,146,251
2014,8,17,6,9,134,203,337
2014,8,17,6,10,261,365,626
2014,8,17,6,11,350,448,798
2014,8,17,6,12,435,535,970
2014,8,17,6,13,457,493,950
2014,8,17,6,14,435,477,912
2014,8,17,6,15,334,479,813
2014,8,17,6,16,368,516,884
2014,8,17,6,17,342,435,777
2014,8,17,6,18,260,498,758
2014,8,17,6,19,235,448,683
2014,8,17,6,20,180,317,497
2014,8,17,6,21,116,231,347
2014,8,17,6,22,83,173,256
2014,8,17,6,23,47,96,143
2014,8,18,0,0,20,30,50
2014,8,18,0,1,6,17,23
2014,8,18,0,2,4,9,13
2014,8,18,0,3,0,5,5
2014,8,18,0,4,2,11,13
2014,8,18,0,5,4,58,62
2014,8,18,0,6,24,253,277
2014,8,18,0,7,45,598,643
2014,8,18,0,8,89,971,1060
2014,8,18,0,9,122,394,516
2014,8,18,0,10,143,174,317
2014,8,18,0,11,205,205,410
2014,8,18,0,12,173,264,437
2014,8,18,0,13,204,298,502
2014,8,18,0,14,195,257,452
2014,8,18,0,15,195,299,494
2014,8,18,0,16,206,520,726
2014,8,18,0,17,226,1084,1310
2014,8,18,0,18,222,985,1207
2014,8,18,0,19,160,777,937
2014,8,18,0,20,102,440,542
2014,8,18,0,21,78,295,373
2014,8,18,0,22,58,281,339
2014,8,18,0,23,31,103,134
2014,8,19,1,0,6,40,46
2014,8,19,1,1,10,18,28
2014,8,19,1,2,1,8,9
2014,8,19,1,3,0,6,6
2014,8,19,1,4,0,10,10
2014,8,19,1,5,2,73,75
2014,8,19,1,6,15,276,291
2014,8,19,1,7,40,718,758
2014,8,19,1,8,86,952,1038
2014,8,19,1,9,99,425,524
2014,8,19,1,10,97,177,274
2014,8,19,1,11,100,178,278
2014,8,19,1,12,101,295,396
2014,8,19,1,13,101,275,376
2014,8,19,1,14,135,269,404
2014,8,19,1,15,185,326,511
2014,8,19,1,16,141,520,661
2014,8,19,1,17,177,1187,1364
2014,8,19,1,18,167,1065,1232
2014,8,19,1,19,160,690,850
2014,8,19,1,20,94,545,639
2014,8,19,1,21,77,342,419
2014,8,19,1,22,39,252,291
2014,8,19,1,23,36,130,166
2014,8,20,2,0,7,47,54
2014,8,20,2,1,0,21,21
2014,8,20,2,2,3,9,12
2014,8,20,2,3,0,1,1
2014,8,20,2,4,1,14,15
2014,8,20,2,5,3,73,76
2014,8,20,2,6,11,284,295
2014,8,20,2,7,43,726,769
2014,8,20,2,8,67,963,1030
2014,8,20,2,9,107,427,534
2014,8,20,2,10,125,203,328
2014,8,20,2,11,130,257,387
2014,8,20,2,12,156,318,474
2014,8,20,2,13,159,346,505
2014,8,20,2,14,162,251,413
2014,8,20,2,15,170,346,516
2014,8,20,2,16,206,561,767
2014,8,20,2,17,59,334,393
2014,8,20,2,18,76,450,526
2014,8,20,2,19,148,595,743
2014,8,20,2,20,121,411,532
2014,8,20,2,21,93,330,423
2014,8,20,2,22,52,250,302
2014,8,20,2,23,29,111,140
2014,8,21,3,0,11,53,64
2014,8,21,3,1,8,23,31
2014,8,21,3,2,8,15,23
2014,8,21,3,3,0,2,2
2014,8,21,3,4,1,6,7
2014,8,21,3,5,3,64,67
2014,8,21,3,6,19,264,283
2014,8,21,3,7,33,698,731
2014,8,21,3,8,66,951,1017
2014,8,21,3,9,90,442,532
2014,8,21,3,10,119,196,315
2014,8,21,3,11,161,248,409
2014,8,21,3,12,160,309,469
2014,8,21,3,13,141,316,457
2014,8,21,3,14,175,306,481
2014,8,21,3,15,179,321,500
2014,8,21,3,16,184,496,680
2014,8,21,3,17,107,635,742
2014,8,21,3,18,95,722,817
2014,8,21,3,19,124,615,739
2014,8,21,3,20,117,422,539
2014,8,21,3,21,124,331,455
2014,8,21,3,22,70,229,299
2014,8,21,3,23,25,166,191
2014,8,22,4,0,20,71,91
2014,8,22,4,1,6,25,31
2014,8,22,4,2,3,16,19
2014,8,22,4,3,2,10,12
2014,8,22,4,4,1,8,9
2014,8,22,4,5,2,68,70
2014,8,22,4,6,12,222,234
2014,8,22,4,7,47,600,647
2014,8,22,4,8,59,859,918
2014,8,22,4,9,83,504,587
2014,8,22,4,10,106,235,341
2014,8,22,4,11,132,204,336
2014,8,22,4,12,185,329,514
2014,8,22,4,13,154,308,462
2014,8,22,4,14,155,301,456
2014,8,22,4,15,154,370,524
2014,8,22,4,16,198,545,743
2014,8,22,4,17,192,919,1111
2014,8,22,4,18,180,832,1012
2014,8,22,4,19,172,551,723
2014,8,22,4,20,107,389,496
2014,8,22,4,21,97,300,397
2014,8,22,4,22,72,279,351
2014,8,22,4,23,66,204,270
2014,8,23,5,0,33,183,216
2014,8,23,5,1,33,122,155
2014,8,23,5,2,25,64,89
2014,8,23,5,3,10,32,42
2014,8,23,5,4,4,11,15
2014,8,23,5,5,12,21,33
2014,8,23,5,6,12,54,66
2014,8,23,5,7,32,114,146
2014,8,23,5,8,43,234,277
2014,8,23,5,9,91,302,393
2014,8,23,5,10,121,247,368
2014,8,23,5,11,145,284,429
2014,8,23,5,12,225,385,610
2014,8,23,5,13,231,408,639
2014,8,23,5,14,155,217,372
2014,8,23,5,15,55,118,173
2014,8,23,5,16,67,144,211
2014,8,23,5,17,113,177,290
2014,8,23,5,18,103,277,380
2014,8,23,5,19,141,281,422
2014,8,23,5,20,127,247,374
2014,8,23,5,21,120,198,318
2014,8,23,5,22,93,190,283
2014,8,23,5,23,54,158,212
2014,8,24,6,0,42,141,183
2014,8,24,6,1,17,115,132
2014,8,24,6,2,32,98,130
2014,8,24,6,3,9,35,44
2014,8,24,6,4,7,13,20
2014,8,24,6,5,4,5,9
2014,8,24,6,6,3,26,29
2014,8,24,6,7,21,84,105
2014,8,24,6,8,38,150,188
2014,8,24,6,9,143,275,418
2014,8,24,6,10,228,400,628
2014,8,24,6,11,332,530,862
2014,8,24,6,12,384,639,1023
2014,8,24,6,13,420,616,1036
2014,8,24,6,14,372,527,899
2014,8,24,6,15,377,545,922
2014,8,24,6,16,303,523,826
2014,8,24,6,17,336,583,919
2014,8,24,6,18,276,564,840
2014,8,24,6,19,209,466,675
2014,8,24,6,20,128,308,436
2014,8,24,6,21,85,206,291
2014,8,24,6,22,52,162,214
2014,8,24,6,23,25,79,104
2014,8,25,0,0,17,31,48
2014,8,25,0,1,2,16,18
2014,8,25,0,2,0,7,7
2014,8,25,0,3,0,4,4
2014,8,25,0,4,1,11,12
2014,8,25,0,5,0,62,62
2014,8,25,0,6,14,248,262
2014,8,25,0,7,39,686,725
2014,8,25,0,8,63,930,993
2014,8,25,0,9,91,387,478
2014,8,25,0,10,118,217,335
2014,8,25,0,11,163,236,399
2014,8,25,0,12,168,308,476
2014,8,25,0,13,138,350,488
2014,8,25,0,14,168,252,420
2014,8,25,0,15,200,325,525
2014,8,25,0,16,179,579,758
2014,8,25,0,17,184,1183,1367
2014,8,25,0,18,166,1080,1246
2014,8,25,0,19,142,713,855
2014,8,25,0,20,127,506,633
2014,8,25,0,21,83,305,388
2014,8,25,0,22,54,169,223
2014,8,25,0,23,28,110,138
2014,8,26,1,0,18,35,53
2014,8,26,1,1,5,10,15
2014,8,26,1,2,1,6,7
2014,8,26,1,3,0,1,1
2014,8,26,1,4,1,13,14
2014,8,26,1,5,1,75,76
2014,8,26,1,6,12,296,308
2014,8,26,1,7,35,807,842
2014,8,26,1,8,74,1055,1129
2014,8,26,1,9,72,452,524
2014,8,26,1,10,107,208,315
2014,8,26,1,11,141,245,386
2014,8,26,1,12,120,295,415
2014,8,26,1,13,123,312,435
2014,8,26,1,14,137,277,414
2014,8,26,1,15,160,333,493
2014,8,26,1,16,150,567,717
2014,8,26,1,17,166,1144,1310
2014,8,26,1,18,197,1036,1233
2014,8,26,1,19,145,754,899
2014,8,26,1,20,85,486,571
2014,8,26,1,21,79,338,417
2014,8,26,1,22,61,223,284
2014,8,26,1,23,31,99,130
2014,8,27,2,0,18,44,62
2014,8,27,2,1,5,11,16
2014,8,27,2,2,2,8,10
2014,8,27,2,3,2,1,3
2014,8,27,2,4,4,9,13
2014,8,27,2,5,3,85,88
2014,8,27,2,6,15,292,307
2014,8,27,2,7,39,766,805
2014,8,27,2,8,55,1043,1098
2014,8,27,2,9,99,432,531
2014,8,27,2,10,109,232,341
2014,8,27,2,11,124,262,386
2014,8,27,2,12,181,348,529
2014,8,27,2,13,130,329,459
2014,8,27,2,14,176,287,463
2014,8,27,2,15,152,333,485
2014,8,27,2,16,141,564,705
2014,8,27,2,17,206,1102,1308
2014,8,27,2,18,201,1052,1253
2014,8,27,2,19,167,716,883
2014,8,27,2,20,84,497,581
2014,8,27,2,21,88,376,464
2014,8,27,2,22,47,259,306
2014,8,27,2,23,30,122,152
2014,8,28,3,0,22,43,65
2014,8,28,3,1,11,16,27
2014,8,28,3,2,0,7,7
2014,8,28,3,3,0,7,7
2014,8,28,3,4,0,8,8
2014,8,28,3,5,1,58,59
2014,8,28,3,6,14,294,308
2014,8,28,3,7,33,712,745
2014,8,28,3,8,59,1015,1074
2014,8,28,3,9,95,459,554
2014,8,28,3,10,98,244,342
2014,8,28,3,11,134,270,404
2014,8,28,3,12,118,360,478
2014,8,28,3,13,156,369,525
2014,8,28,3,14,136,311,447
2014,8,28,3,15,182,350,532
2014,8,28,3,16,184,600,784
2014,8,28,3,17,207,1049,1256
2014,8,28,3,18,141,1013,1154
2014,8,28,3,19,131,651,782
2014,8,28,3,20,99,510,609
2014,8,28,3,21,92,373,465
2014,8,28,3,22,72,287,359
2014,8,28,3,23,31,149,180
2014,8,29,4,0,11,73,84
2014,8,29,4,1,8,28,36
2014,8,29,4,2,7,18,25
2014,8,29,4,3,1,6,7
2014,8,29,4,4,0,6,6
2014,8,29,4,5,1,61,62
2014,8,29,4,6,17,229,246
2014,8,29,4,7,29,560,589
2014,8,29,4,8,64,964,1028
2014,8,29,4,9,99,505,604
2014,8,29,4,10,148,273,421
2014,8,29,4,11,177,294,471
2014,8,29,4,12,207,427,634
2014,8,29,4,13,235,446,681
2014,8,29,4,14,222,492,714
2014,8,29,4,15,298,648,946
2014,8,29,4,16,279,751,1030
2014,8,29,4,17,272,844,1116
2014,8,29,4,18,222,648,870
2014,8,29,4,19,164,516,680
2014,8,29,4,20,138,405,543
2014,8,29,4,21,121,275,396
2014,8,29,4,22,65,239,304
2014,8,29,4,23,63,177,240
2014,8,30,5,0,31,99,130
2014,8,30,5,1,29,70,99
2014,8,30,5,2,19,51,70
2014,8,30,5,3,10,17,27
2014,8,30,5,4,5,9,14
2014,8,30,5,5,13,19,32
2014,8,30,5,6,15,55,70
2014,8,30,5,7,28,98,126
2014,8,30,5,8,53,161,214
2014,8,30,5,9,131,259,390
2014,8,30,5,10,244,324,568
2014,8,30,5,11,314,379,693
2014,8,30,5,12,417,433,850
2014,8,30,5,13,438,409,847
2014,8,30,5,14,441,392,833
2014,8,30,5,15,481,384,865
2014,8,30,5,16,518,371,889
2014,8,30,5,17,442,357,799
2014,8,30,5,18,413,382,795
2014,8,30,5,19,305,335,640
2014,8,30,5,20,212,231,443
2014,8,30,5,21,158,197,355
2014,8,30,5,22,134,175,309
2014,8,30,5,23,95,156,251
2014,8,31,6,0,50,115,165
2014,8,31,6,1,32,105,137
2014,8,31,6,2,10,60,70
2014,8,31,6,3,4,26,30
2014,8,31,6,4,4,4,8
2014,8,31,6,5,4,5,9
2014,8,31,6,6,4,16,20
2014,8,31,6,7,31,53,84
2014,8,31,6,8,74,142,216
2014,8,31,6,9,195,218,413
2014,8,31,6,10,370,325,695
2014,8,31,6,11,438,440,878
2014,8,31,6,12,441,466,907
2014,8,31,6,13,499,379,878
2014,8,31,6,14,472,391,863
2014,8,31,6,15,479,288,767
2014,8,31,6,16,464,366,830
2014,8,31,6,17,419,378,797
2014,8,31,6,18,311,335,646
2014,8,31,6,19,132,110,242
2014,8,31,6,20,29,63,92
2014,8,31,6,21,24,50,74
2014,8,31,6,22,14,50,64
2014,8,31,6,23,49,92,141
2014,9,1,0,0,10,84,94
2014,9,1,0,1,5,43,48
2014,9,1,0,2,1,37,38
2014,9,1,0,3,1,8,9
2014,9,1,0,4,3,5,8
2014,9,1,0,5,3,12,15
2014,9,1,0,6,6,31,37
2014,9,1,0,7,7,66,73
2014,9,1,0,8,15,190,205
2014,9,1,0,9,45,369,414
2014,9,1,0,10,51,550,601
2014,9,1,0,11,71,668,739
2014,9,1,0,12,68,701,769
2014,9,1,0,13,48,698,746
2014,9,1,0,14,68,698,766
2014,9,1,0,15,92,669,761
2014,9,1,0,16,112,376,488
2014,9,1,0,17,160,420,580
2014,9,1,0,18,152,439,591
2014,9,1,0,19,122,426,548
2014,9,1,0,20,60,253,313
2014,9,1,0,21,76,185,261
2014,9,1,0,22,49,141,190
2014,9,1,0,23,29,82,111
2014,9,2,1,0,11,21,32
2014,9,2,1,1,5,11,16
2014,9,2,1,2,1,15,16
2014,9,2,1,3,0,2,2
2014,9,2,1,4,3,13,16
2014,9,2,1,5,8,66,74
2014,9,2,1,6,29,280,309
2014,9,2,1,7,51,693,744
2014,9,2,1,8,25,910,935
2014,9,2,1,9,8,460,468
2014,9,2,1,10,7,249,256
2014,9,2,1,11,1,298,299
2014,9,2,1,12,35,367,402
2014,9,2,1,13,37,330,367
2014,9,2,1,14,34,294,328
2014,9,2,1,15,25,350,375
2014,9,2,1,16,51,551,602
2014,9,2,1,17,107,1020,1127
2014,9,2,1,18,100,980,1080
2014,9,2,1,19,48,431,479
2014,9,2,1,20,43,194,237
2014,9,2,1,21,43,186,229
2014,9,2,1,22,58,146,204
2014,9,2,1,23,24,96,120
2014,9,3,2,0,5,18,23
2014,9,3,2,1,4,10,14
2014,9,3,2,2,1,11,12
2014,9,3,2,3,0,3,3
2014,9,3,2,4,3,8,11
2014,9,3,2,5,22,58,80
2014,9,3,2,6,88,239,327
2014,9,3,2,7,261,517,778
2014,9,3,2,8,405,750,1155
2014,9,3,2,9,96,357,453
2014,9,3,2,10,21,272,293
2014,9,3,2,11,21,294,315
2014,9,3,2,12,14,391,405
2014,9,3,2,13,11,407,418
2014,9,3,2,14,13,340,353
2014,9,3,2,15,12,378,390
2014,9,3,2,16,95,577,672
2014,9,3,2,17,342,942,1284
2014,9,3,2,18,380,807,1187
2014,9,3,2,19,296,594,890
2014,9,3,2,20,222,375,597
2014,9,3,2,21,138,274,412
2014,9,3,2,22,133,179,312
2014,9,3,2,23,62,98,160
2014,9,4,3,0,25,25,50
2014,9,4,3,1,12,16,28
2014,9,4,3,2,3,5,8
2014,9,4,3,3,1,4,5
2014,9,4,3,4,3,7,10
2014,9,4,3,5,31,37,68
2014,9,4,3,6,130,181,311
2014,9,4,3,7,315,465,780
2014,9,4,3,8,386,764,1150
2014,9,4,3,9,164,329,493
2014,9,4,3,10,107,170,277
2014,9,4,3,11,122,223,345
2014,9,4,3,12,165,296,461
2014,9,4,3,13,178,275,453
2014,9,4,3,14,105,275,380
2014,9,4,3,15,124,366,490
2014,9,4,3,16,108,564,672
2014,9,4,3,17,310,966,1276
2014,9,4,3,18,349,852,1201
2014,9,4,3,19,356,556,912
2014,9,4,3,20,239,379,618
2014,9,4,3,21,176,237,413
2014,9,4,3,22,113,170,283
2014,9,4,3,23,109,136,245
2014,9,5,4,0,43,54,97
2014,9,5,4,1,11,29,40
2014,9,5,4,2,5,11,16
2014,9,5,4,3,5,5,10
2014,9,5,4,4,3,6,9
2014,9,5,4,5,24,48,72
2014,9,5,4,6,135,178,313
2014,9,5,4,7,309,434,743
2014,9,5,4,8,454,677,1131
2014,9,5,4,9,229,285,514
2014,9,5,4,10,155,225,380
2014,9,5,4,11,161,246,407
2014,9,5,4,12,187,284,471
2014,9,5,4,13,197,331,528
2014,9,5,4,14,195,286,481
2014,9,5,4,15,194,318,512
2014,9,5,4,16,226,484,710
2014,9,5,4,17,195,1005,1200
2014,9,5,4,18,170,847,1017
2014,9,5,4,19,144,690,834
2014,9,5,4,20,80,495,575
2014,9,5,4,21,68,344,412
2014,9,5,4,22,60,300,360
2014,9,5,4,23,39,238,277
2014,9,6,5,0,38,170,208
2014,9,6,5,1,12,126,138
2014,9,6,5,2,9,70,79
2014,9,6,5,3,5,30,35
2014,9,6,5,4,2,13,15
2014,9,6,5,5,3,14,17
2014,9,6,5,6,9,52,61
2014,9,6,5,7,11,125,136
2014,9,6,5,8,42,278,320
2014,9,6,5,9,50,379,429
2014,9,6,5,10,157,489,646
2014,9,6,5,11,253,589,842
2014,9,6,5,12,292,519,811
2014,9,6,5,13,212,618,830
2014,9,6,5,14,254,574,828
2014,9,6,5,15,196,554,750
2014,9,6,5,16,69,597,666
2014,9,6,5,17,30,703,733
2014,9,6,5,18,17,704,721
2014,9,6,5,19,13,305,318
2014,9,6,5,20,11,195,206
2014,9,6,5,21,40,189,229
2014,9,6,5,22,31,194,225
2014,9,6,5,23,20,173,193
2014,9,7,6,0,18,176,194
2014,9,7,6,1,8,96,104
2014,9,7,6,2,7,89,96
2014,9,7,6,3,4,32,36
2014,9,7,6,4,1,16,17
2014,9,7,6,5,6,63,69
2014,9,7,6,6,10,71,81
2014,9,7,6,7,12,100,112
2014,9,7,6,8,17,265,282
2014,9,7,6,9,21,465,486
2014,9,7,6,10,33,684,717
2014,9,7,6,11,52,882,934
2014,9,7,6,12,118,977,1095
2014,9,7,6,13,103,783,886
2014,9,7,6,14,31,881,912
2014,9,7,6,15,31,847,878
2014,9,7,6,16,72,944,1016
2014,9,7,6,17,79,834,913
2014,9,7,6,18,102,720,822
2014,9,7,6,19,139,513,652
2014,9,7,6,20,132,286,418
2014,9,7,6,21,73,252,325
2014,9,7,6,22,40,179,219
2014,9,7,6,23,25,76,101
2014,9,8,0,0,14,30,44
2014,9,8,0,1,5,9,14
2014,9,8,0,2,3,3,6
2014,9,8,0,3,4,5,9
2014,9,8,0,4,2,9,11
2014,9,8,0,5,11,54,65
2014,9,8,0,6,61,252,313
2014,9,8,0,7,208,594,802
2014,9,8,0,8,50,1072,1122
2014,9,8,0,9,22,453,475
2014,9,8,0,10,14,280,294
2014,9,8,0,11,9,397,406
2014,9,8,0,12,5,438,443
2014,9,8,0,13,40,393,433
2014,9,8,0,14,28,364,392
2014,9,8,0,15,37,372,409
2014,9,8,0,16,74,604,678
2014,9,8,0,17,122,1196,1318
2014,9,8,0,18,119,1069,1188
2014,9,8,0,19,81,718,799
2014,9,8,0,20,58,432,490
2014,9,8,0,21,67,335,402
2014,9,8,0,22,56,214,270
2014,9,8,0,23,26,84,110
2014,9,9,1,0,5,37,42
2014,9,9,1,1,4,23,27
2014,9,9,1,2,2,4,6
2014,9,9,1,3,2,3,5
2014,9,9,1,4,1,7,8
2014,9,9,1,5,20,63,83
2014,9,9,1,6,78,256,334
2014,9,9,1,7,200,715,915
2014,9,9,1,8,253,912,1165
2014,9,9,1,9,24,438,462
2014,9,9,1,10,13,302,315
2014,9,9,1,11,10,305,315
2014,9,9,1,12,17,405,422
2014,9,9,1,13,12,412,424
2014,9,9,1,14,16,373,389
2014,9,9,1,15,8,421,429
2014,9,9,1,16,88,611,699
2014,9,9,1,17,148,1322,1470
2014,9,9,1,18,116,1144,1260
2014,9,9,1,19,104,719,823
2014,9,9,1,20,64,446,510
2014,9,9,1,21,63,362,425
2014,9,9,1,22,89,329,418
2014,9,9,1,23,34,110,144
2014,9,10,2,0,6,55,61
2014,9,10,2,1,6,19,25
2014,9,10,2,2,1,7,8
2014,9,10,2,3,0,2,2
2014,9,10,2,4,1,9,10
2014,9,10,2,5,28,66,94
2014,9,10,2,6,97,250,347
2014,9,10,2,7,215,676,891
2014,9,10,2,8,331,832,1163
2014,9,10,2,9,53,428,481
2014,9,10,2,10,25,302,327
2014,9,10,2,11,10,317,327
2014,9,10,2,12,10,404,414
2014,9,10,2,13,19,370,389
2014,9,10,2,14,19,368,387
2014,9,10,2,15,29,503,532
2014,9,10,2,16,198,539,737
2014,9,10,2,17,375,989,1364
2014,9,10,2,18,410,904,1314
2014,9,10,2,19,346,567,913
2014,9,10,2,20,195,404,599
2014,9,10,2,21,189,298,487
2014,9,10,2,22,113,200,313
2014,9,10,2,23,73,113,186
2014,9,11,3,0,23,49,72
2014,9,11,3,1,10,16,26
2014,9,11,3,2,3,5,8
2014,9,11,3,3,4,3,7
2014,9,11,3,4,5,9,14
2014,9,11,3,5,31,44,75
2014,9,11,3,6,108,213,321
2014,9,11,3,7,289,589,878
2014,9,11,3,8,363,765,1128
2014,9,11,3,9,186,358,544
2014,9,11,3,10,94,238,332
2014,9,11,3,11,131,232,363
2014,9,11,3,12,131,338,469
2014,9,11,3,13,92,322,414
2014,9,11,3,14,83,330,413
2014,9,11,3,15,105,346,451
2014,9,11,3,16,186,462,648
2014,9,11,3,17,432,900,1332
2014,9,11,3,18,475,789,1264
2014,9,11,3,19,353,508,861
2014,9,11,3,20,258,344,602
2014,9,11,3,21,162,225,387
2014,9,11,3,22,137,167,304
2014,9,11,3,23,94,101,195
2014,9,12,4,0,33,67,100
2014,9,12,4,1,11,28,39
2014,9,12,4,2,12,16,28
2014,9,12,4,3,7,4,11
2014,9,12,4,4,4,7,11
2014,9,12,4,5,33,38,71
2014,9,12,4,6,119,180,299
2014,9,12,4,7,312,475,787
2014,9,12,4,8,439,660,1099
2014,9,12,4,9,205,344,549
2014,9,12,4,10,131,237,368
2014,9,12,4,11,183,285,468
2014,9,12,4,12,213,401,614
2014,9,12,4,13,223,423,646
2014,9,12,4,14,169,433,602
2014,9,12,4,15,102,551,653
2014,9,12,4,16,123,773,896
2014,9,12,4,17,193,1156,1349
2014,9,12,4,18,187,1020,1207
2014,9,12,4,19,106,755,861
2014,9,12,4,20,97,473,570
2014,9,12,4,21,87,348,435
2014,9,12,4,22,88,261,349
2014,9,12,4,23,62,209,271
2014,9,13,5,0,54,149,203
2014,9,13,5,1,34,78,112
2014,9,13,5,2,15,58,73
2014,9,13,5,3,16,33,49
2014,9,13,5,4,7,10,17
2014,9,13,5,5,11,12,23
2014,9,13,5,6,13,31,44
2014,9,13,5,7,51,101,152
2014,9,13,5,8,97,226,323
2014,9,13,5,9,177,361,538
2014,9,13,5,10,174,509,683
2014,9,13,5,11,152,424,576
2014,9,13,5,12,145,386,531
2014,9,13,5,13,38,231,269
2014,9,13,5,14,11,180,191
2014,9,13,5,15,30,434,464
2014,9,13,5,16,26,562,588
2014,9,13,5,17,22,714,736
2014,9,13,5,18,49,735,784
2014,9,13,5,19,60,558,618
2014,9,13,5,20,37,399,436
2014,9,13,5,21,38,317,355
2014,9,13,5,22,29,235,264
2014,9,13,5,23,32,241,273
2014,9,14,6,0,15,196,211
2014,9,14,6,1,20,158,178
2014,9,14,6,2,15,119,134
2014,9,14,6,3,12,64,76
2014,9,14,6,4,3,22,25
2014,9,14,6,5,0,20,20
2014,9,14,6,6,8,62,70
2014,9,14,6,7,10,89,99
2014,9,14,6,8,35,241,276
2014,9,14,6,9,38,446,484
2014,9,14,6,10,79,667,746
2014,9,14,6,11,107,829,936
2014,9,14,6,12,217,831,1048
2014,9,14,6,13,251,789,1040
2014,9,14,6,14,233,799,1032
2014,9,14,6,15,127,927,1054
2014,9,14,6,16,39,1041,1080
2014,9,14,6,17,31,937,968
2014,9,14,6,18,91,808,899
2014,9,14,6,19,92,582,674
2014,9,14,6,20,36,370,406
2014,9,14,6,21,30,266,296
2014,9,14,6,22,35,165,200
2014,9,14,6,23,10,89,99
2014,9,15,0,0,6,29,35
2014,9,15,0,1,2,12,14
2014,9,15,0,2,0,10,10
2014,9,15,0,3,0,5,5
2014,9,15,0,4,0,9,9
2014,9,15,0,5,10,66,76
2014,9,15,0,6,31,269,300
2014,9,15,0,7,82,778,860
2014,9,15,0,8,127,991,1118
2014,9,15,0,9,63,399,462
2014,9,15,0,10,57,238,295
2014,9,15,0,11,80,303,383
2014,9,15,0,12,143,369,512
2014,9,15,0,13,148,369,517
2014,9,15,0,14,150,349,499
2014,9,15,0,15,149,388,537
2014,9,15,0,16,233,600,833
2014,9,15,0,17,75,1348,1423
2014,9,15,0,18,48,1258,1306
2014,9,15,0,19,90,842,932
2014,9,15,0,20,81,522,603
2014,9,15,0,21,52,331,383
2014,9,15,0,22,29,207,236
2014,9,15,0,23,18,111,129
2014,9,16,1,0,9,54,63
2014,9,16,1,1,4,25,29
2014,9,16,1,2,3,3,6
2014,9,16,1,3,1,4,5
2014,9,16,1,4,0,13,13
2014,9,16,1,5,8,71,79
2014,9,16,1,6,50,306,356
2014,9,16,1,7,121,871,992
2014,9,16,1,8,164,1057,1221
2014,9,16,1,9,81,489,570
2014,9,16,1,10,64,270,334
2014,9,16,1,11,87,315,402
2014,9,16,1,12,149,369,518
2014,9,16,1,13,145,324,469
2014,9,16,1,14,131,298,429
2014,9,16,1,15,148,416,564
2014,9,16,1,16,238,562,800
2014,9,16,1,17,155,1360,1515
2014,9,16,1,18,61,1389,1450
2014,9,16,1,19,89,841,930
2014,9,16,1,20,85,546,631
2014,9,16,1,21,71,378,449
2014,9,16,1,22,43,256,299
2014,9,16,1,23,16,122,138
2014,9,17,2,0,8,41,49
2014,9,17,2,1,5,18,23
2014,9,17,2,2,2,7,9
2014,9,17,2,3,2,3,5
2014,9,17,2,4,4,9,13
2014,9,17,2,5,14,65,79
2014,9,17,2,6,40,317,357
2014,9,17,2,7,98,841,939
2014,9,17,2,8,151,1079,1230
2014,9,17,2,9,81,431,512
2014,9,17,2,10,68,284,352
2014,9,17,2,11,104,303,407
2014,9,17,2,12,162,322,484
2014,9,17,2,13,180,336,516
2014,9,17,2,14,122,312,434
2014,9,17,2,15,172,357,529
2014,9,17,2,16,246,542,788
2014,9,17,2,17,78,1333,1411
2014,9,17,2,18,50,1244,1294
2014,9,17,2,19,238,666,904
2014,9,17,2,20,151,422,573
2014,9,17,2,21,149,289,438
2014,9,17,2,22,98,178,276
2014,9,17,2,23,61,81,142
2014,9,18,3,0,12,40,52
2014,9,18,3,1,5,20,25
2014,9,18,3,2,3,0,3
2014,9,18,3,3,2,3,5
2014,9,18,3,4,6,7,13
2014,9,18,3,5,24,54,78
2014,9,18,3,6,116,207,323
2014,9,18,3,7,348,542,890
2014,9,18,3,8,447,708,1155
2014,9,18,3,9,211,323,534
2014,9,18,3,10,107,192,299
2014,9,18,3,11,134,261,395
2014,9,18,3,12,200,298,498
2014,9,18,3,13,208,321,529
2014,9,18,3,14,180,304,484
2014,9,18,3,15,167,339,506
2014,9,18,3,16,295,492,787
2014,9,18,3,17,468,915,1383
2014,9,18,3,18,326,926,1252
2014,9,18,3,19,199,703,902
2014,9,18,3,20,120,433,553
2014,9,18,3,21,112,348,460
2014,9,18,3,22,91,229,320
2014,9,18,3,23,50,131,181
2014,9,19,4,0,23,72,95
2014,9,19,4,1,13,34,47
2014,9,19,4,2,9,18,27
2014,9,19,4,3,3,4,7
2014,9,19,4,4,5,12,17
2014,9,19,4,5,23,60,83
2014,9,19,4,6,98,216,314
2014,9,19,4,7,230,512,742
2014,9,19,4,8,350,803,1153
2014,9,19,4,9,166,405,571
2014,9,19,4,10,99,262,361
2014,9,19,4,11,146,323,469
2014,9,19,4,12,158,456,614
2014,9,19,4,13,151,473,624
2014,9,19,4,14,127,468,595
2014,9,19,4,15,100,564,664
2014,9,19,4,16,133,778,911
2014,9,19,4,17,202,1127,1329
2014,9,19,4,18,168,944,1112
2014,9,19,4,19,130,671,801
2014,9,19,4,20,80,389,469
2014,9,19,4,21,53,323,376
2014,9,19,4,22,72,276,348
2014,9,19,4,23,52,191,243
2014,9,20,5,0,55,142,197
2014,9,20,5,1,39,95,134
2014,9,20,5,2,36,53,89
2014,9,20,5,3,10,26,36
2014,9,20,5,4,2,14,16
2014,9,20,5,5,5,9,14
2014,9,20,5,6,10,32,42
2014,9,20,5,7,41,107,148
2014,9,20,5,8,121,206,327
2014,9,20,5,9,184,400,584
2014,9,20,5,10,233,601,834
2014,9,20,5,11,285,691,976
2014,9,20,5,12,168,877,1045
2014,9,20,5,13,53,1091,1144
2014,9,20,5,14,54,1017,1071
2014,9,20,5,15,102,935,1037
2014,9,20,5,16,120,879,999
2014,9,20,5,17,107,890,997
2014,9,20,5,18,85,820,905
2014,9,20,5,19,85,719,804
2014,9,20,5,20,46,403,449
2014,9,20,5,21,69,362,431
2014,9,20,5,22,58,250,308
2014,9,20,5,23,50,198,248
2014,9,21,6,0,59,174,233
2014,9,21,6,1,35,117,152
2014,9,21,6,2,23,90,113
2014,9,21,6,3,16,43,59
2014,9,21,6,4,4,6,10
2014,9,21,6,5,3,12,15
2014,9,21,6,6,4,26,30
2014,9,21,6,7,17,91,108
2014,9,21,6,8,61,194,255
2014,9,21,6,9,93,391,484
2014,9,21,6,10,153,620,773
2014,9,21,6,11,50,815,865
2014,9,21,6,12,36,956,992
2014,9,21,6,13,68,881,949
2014,9,21,6,14,147,704,851
2014,9,21,6,15,118,746,864
2014,9,21,6,16,120,821,941
2014,9,21,6,17,82,804,886
2014,9,21,6,18,70,707,777
2014,9,21,6,19,78,498,576
2014,9,21,6,20,34,330,364
2014,9,21,6,21,26,227,253
2014,9,21,6,22,33,180,213
2014,9,21,6,23,20,85,105
2014,9,22,0,0,6,56,62
2014,9,22,0,1,2,16,18
2014,9,22,0,2,2,6,8
2014,9,22,0,3,0,9,9
2014,9,22,0,4,5,9,14
2014,9,22,0,5,11,82,93
2014,9,22,0,6,57,228,285
2014,9,22,0,7,190,669,859
2014,9,22,0,8,249,917,1166
2014,9,22,0,9,44,493,537
2014,9,22,0,10,16,287,303
2014,9,22,0,11,16,388,404
2014,9,22,0,12,15,453,468
2014,9,22,0,13,13,423,436
2014,9,22,0,14,15,419,434
2014,9,22,0,15,35,427,462
2014,9,22,0,16,94,720,814
2014,9,22,0,17,191,1284,1475
2014,9,22,0,18,149,1147,1296
2014,9,22,0,19,83,692,775
2014,9,22,0,20,67,446,513
2014,9,22,0,21,33,335,368
2014,9,22,0,22,31,216,247
2014,9,22,0,23,17,77,94
2014,9,23,1,0,9,37,46
2014,9,23,1,1,2,12,14
2014,9,23,1,2,1,5,6
2014,9,23,1,3,0,1,1
2014,9,23,1,4,0,5,5
2014,9,23,1,5,13,70,83
2014,9,23,1,6,79,286,365
2014,9,23,1,7,240,669,909
2014,9,23,1,8,298,925,1223
2014,9,23,1,9,43,481,524
2014,9,23,1,10,14,327,341
2014,9,23,1,11,19,351,370
2014,9,23,1,12,16,442,458
2014,9,23,1,13,21,493,514
2014,9,23,1,14,13,428,441
2014,9,23,1,15,68,429,497
2014,9,23,1,16,107,666,773
2014,9,23,1,17,175,1303,1478
2014,9,23,1,18,144,1210,1354
2014,9,23,1,19,113,750,863
2014,9,23,1,20,141,428,569
2014,9,23,1,21,139,272,411
2014,9,23,1,22,117,215,332
2014,9,23,1,23,64,89,153
2014,9,24,2,0,21,33,54
2014,9,24,2,1,2,10,12
2014,9,24,2,2,4,7,11
2014,9,24,2,3,2,4,6
2014,9,24,2,4,3,6,9
2014,9,24,2,5,32,47,79
2014,9,24,2,6,120,187,307
2014,9,24,2,7,316,556,872
2014,9,24,2,8,114,1138,1252
2014,9,24,2,9,20,507,527
2014,9,24,2,10,16,337,353
2014,9,24,2,11,12,411,423
2014,9,24,2,12,92,422,514
2014,9,24,2,13,160,302,462
2014,9,24,2,14,127,284,411
2014,9,24,2,15,135,378,513
2014,9,24,2,16,227,493,720
2014,9,24,2,17,378,773,1151
2014,9,24,2,18,152,386,538
2014,9,24,2,19,128,220,348
2014,9,24,2,20,112,191,303
2014,9,24,2,21,98,162,260
2014,9,24,2,22,58,106,164
2014,9,24,2,23,40,68,108
2014,9,25,3,0,9,23,32
2014,9,25,3,1,2,3,5
2014,9,25,3,2,1,2,3
2014,9,25,3,3,1,1,2
2014,9,25,3,4,1,1,2
2014,9,25,3,5,9,15,24
2014,9,25,3,6,20,46,66
2014,9,25,3,7,73,118,191
2014,9,25,3,8,157,302,459
2014,9,25,3,9,127,216,343
2014,9,25,3,10,36,90,126
2014,9,25,3,11,53,89,142
2014,9,25,3,12,52,90,142
2014,9,25,3,13,58,109,167
2014,9,25,3,14,65,127,192
2014,9,25,3,15,122,206,328
2014,9,25,3,16,167,391,558
2014,9,25,3,17,340,700,1040
2014,9,25,3,18,317,668,985
2014,9,25,3,19,181,425,606
2014,9,25,3,20,99,340,439
2014,9,25,3,21,44,281,325
2014,9,25,3,22,62,283,345
2014,9,25,3,23,41,154,195
2014,9,26,4,0,15,88,103
2014,9,26,4,1,7,33,40
2014,9,26,4,2,2,18,20
2014,9,26,4,3,3,4,7
2014,9,26,4,4,1,6,7
2014,9,26,4,5,20,49,69
2014,9,26,4,6,62,208,270
2014,9,26,4,7,221,465,686
2014,9,26,4,8,387,772,1159
2014,9,26,4,9,213,365,578
2014,9,26,4,10,133,265,398
2014,9,26,4,11,189,400,589
2014,9,26,4,12,263,422,685
2014,9,26,4,13,225,399,624
2014,9,26,4,14,233,438,671
2014,9,26,4,15,211,477,688
2014,9,26,4,16,279,594,873
2014,9,26,4,17,215,1178,1393
2014,9,26,4,18,211,977,1188
2014,9,26,4,19,161,555,716
2014,9,26,4,20,65,424,489
2014,9,26,4,21,61,336,397
2014,9,26,4,22,52,321,373
2014,9,26,4,23,30,234,264
2014,9,27,5,0,32,135,167
2014,9,27,5,1,13,91,104
2014,9,27,5,2,19,81,100
2014,9,27,5,3,3,44,47
2014,9,27,5,4,3,8,11
2014,9,27,5,5,1,13,14
2014,9,27,5,6,7,48,55
2014,9,27,5,7,28,128,156
2014,9,27,5,8,62,257,319
2014,9,27,5,9,58,474,532
2014,9,27,5,10,174,622,796
2014,9,27,5,11,259,660,919
2014,9,27,5,12,276,783,1059
2014,9,27,5,13,219,877,1096
2014,9,27,5,14,57,1065,1122
2014,9,27,5,15,46,1017,1063
2014,9,27,5,16,136,910,1046
2014,9,27,5,17,132,849,981
2014,9,27,5,18,105,762,867
2014,9,27,5,19,73,667,740
2014,9,27,5,20,60,454,514
2014,9,27,5,21,45,359,404
2014,9,27,5,22,36,312,348
2014,9,27,5,23,43,278,321
2014,9,28,6,0,37,218,255
2014,9,28,6,1,39,136,175
2014,9,28,6,2,25,95,120
2014,9,28,6,3,22,40,62
2014,9,28,6,4,7,9,16
2014,9,28,6,5,6,5,11
2014,9,28,6,6,6,22,28
2014,9,28,6,7,24,50,74
2014,9,28,6,8,68,160,228
2014,9,28,6,9,131,317,448
2014,9,28,6,10,153,533,686
2014,9,28,6,11,247,643,890
2014,9,28,6,12,106,940,1046
2014,9,28,6,13,34,937,971
2014,9,28,6,14,43,791,834
2014,9,28,6,15,130,762,892
2014,9,28,6,16,109,837,946
2014,9,28,6,17,110,773,883
2014,9,28,6,18,92,699,791
2014,9,28,6,19,52,571,623
2014,9,28,6,20,64,391,455
2014,9,28,6,21,31,275,306
2014,9,28,6,22,27,177,204
2014,9,28,6,23,17,73,90
2014,9,29,0,0,1,24,25
2014,9,29,0,1,5,15,20
2014,9,29,0,2,1,9,10
2014,9,29,0,3,3,4,7
2014,9,29,0,4,1,7,8
2014,9,29,0,5,18,62,80
2014,9,29,0,6,51,210,261
2014,9,29,0,7,193,632,825
2014,9,29,0,8,288,869,1157
2014,9,29,0,9,103,381,484
2014,9,29,0,10,23,321,344
2014,9,29,0,11,25,361,386
2014,9,29,0,12,18,427,445
2014,9,29,0,13,21,448,469
2014,9,29,0,14,19,403,422
2014,9,29,0,15,26,439,465
2014,9,29,0,16,123,620,743
2014,9,29,0,17,157,1215,1372
2014,9,29,0,18,136,1095,1231
2014,9,29,0,19,156,622,778
2014,9,29,0,20,170,357,527
2014,9,29,0,21,122,232,354
2014,9,29,0,22,58,140,198
2014,9,29,0,23,34,94,128
2014,9,30,1,0,12,26,38
2014,9,30,1,1,2,15,17
2014,9,30,1,2,0,11,11
2014,9,30,1,3,0,2,2
2014,9,30,1,4,3,11,14
2014,9,30,1,5,26,56,82
2014,9,30,1,6,127,203,330
2014,9,30,1,7,166,758,924
2014,9,30,1,8,52,1256,1308
2014,9,30,1,9,32,545,577
2014,9,30,1,10,105,274,379
2014,9,30,1,11,106,279,385
2014,9,30,1,12,156,321,477
2014,9,30,1,13,148,321,469
2014,9,30,1,14,138,295,433
2014,9,30,1,15,198,367,565
2014,9,30,1,16,331,457,788
2014,9,30,1,17,642,749,1391
2014,9,30,1,18,584,727,1311
2014,9,30,1,19,400,486,886
2014,9,30,1,20,252,347,599
2014,9,30,1,21,174,273,447
2014,9,30,1,22,51,164,215
2014,9,30,1,23,41,75,116
2014,10,1,2,0,3,26,29
2014,10,1,2,1,2,21,23
2014,10,1,2,2,1,12,13
2014,10,1,2,3,0,4,4
2014,10,1,2,4,2,9,11
2014,10,1,2,5,1,98,99
2014,10,1,2,6,3,186,189
2014,10,1,2,7,15,585,600
2014,10,1,2,8,36,953,989
2014,10,1,2,9,43,465,508
2014,10,1,2,10,92,254,346
2014,10,1,2,11,84,256,340
2014,10,1,2,12,100,334,434
2014,10,1,2,13,77,340,417
2014,10,1,2,14,93,307,400
2014,10,1,2,15,96,359,455
2014,10,1,2,16,113,680,793
2014,10,1,2,17,155,1324,1479
2014,10,1,2,18,109,1110,1219
2014,10,1,2,19,89,773,862
2014,10,1,2,20,54,477,531
2014,10,1,2,21,28,423,451
2014,10,1,2,22,20,288,308
2014,10,1,2,23,13,144,157
2014,10,2,3,0,9,42,51
2014,10,2,3,1,2,22,24
2014,10,2,3,2,0,8,8
2014,10,2,3,3,0,2,2
2014,10,2,3,4,2,12,14
2014,10,2,3,5,3,72,75
2014,10,2,3,6,6,314,320
2014,10,2,3,7,22,817,839
2014,10,2,3,8,38,1190,1228
2014,10,2,3,9,67,441,508
2014,10,2,3,10,88,235,323
2014,10,2,3,11,135,311,446
2014,10,2,3,12,96,354,450
2014,10,2,3,13,103,378,481
2014,10,2,3,14,118,349,467
2014,10,2,3,15,147,429,576
2014,10,2,3,16,135,668,803
2014,10,2,3,17,175,1300,1475
2014,10,2,3,18,113,1132,1245
2014,10,2,3,19,78,810,888
2014,10,2,3,20,73,508,581
2014,10,2,3,21,44,458,502
2014,10,2,3,22,29,293,322
2014,10,2,3,23,21,185,206
2014,10,3,4,0,14,82,96
2014,10,3,4,1,9,44,53
2014,10,3,4,2,2,15,17
2014,10,3,4,3,1,9,10
2014,10,3,4,4,2,17,19
2014,10,3,4,5,2,77,79
2014,10,3,4,6,6,271,277
2014,10,3,4,7,20,761,781
2014,10,3,4,8,57,1162,1219
2014,10,3,4,9,96,503,599
2014,10,3,4,10,96,305,401
2014,10,3,4,11,132,341,473
2014,10,3,4,12,147,448,595
2014,10,3,4,13,192,469,661
2014,10,3,4,14,175,469,644
2014,10,3,4,15,145,442,587
2014,10,3,4,16,136,645,781
2014,10,3,4,17,159,1086,1245
2014,10,3,4,18,94,795,889
2014,10,3,4,19,123,734,857
2014,10,3,4,20,44,262,306
2014,10,3,4,21,11,131,142
2014,10,3,4,22,17,177,194
2014,10,3,4,23,8,114,122
2014,10,4,5,0,1,72,73
2014,10,4,5,1,4,86,90
2014,10,4,5,2,6,42,48
2014,10,4,5,3,10,22,32
2014,10,4,5,4,8,9,17
2014,10,4,5,5,3,18,21
2014,10,4,5,6,12,45,57
2014,10,4,5,7,9,100,109
2014,10,4,5,8,41,212,253
2014,10,4,5,9,108,389,497
2014,10,4,5,10,189,472,661
2014,10,4,5,11,278,535,813
2014,10,4,5,12,339,611,950
2014,10,4,5,13,355,674,1029
2014,10,4,5,14,349,560,909
2014,10,4,5,15,412,669,1081
2014,10,4,5,16,356,644,1000
2014,10,4,5,17,325,597,922
2014,10,4,5,18,251,504,755
2014,10,4,5,19,98,348,446
2014,10,4,5,20,80,241,321
2014,10,4,5,21,59,175,234
2014,10,4,5,22,46,196,242
2014,10,4,5,23,32,162,194
2014,10,5,6,0,37,236,273
2014,10,5,6,1,18,100,118
2014,10,5,6,2,12,73,85
2014,10,5,6,3,6,34,40
2014,10,5,6,4,6,12,18
2014,10,5,6,5,1,16,17
2014,10,5,6,6,3,16,19
2014,10,5,6,7,8,69,77
2014,10,5,6,8,26,164,190
2014,10,5,6,9,91,280,371
2014,10,5,6,10,204,427,631
2014,10,5,6,11,271,491,762
2014,10,5,6,12,317,620,937
2014,10,5,6,13,265,601,866
2014,10,5,6,14,264,616,880
2014,10,5,6,15,305,558,863
2014,10,5,6,16,287,538,825
2014,10,5,6,17,279,570,849
2014,10,5,6,18,144,514,658
2014,10,5,6,19,86,369,455
2014,10,5,6,20,83,267,350
2014,10,5,6,21,35,163,198
2014,10,5,6,22,42,144,186
2014,10,5,6,23,19,76,95
2014,10,6,0,0,21,33,54
2014,10,6,0,1,9,15,24
2014,10,6,0,2,10,7,17
2014,10,6,0,3,1,1,2
2014,10,6,0,4,2,8,10
2014,10,6,0,5,1,80,81
2014,10,6,0,6,1,272,273
2014,10,6,0,7,21,759,780
2014,10,6,0,8,57,1015,1072
2014,10,6,0,9,65,410,475
2014,10,6,0,10,89,199,288
2014,10,6,0,11,107,244,351
2014,10,6,0,12,130,342,472
2014,10,6,0,13,161,324,485
2014,10,6,0,14,178,278,456
2014,10,6,0,15,151,347,498
2014,10,6,0,16,176,691,867
2014,10,6,0,17,168,1301,1469
2014,10,6,0,18,115,1080,1195
2014,10,6,0,19,68,666,734
2014,10,6,0,20,58,424,482
2014,10,6,0,21,22,295,317
2014,10,6,0,22,33,211,244
2014,10,6,0,23,12,103,115
2014,10,7,1,0,17,47,64
2014,10,7,1,1,6,18,24
2014,10,7,1,2,1,6,7
2014,10,7,1,3,2,4,6
2014,10,7,1,4,1,12,13
2014,10,7,1,5,1,80,81
2014,10,7,1,6,3,305,308
2014,10,7,1,7,30,815,845
2014,10,7,1,8,43,1188,1231
2014,10,7,1,9,68,450,518
2014,10,7,1,10,83,203,286
2014,10,7,1,11,74,209,283
2014,10,7,1,12,71,276,347
2014,10,7,1,13,96,245,341
2014,10,7,1,14,84,228,312
2014,10,7,1,15,100,352,452
2014,10,7,1,16,116,629,745
2014,10,7,1,17,148,1216,1364
2014,10,7,1,18,94,1071,1165
2014,10,7,1,19,47,458,505
2014,10,7,1,20,15,257,272
2014,10,7,1,21,13,247,260
2014,10,7,1,22,4,65,69
2014,10,7,1,23,5,78,83
2014,10,8,2,0,6,56,62
2014,10,8,2,1,0,19,19
2014,10,8,2,2,3,10,13
2014,10,8,2,3,0,3,3
2014,10,8,2,4,0,13,13
2014,10,8,2,5,2,100,102
2014,10,8,2,6,9,335,344
2014,10,8,2,7,25,825,850
2014,10,8,2,8,41,1179,1220
2014,10,8,2,9,70,455,525
2014,10,8,2,10,104,225,329
2014,10,8,2,11,105,267,372
2014,10,8,2,12,97,345,442
2014,10,8,2,13,105,330,435
2014,10,8,2,14,82,341,423
2014,10,8,2,15,132,394,526
2014,10,8,2,16,140,662,802
2014,10,8,2,17,142,1276,1418
2014,10,8,2,18,109,1137,1246
2014,10,8,2,19,91,697,788
2014,10,8,2,20,53,479,532
2014,10,8,2,21,55,385,440
2014,10,8,2,22,38,258,296
2014,10,8,2,23,26,139,165
2014,10,9,3,0,10,45,55
2014,10,9,3,1,0,22,22
2014,10,9,3,2,2,7,9
2014,10,9,3,3,2,4,6
2014,10,9,3,4,0,9,9
2014,10,9,3,5,1,82,83
2014,10,9,3,6,6,283,289
2014,10,9,3,7,16,787,803
2014,10,9,3,8,44,1133,1177
2014,10,9,3,9,64,486,550
2014,10,9,3,10,116,248,364
2014,10,9,3,11,100,308,408
2014,10,9,3,12,158,361,519
2014,10,9,3,13,119,377,496
2014,10,9,3,14,158,317,475
2014,10,9,3,15,130,379,509
2014,10,9,3,16,151,647,798
2014,10,9,3,17,160,1202,1362
2014,10,9,3,18,131,1107,1238
2014,10,9,3,19,66,695,761
2014,10,9,3,20,55,433,488
2014,10,9,3,21,49,328,377
2014,10,9,3,22,55,312,367
2014,10,9,3,23,21,170,191
2014,10,10,4,0,14,90,104
2014,10,10,4,1,3,30,33
2014,10,10,4,2,10,22,32
2014,10,10,4,3,1,5,6
2014,10,10,4,4,0,10,10
2014,10,10,4,5,4,69,73
2014,10,10,4,6,8,218,226
2014,10,10,4,7,24,568,592
2014,10,10,4,8,49,1047,1096
2014,10,10,4,9,85,538,623
2014,10,10,4,10,123,272,395
2014,10,10,4,11,169,295,464
2014,10,10,4,12,64,231,295
2014,10,10,4,13,88,219,307
2014,10,10,4,14,101,221,322
2014,10,10,4,15,119,216,335
2014,10,10,4,16,104,415,519
2014,10,10,4,17,103,761,864
2014,10,10,4,18,77,690,767
2014,10,10,4,19,53,459,512
2014,10,10,4,20,48,237,285
2014,10,10,4,21,38,164,202
2014,10,10,4,22,12,89,101
2014,10,10,4,23,7,73,80
2014,10,11,5,0,6,60,66
2014,10,11,5,1,7,57,64
2014,10,11,5,2,2,42,44
2014,10,11,5,3,5,17,22
2014,10,11,5,4,0,9,9
2014,10,11,5,5,1,6,7
2014,10,11,5,6,1,12,13
2014,10,11,5,7,1,20,21
2014,10,11,5,8,8,69,77
2014,10,11,5,9,43,111,154
2014,10,11,5,10,37,148,185
2014,10,11,5,11,51,242,293
2014,10,11,5,12,105,254,359
2014,10,11,5,13,77,303,380
2014,10,11,5,14,134,323,457
2014,10,11,5,15,202,396,598
2014,10,11,5,16,197,398,595
2014,10,11,5,17,210,373,583
2014,10,11,5,18,164,370,534
2014,10,11,5,19,80,266,346
2014,10,11,5,20,80,211,291
2014,10,11,5,21,72,200,272
2014,10,11,5,22,48,171,219
2014,10,11,5,23,40,145,185
2014,10,12,6,0,29,128,157
2014,10,12,6,1,18,99,117
2014,10,12,6,2,8,70,78
2014,10,12,6,3,4,35,39
2014,10,12,6,4,2,12,14
2014,10,12,6,5,0,9,9
2014,10,12,6,6,6,37,43
2014,10,12,6,7,17,66,83
2014,10,12,6,8,24,166,190
2014,10,12,6,9,105,259,364
2014,10,12,6,10,230,375,605
2014,10,12,6,11,347,518,865
2014,10,12,6,12,396,543,939
2014,10,12,6,13,386,494,880
2014,10,12,6,14,390,489,879
2014,10,12,6,15,375,499,874
2014,10,12,6,16,320,471,791
2014,10,12,6,17,275,458,733
2014,10,12,6,18,213,406,619
2014,10,12,6,19,110,309,419
2014,10,12,6,20,99,202,301
2014,10,12,6,21,56,146,202
2014,10,12,6,22,46,135,181
2014,10,12,6,23,36,109,145
2014,10,13,0,0,15,67,82
2014,10,13,0,1,4,35,39
2014,10,13,0,2,5,13,18
2014,10,13,0,3,1,9,10
2014,10,13,0,4,4,12,16
2014,10,13,0,5,0,33,33
2014,10,13,0,6,4,92,96
2014,10,13,0,7,7,271,278
2014,10,13,0,8,32,439,471
2014,10,13,0,9,78,290,368
2014,10,13,0,10,51,188,239
2014,10,13,0,11,31,105,136
2014,10,13,0,12,72,218,290
2014,10,13,0,13,83,258,341
2014,10,13,0,14,100,279,379
2014,10,13,0,15,95,295,390
2014,10,13,0,16,112,430,542
2014,10,13,0,17,112,638,750
2014,10,13,0,18,81,703,784
2014,10,13,0,19,62,480,542
2014,10,13,0,20,41,304,345
2014,10,13,0,21,27,207,234
2014,10,13,0,22,36,155,191
2014,10,13,0,23,27,94,121
2014,10,14,1,0,5,45,50
2014,10,14,1,1,8,17,25
2014,10,14,1,2,3,8,11
2014,10,14,1,3,2,4,6
2014,10,14,1,4,1,11,12
2014,10,14,1,5,2,78,80
2014,10,14,1,6,5,293,298
2014,10,14,1,7,19,762,781
2014,10,14,1,8,50,1049,1099
2014,10,14,1,9,61,455,516
2014,10,14,1,10,101,222,323
2014,10,14,1,11,98,257,355
2014,10,14,1,12,117,312,429
2014,10,14,1,13,152,326,478
2014,10,14,1,14,172,322,494
2014,10,14,1,15,149,399,548
2014,10,14,1,16,157,578,735
2014,10,14,1,17,140,1245,1385
2014,10,14,1,18,96,1157,1253
2014,10,14,1,19,85,721,806
2014,10,14,1,20,55,481,536
2014,10,14,1,21,40,341,381
2014,10,14,1,22,20,261,281
2014,10,14,1,23,22,116,138
2014,10,15,2,0,9,46,55
2014,10,15,2,1,5,20,25
2014,10,15,2,2,0,9,9
2014,10,15,2,3,0,3,3
2014,10,15,2,4,0,12,12
2014,10,15,2,5,0,84,84
2014,10,15,2,6,14,289,303
2014,10,15,2,7,11,707,718
2014,10,15,2,8,28,1044,1072
2014,10,15,2,9,57,501,558
2014,10,15,2,10,68,225,293
2014,10,15,2,11,77,244,321
2014,10,15,2,12,29,152,181
2014,10,15,2,13,15,99,114
2014,10,15,2,14,10,62,72
2014,10,15,2,15,5,37,42
2014,10,15,2,16,20,141,161
2014,10,15,2,17,24,544,568
2014,10,15,2,18,28,473,501
2014,10,15,2,19,7,232,239
2014,10,15,2,20,11,321,332
2014,10,15,2,21,9,206,215
2014,10,15,2,22,11,164,175
2014,10,15,2,23,6,98,104
2014,10,16,3,0,3,39,42
2014,10,16,3,1,5,22,27
2014,10,16,3,2,0,11,11
2014,10,16,3,3,0,2,2
2014,10,16,3,4,2,13,15
2014,10,16,3,5,3,70,73
2014,10,16,3,6,6,279,285
2014,10,16,3,7,7,694,701
2014,10,16,3,8,39,1026,1065
2014,10,16,3,9,38,433,471
2014,10,16,3,10,56,226,282
2014,10,16,3,11,67,275,342
2014,10,16,3,12,75,339,414
2014,10,16,3,13,95,313,408
2014,10,16,3,14,74,235,309
2014,10,16,3,15,99,361,460
2014,10,16,3,16,120,595,715
2014,10,16,3,17,138,1122,1260
2014,10,16,3,18,97,1097,1194
2014,10,16,3,19,63,615,678
2014,10,16,3,20,62,428,490
2014,10,16,3,21,72,374,446
2014,10,16,3,22,36,287,323
2014,10,16,3,23,23,146,169
2014,10,17,4,0,22,78,100
2014,10,17,4,1,13,37,50
2014,10,17,4,2,4,8,12
2014,10,17,4,3,5,3,8
2014,10,17,4,4,0,11,11
2014,10,17,4,5,0,65,65
2014,10,17,4,6,1,189,190
2014,10,17,4,7,25,626,651
2014,10,17,4,8,63,1106,1169
2014,10,17,4,9,113,465,578
2014,10,17,4,10,157,259,416
2014,10,17,4,11,215,319,534
2014,10,17,4,12,239,452,691
2014,10,17,4,13,236,419,655
2014,10,17,4,14,270,391,661
2014,10,17,4,15,273,456,729
2014,10,17,4,16,247,673,920
2014,10,17,4,17,229,1163,1392
2014,10,17,4,18,168,944,1112
2014,10,17,4,19,130,607,737
2014,10,17,4,20,84,390,474
2014,10,17,4,21,51,296,347
2014,10,17,4,22,60,245,305
2014,10,17,4,23,55,212,267
2014,10,18,5,0,34,159,193
2014,10,18,5,1,30,100,130
2014,10,18,5,2,23,80,103
2014,10,18,5,3,10,31,41
2014,10,18,5,4,1,17,18
2014,10,18,5,5,1,12,13
2014,10,18,5,6,10,38,48
2014,10,18,5,7,29,95,124
2014,10,18,5,8,55,234,289
2014,10,18,5,9,139,347,486
2014,10,18,5,10,244,449,693
2014,10,18,5,11,373,510,883
2014,10,18,5,12,384,557,941
2014,10,18,5,13,417,545,962
2014,10,18,5,14,450,584,1034
2014,10,18,5,15,459,588,1047
2014,10,18,5,16,381,553,934
2014,10,18,5,17,338,493,831
2014,10,18,5,18,208,400,608
2014,10,18,5,19,108,337,445
2014,10,18,5,20,76,250,326
2014,10,18,5,21,75,254,329
2014,10,18,5,22,62,199,261
2014,10,18,5,23,31,170,201
2014,10,19,6,0,31,163,194
2014,10,19,6,1,25,114,139
2014,10,19,6,2,26,91,117
2014,10,19,6,3,9,48,57
2014,10,19,6,4,2,9,11
2014,10,19,6,5,2,15,17
2014,10,19,6,6,5,16,21
2014,10,19,6,7,22,67,89
2014,10,19,6,8,31,111,142
2014,10,19,6,9,98,272,370
2014,10,19,6,10,149,417,566
2014,10,19,6,11,180,460,640
2014,10,19,6,12,213,573,786
2014,10,19,6,13,242,492,734
2014,10,19,6,14,223,452,675
2014,10,19,6,15,245,501,746
2014,10,19,6,16,215,485,700
2014,10,19,6,17,238,431,669
2014,10,19,6,18,125,443,568
2014,10,19,6,19,85,269,354
2014,10,19,6,20,40,196,236
2014,10,19,6,21,29,147,176
2014,10,19,6,22,21,107,128
2014,10,19,6,23,18,68,86
2014,10,20,0,0,6,21,27
2014,10,20,0,1,2,20,22
2014,10,20,0,2,0,5,5
2014,10,20,0,3,0,4,4
2014,10,20,0,4,0,8,8
2014,10,20,0,5,0,55,55
2014,10,20,0,6,5,245,250
2014,10,20,0,7,15,631,646
2014,10,20,0,8,46,1097,1143
2014,10,20,0,9,60,422,482
2014,10,20,0,10,61,196,257
2014,10,20,0,11,80,232,312
2014,10,20,0,12,86,283,369
2014,10,20,0,13,92,307,399
2014,10,20,0,14,119,287,406
2014,10,20,0,15,106,317,423
2014,10,20,0,16,124,555,679
2014,10,20,0,17,129,1156,1285
2014,10,20,0,18,91,970,1061
2014,10,20,0,19,56,621,677
2014,10,20,0,20,42,393,435
2014,10,20,0,21,32,291,323
2014,10,20,0,22,35,153,188
2014,10,20,0,23,16,60,76
2014,10,21,1,0,4,33,37
2014,10,21,1,1,0,16,16
2014,10,21,1,2,0,6,6
2014,10,21,1,3,1,2,3
2014,10,21,1,4,2,7,9
2014,10,21,1,5,2,69,71
2014,10,21,1,6,2,290,292
2014,10,21,1,7,27,716,743
2014,10,21,1,8,47,1139,1186
2014,10,21,1,9,33,486,519
2014,10,21,1,10,63,205,268
2014,10,21,1,11,57,245,302
2014,10,21,1,12,102,309,411
2014,10,21,1,13,95,364,459
2014,10,21,1,14,84,311,395
2014,10,21,1,15,56,355,411
2014,10,21,1,16,83,533,616
2014,10,21,1,17,42,485,527
2014,10,21,1,18,16,401,417
2014,10,21,1,19,15,355,370
2014,10,21,1,20,7,256,263
2014,10,21,1,21,7,137,144
2014,10,21,1,22,2,64,66
2014,10,21,1,23,0,34,34
2014,10,22,2,0,0,24,24
2014,10,22,2,1,3,10,13
2014,10,22,2,2,0,8,8
2014,10,22,2,3,0,4,4
2014,10,22,2,4,0,4,4
2014,10,22,2,5,0,32,32
2014,10,22,2,6,2,121,123
2014,10,22,2,7,2,113,115
2014,10,22,2,8,5,187,192
2014,10,22,2,9,4,115,119
2014,10,22,2,10,3,46,49
2014,10,22,2,11,4,37,41
2014,10,22,2,12,9,88,97
2014,10,22,2,13,6,69,75
2014,10,22,2,14,15,103,118
2014,10,22,2,15,22,177,199
2014,10,22,2,16,17,273,290
2014,10,22,2,17,42,775,817
2014,10,22,2,18,30,700,730
2014,10,22,2,19,20,425,445
2014,10,22,2,20,15,336,351
2014,10,22,2,21,20,282,302
2014,10,22,2,22,13,192,205
2014,10,22,2,23,8,83,91
2014,10,23,3,0,2,36,38
2014,10,23,3,1,0,17,17
2014,10,23,3,2,0,7,7
2014,10,23,3,3,0,4,4
2014,10,23,3,4,0,8,8
2014,10,23,3,5,0,69,69
2014,10,23,3,6,3,241,244
2014,10,23,3,7,17,623,640
2014,10,23,3,8,32,1054,1086
2014,10,23,3,9,34,524,558
2014,10,23,3,10,52,267,319
2014,10,23,3,11,63,232,295
2014,10,23,3,12,79,295,374
2014,10,23,3,13,112,334,446
2014,10,23,3,14,91,273,364
2014,10,23,3,15,96,323,419
2014,10,23,3,16,102,557,659
2014,10,23,3,17,122,1078,1200
2014,10,23,3,18,105,1023,1128
2014,10,23,3,19,49,613,662
2014,10,23,3,20,38,454,492
2014,10,23,3,21,24,367,391
2014,10,23,3,22,14,245,259
2014,10,23,3,23,20,149,169
2014,10,24,4,0,6,67,73
2014,10,24,4,1,4,28,32
2014,10,24,4,2,0,25,25
2014,10,24,4,3,2,9,11
2014,10,24,4,4,2,9,11
2014,10,24,4,5,4,40,44
2014,10,24,4,6,7,225,232
2014,10,24,4,7,13,612,625
2014,10,24,4,8,32,1020,1052
2014,10,24,4,9,61,552,613
2014,10,24,4,10,106,254,360
2014,10,24,4,11,121,329,450
2014,10,24,4,12,155,391,546
2014,10,24,4,13,146,416,562
2014,10,24,4,14,204,346,550
2014,10,24,4,15,192,416,608
2014,10,24,4,16,177,640,817
2014,10,24,4,17,180,1085,1265
2014,10,24,4,18,105,880,985
2014,10,24,4,19,74,524,598
2014,10,24,4,20,47,328,375
2014,10,24,4,21,31,264,295
2014,10,24,4,22,35,222,257
2014,10,24,4,23,12,165,177
2014,10,25,5,0,20,129,149
2014,10,25,5,1,3,83,86
2014,10,25,5,2,10,56,66
2014,10,25,5,3,8,31,39
2014,10,25,5,4,1,4,5
2014,10,25,5,5,1,7,8
2014,10,25,5,6,10,32,42
2014,10,25,5,7,18,105,123
2014,10,25,5,8,36,236,272
2014,10,25,5,9,134,378,512
2014,10,25,5,10,182,476,658
2014,10,25,5,11,323,585,908
2014,10,25,5,12,371,623,994
2014,10,25,5,13,409,622,1031
2014,10,25,5,14,404,644,1048
2014,10,25,5,15,444,591,1035
2014,10,25,5,16,417,603,1020
2014,10,25,5,17,406,544,950
2014,10,25,5,18,232,495,727
2014,10,25,5,19,139,372,511
2014,10,25,5,20,105,236,341
2014,10,25,5,21,76,250,326
2014,10,25,5,22,54,212,266
2014,10,25,5,23,27,191,218
2014,10,26,6,0,20,148,168
2014,10,26,6,1,12,120,132
2014,10,26,6,2,26,82,108
2014,10,26,6,3,16,56,72
2014,10,26,6,4,2,9,11
2014,10,26,6,5,7,18,25
2014,10,26,6,6,10,50,60
2014,10,26,6,7,31,107,138
2014,10,26,6,8,123,194,317
2014,10,26,6,9,212,341,553
2014,10,26,6,10,265,426,691
2014,10,26,6,11,328,566,894
2014,10,26,6,12,301,603,904
2014,10,26,6,13,307,615,922
2014,10,26,6,14,356,614,970
2014,10,26,6,15,339,576,915
2014,10,26,6,16,301,569,870
2014,10,26,6,17,247,517,764
2014,10,26,6,18,172,465,637
2014,10,26,6,19,68,332,400
2014,10,26,6,20,56,253,309
2014,10,26,6,21,38,198,236
2014,10,26,6,22,51,115,166
2014,10,26,6,23,21,75,96
2014,10,27,0,0,9,42,51
2014,10,27,0,1,7,16,23
2014,10,27,0,2,7,5,12
2014,10,27,0,3,9,2,11
2014,10,27,0,4,0,5,5
2014,10,27,0,5,1,62,63
2014,10,27,0,6,2,249,251
2014,10,27,0,7,6,637,643
2014,10,27,0,8,47,1059,1106
2014,10,27,0,9,54,432,486
2014,10,27,0,10,130,208,338
2014,10,27,0,11,130,234,364
2014,10,27,0,12,144,363,507
2014,10,27,0,13,180,364,544
2014,10,27,0,14,134,315,449
2014,10,27,0,15,143,348,491
2014,10,27,0,16,108,635,743
2014,10,27,0,17,148,1235,1383
2014,10,27,0,18,127,1150,1277
2014,10,27,0,19,54,691,745
2014,10,27,0,20,34,438,472
2014,10,27,0,21,45,301,346
2014,10,27,0,22,34,167,201
2014,10,27,0,23,24,87,111
2014,10,28,1,0,13,47,60
2014,10,28,1,1,1,17,18
2014,10,28,1,2,4,6,10
2014,10,28,1,3,0,2,2
2014,10,28,1,4,0,7,7
2014,10,28,1,5,0,71,71
2014,10,28,1,6,1,310,311
2014,10,28,1,7,11,743,754
2014,10,28,1,8,59,1240,1299
2014,10,28,1,9,50,509,559
2014,10,28,1,10,93,229,322
2014,10,28,1,11,108,287,395
2014,10,28,1,12,142,380,522
2014,10,28,1,13,118,410,528
2014,10,28,1,14,128,351,479
2014,10,28,1,15,109,411,520
2014,10,28,1,16,106,656,762
2014,10,28,1,17,149,1298,1447
2014,10,28,1,18,95,1199,1294
2014,10,28,1,19,92,768,860
2014,10,28,1,20,55,492,547
2014,10,28,1,21,30,439,469
2014,10,28,1,22,35,253,288
2014,10,28,1,23,20,163,183
2014,10,29,2,0,10,48,58
2014,10,29,2,1,4,22,26
2014,10,29,2,2,13,7,20
2014,10,29,2,3,1,2,3
2014,10,29,2,4,0,8,8
2014,10,29,2,5,0,79,79
2014,10,29,2,6,6,313,319
2014,10,29,2,7,19,751,770
2014,10,29,2,8,43,1152,1195
2014,10,29,2,9,60,497,557
2014,10,29,2,10,83,260,343
2014,10,29,2,11,91,266,357
2014,10,29,2,12,60,371,431
2014,10,29,2,13,52,349,401
2014,10,29,2,14,32,127,159
2014,10,29,2,15,41,226,267
2014,10,29,2,16,52,465,517
2014,10,29,2,17,52,1052,1104
2014,10,29,2,18,58,941,999
2014,10,29,2,19,35,610,645
2014,10,29,2,20,17,447,464
2014,10,29,2,21,15,355,370
2014,10,29,2,22,14,218,232
2014,10,29,2,23,13,169,182
2014,10,30,3,0,2,50,52
2014,10,30,3,1,2,18,20
2014,10,30,3,2,0,10,10
2014,10,30,3,3,0,3,3
2014,10,30,3,4,0,7,7
2014,10,30,3,5,1,61,62
2014,10,30,3,6,2,259,261
2014,10,30,3,7,10,670,680
2014,10,30,3,8,23,1155,1178
2014,10,30,3,9,31,472,503
2014,10,30,3,10,48,266,314
2014,10,30,3,11,92,289,381
2014,10,30,3,12,76,355,431
2014,10,30,3,13,86,365,451
2014,10,30,3,14,70,338,408
2014,10,30,3,15,101,372,473
2014,10,30,3,16,83,566,649
2014,10,30,3,17,92,1184,1276
2014,10,30,3,18,55,1022,1077
2014,10,30,3,19,32,686,718
2014,10,30,3,20,32,445,477
2014,10,30,3,21,18,304,322
2014,10,30,3,22,24,229,253
2014,10,30,3,23,7,134,141
2014,10,31,4,0,6,78,84
2014,10,31,4,1,4,33,37
2014,10,31,4,2,0,12,12
2014,10,31,4,3,0,4,4
2014,10,31,4,4,1,7,8
2014,10,31,4,5,0,52,52
2014,10,31,4,6,2,223,225
2014,10,31,4,7,8,539,547
2014,10,31,4,8,37,1071,1108
2014,10,31,4,9,50,509,559
2014,10,31,4,10,69,278,347
2014,10,31,4,11,79,337,416
2014,10,31,4,12,114,428,542
2014,10,31,4,13,108,375,483
2014,10,31,4,14,122,396,518
2014,10,31,4,15,123,463,586
2014,10,31,4,16,115,735,850
2014,10,31,4,17,105,1079,1184
2014,10,31,4,18,52,676,728
2014,10,31,4,19,35,431,466
2014,10,31,4,20,30,277,307
2014,10,31,4,21,18,211,229
2014,10,31,4,22,26,170,196
2014,10,31,4,23,27,151,178
2014,11,1,5,0,15,126,141
2014,11,1,5,1,11,136,147
2014,11,1,5,2,13,125,138
2014,11,1,5,3,13,62,75
2014,11,1,5,4,10,10,20
2014,11,1,5,5,1,17,18
2014,11,1,5,6,1,23,24
2014,11,1,5,7,9,77,86
2014,11,1,5,8,8,167,175
2014,11,1,5,9,34,240,274
2014,11,1,5,10,60,317,377
2014,11,1,5,11,92,383,475
2014,11,1,5,12,89,349,438
2014,11,1,5,13,104,387,491
2014,11,1,5,14,126,334,460
2014,11,1,5,15,114,338,452
2014,11,1,5,16,125,381,506
2014,11,1,5,17,116,367,483
2014,11,1,5,18,79,311,390
2014,11,1,5,19,35,225,260
2014,11,1,5,20,24,215,239
2014,11,1,5,21,18,167,185
2014,11,1,5,22,14,132,146
2014,11,1,5,23,17,113,130
2014,11,2,6,0,12,103,115
2014,11,2,6,1,15,130,145
2014,11,2,6,2,5,25,30
2014,11,2,6,3,1,13,14
2014,11,2,6,4,0,3,3
2014,11,2,6,5,1,4,5
2014,11,2,6,6,3,22,25
2014,11,2,6,7,3,73,76
2014,11,2,6,8,13,150,163
2014,11,2,6,9,37,260,297
2014,11,2,6,10,77,299,376
2014,11,2,6,11,72,367,439
2014,11,2,6,12,105,457,562
2014,11,2,6,13,110,413,523
2014,11,2,6,14,103,411,514
2014,11,2,6,15,104,407,511
2014,11,2,6,16,104,443,547
2014,11,2,6,17,62,344,406
2014,11,2,6,18,20,279,299
2014,11,2,6,19,17,212,229
2014,11,2,6,20,11,142,153
2014,11,2,6,21,6,110,116
2014,11,2,6,22,11,86,97
2014,11,2,6,23,3,50,53
2014,11,3,0,0,3,17,20
2014,11,3,0,1,2,6,8
2014,11,3,0,2,1,1,2
2014,11,3,0,3,0,3,3
2014,11,3,0,4,0,10,10
2014,11,3,0,5,1,53,54
2014,11,3,0,6,1,267,268
2014,11,3,0,7,12,733,745
2014,11,3,0,8,23,981,1004
2014,11,3,0,9,25,430,455
2014,11,3,0,10,36,198,234
2014,11,3,0,11,55,209,264
2014,11,3,0,12,59,279,338
2014,11,3,0,13,59,312,371
2014,11,3,0,14,73,252,325
2014,11,3,0,15,67,354,421
2014,11,3,0,16,83,561,644
2014,11,3,0,17,42,1085,1127
2014,11,3,0,18,25,898,923
2014,11,3,0,19,22,537,559
2014,11,3,0,20,13,341,354
2014,11,3,0,21,9,278,287
2014,11,3,0,22,8,160,168
2014,11,3,0,23,1,76,77
2014,11,4,1,0,3,26,29
2014,11,4,1,1,1,15,16
2014,11,4,1,2,1,5,6
2014,11,4,1,3,0,1,1
2014,11,4,1,4,0,12,12
2014,11,4,1,5,1,82,83
2014,11,4,1,6,3,302,305
2014,11,4,1,7,16,817,833
2014,11,4,1,8,20,1055,1075
2014,11,4,1,9,25,508,533
2014,11,4,1,10,32,222,254
2014,11,4,1,11,99,263,362
2014,11,4,1,12,86,360,446
2014,11,4,1,13,85,327,412
2014,11,4,1,14,68,316,384
2014,11,4,1,15,60,354,414
2014,11,4,1,16,80,657,737
2014,11,4,1,17,67,1144,1211
2014,11,4,1,18,25,1001,1026
2014,11,4,1,19,22,557,579
2014,11,4,1,20,24,444,468
2014,11,4,1,21,10,356,366
2014,11,4,1,22,14,244,258
2014,11,4,1,23,8,103,111
2014,11,5,2,0,0,55,55
2014,11,5,2,1,6,30,36
2014,11,5,2,2,0,9,9
2014,11,5,2,3,0,9,9
2014,11,5,2,4,0,10,10
2014,11,5,2,5,2,90,92
2014,11,5,2,6,9,325,334
2014,11,5,2,7,18,800,818
2014,11,5,2,8,40,1125,1165
2014,11,5,2,9,32,486,518
2014,11,5,2,10,36,240,276
2014,11,5,2,11,60,230,290
2014,11,5,2,12,73,387,460
2014,11,5,2,13,70,325,395
2014,11,5,2,14,57,270,327
2014,11,5,2,15,64,322,386
2014,11,5,2,16,79,622,701
2014,11,5,2,17,64,1096,1160
2014,11,5,2,18,43,837,880
2014,11,5,2,19,23,455,478
2014,11,5,2,20,8,330,338
2014,11,5,2,21,9,251,260
2014,11,5,2,22,5,165,170
2014,11,5,2,23,2,72,74
2014,11,6,3,0,2,30,32
2014,11,6,3,1,0,10,10
2014,11,6,3,2,2,4,6
2014,11,6,3,4,0,3,3
2014,11,6,3,5,0,22,22
2014,11,6,3,6,2,57,59
2014,11,6,3,7,5,366,371
2014,11,6,3,8,11,770,781
2014,11,6,3,9,27,547,574
2014,11,6,3,10,41,275,316
2014,11,6,3,11,36,257,293
2014,11,6,3,12,34,394,428
2014,11,6,3,13,55,349,404
2014,11,6,3,14,20,128,148
2014,11,6,3,15,17,228,245
2014,11,6,3,16,36,473,509
2014,11,6,3,17,40,711,751
2014,11,6,3,18,24,771,795
2014,11,6,3,19,20,520,540
2014,11,6,3,20,12,392,404
2014,11,6,3,21,15,326,341
2014,11,6,3,22,12,210,222
2014,11,6,3,23,11,125,136
2014,11,7,4,0,4,69,73
2014,11,7,4,1,3,27,30
2014,11,7,4,2,0,6,6
2014,11,7,4,3,0,3,3
2014,11,7,4,4,0,8,8
2014,11,7,4,5,0,51,51
2014,11,7,4,6,5,237,242
2014,11,7,4,7,13,664,677
2014,11,7,4,8,23,1093,1116
2014,11,7,4,9,36,519,555
2014,11,7,4,10,62,278,340
2014,11,7,4,11,74,307,381
2014,11,7,4,12,83,386,469
2014,11,7,4,13,79,345,424
2014,11,7,4,14,89,303,392
2014,11,7,4,15,79,342,421
2014,11,7,4,16,86,486,572
2014,11,7,4,17,87,966,1053
2014,11,7,4,18,28,691,719
2014,11,7,4,19,10,381,391
2014,11,7,4,20,17,283,300
2014,11,7,4,21,18,192,210
2014,11,7,4,22,26,161,187
2014,11,7,4,23,24,138,162
2014,11,8,5,0,11,83,94
2014,11,8,5,1,4,66,70
2014,11,8,5,2,2,53,55
2014,11,8,5,3,1,23,24
2014,11,8,5,4,1,9,10
2014,11,8,5,5,1,9,10
2014,11,8,5,6,0,26,26
2014,11,8,5,7,9,90,99
2014,11,8,5,8,32,209,241
2014,11,8,5,9,59,304,363
2014,11,8,5,10,88,368,456
2014,11,8,5,11,127,489,616
2014,11,8,5,12,173,525,698
2014,11,8,5,13,206,460,666
2014,11,8,5,14,230,481,711
2014,11,8,5,15,229,466,695
2014,11,8,5,16,160,431,591
2014,11,8,5,17,176,450,626
2014,11,8,5,18,57,333,390
2014,11,8,5,19,77,317,394
2014,11,8,5,20,30,212,242
2014,11,8,5,21,33,174,207
2014,11,8,5,22,41,151,192
2014,11,8,5,23,26,150,176
2014,11,9,6,0,11,118,129
2014,11,9,6,1,7,102,109
2014,11,9,6,2,6,76,82
2014,11,9,6,3,8,25,33
2014,11,9,6,4,0,10,10
2014,11,9,6,5,2,8,10
2014,11,9,6,6,2,20,22
2014,11,9,6,7,16,78,94
2014,11,9,6,8,33,147,180
2014,11,9,6,9,69,278,347
2014,11,9,6,10,158,415,573
2014,11,9,6,11,172,431,603
2014,11,9,6,12,211,539,750
2014,11,9,6,13,272,479,751
2014,11,9,6,14,230,516,746
2014,11,9,6,15,244,547,791
2014,11,9,6,16,201,584,785
2014,11,9,6,17,125,415,540
2014,11,9,6,18,77,357,434
2014,11,9,6,19,58,274,332
2014,11,9,6,20,32,192,224
2014,11,9,6,21,42,142,184
2014,11,9,6,22,9,120,129
2014,11,9,6,23,17,67,84
2014,11,10,0,0,7,36,43
2014,11,10,0,1,0,14,14
2014,11,10,0,2,0,7,7
2014,11,10,0,3,0,5,5
2014,11,10,0,4,0,7,7
2014,11,10,0,5,3,60,63
2014,11,10,0,6,5,218,223
2014,11,10,0,7,17,652,669
2014,11,10,0,8,36,1032,1068
2014,11,10,0,9,60,433,493
2014,11,10,0,10,79,207,286
2014,11,10,0,11,107,259,366
2014,11,10,0,12,87,338,425
2014,11,10,0,13,114,296,410
2014,11,10,0,14,131,301,432
2014,11,10,0,15,137,379,516
2014,11,10,0,16,99,629,728
2014,11,10,0,17,103,1011,1114
2014,11,10,0,18,52,861,913
2014,11,10,0,19,39,559,598
2014,11,10,0,20,28,370,398
2014,11,10,0,21,34,248,282
2014,11,10,0,22,23,199,222
2014,11,10,0,23,14,112,126
2014,11,11,1,0,5,55,60
2014,11,11,1,1,16,22,38
2014,11,11,1,2,0,10,10
2014,11,11,1,3,1,2,3
2014,11,11,1,4,2,4,6
2014,11,11,1,5,4,34,38
2014,11,11,1,6,11,108,119
2014,11,11,1,7,17,378,395
2014,11,11,1,8,41,781,822
2014,11,11,1,9,54,481,535
2014,11,11,1,10,95,409,504
2014,11,11,1,11,109,421,530
2014,11,11,1,12,150,548,698
2014,11,11,1,13,175,513,688
2014,11,11,1,14,169,532,701
2014,11,11,1,15,177,557,734
2014,11,11,1,16,170,678,848
2014,11,11,1,17,121,862,983
2014,11,11,1,18,83,808,891
2014,11,11,1,19,76,557,633
2014,11,11,1,20,75,440,515
2014,11,11,1,21,91,455,546
2014,11,11,1,22,76,397,473
2014,11,11,1,23,4,117,121
2014,11,12,2,0,12,38,50
2014,11,12,2,1,6,12,18
2014,11,12,2,2,0,12,12
2014,11,12,2,3,0,4,4
2014,11,12,2,4,1,10,11
2014,11,12,2,5,2,79,81
2014,11,12,2,6,8,298,306
2014,11,12,2,7,12,824,836
2014,11,12,2,8,32,1209,1241
2014,11,12,2,9,36,503,539
2014,11,12,2,10,61,249,310
2014,11,12,2,11,73,254,327
2014,11,12,2,12,63,307,370
2014,11,12,2,13,68,324,392
2014,11,12,2,14,73,281,354
2014,11,12,2,15,76,399,475
2014,11,12,2,16,77,566,643
2014,11,12,2,17,62,1077,1139
2014,11,12,2,18,36,862,898
2014,11,12,2,19,37,573,610
2014,11,12,2,20,20,396,416
2014,11,12,2,21,13,301,314
2014,11,12,2,22,8,164,172
2014,11,12,2,23,3,108,111
2014,11,13,3,0,1,26,27
2014,11,13,3,1,2,10,12
2014,11,13,3,2,1,2,3
2014,11,13,3,3,1,3,4
2014,11,13,3,4,1,9,10
2014,11,13,3,5,1,63,64
2014,11,13,3,6,3,242,245
2014,11,13,3,7,11,673,684
2014,11,13,3,8,37,1073,1110
2014,11,13,3,9,26,426,452
2014,11,13,3,10,29,227,256
2014,11,13,3,11,41,205,246
2014,11,13,3,12,58,301,359
2014,11,13,3,13,41,259,300
2014,11,13,3,14,49,235,284
2014,11,13,3,15,46,271,317
2014,11,13,3,16,36,483,519
2014,11,13,3,17,41,815,856
2014,11,13,3,18,23,537,560
2014,11,13,3,19,8,267,275
2014,11,13,3,20,11,192,203
2014,11,13,3,21,8,173,181
2014,11,13,3,22,6,117,123
2014,11,13,3,23,5,98,103
2014,11,14,4,0,1,47,48
2014,11,14,4,1,2,16,18
2014,11,14,4,2,0,7,7
2014,11,14,4,3,0,3,3
2014,11,14,4,4,0,3,3
2014,11,14,4,5,0,55,55
2014,11,14,4,6,1,178,179
2014,11,14,4,7,7,530,537
2014,11,14,4,8,24,877,901
2014,11,14,4,9,17,410,427
2014,11,14,4,10,31,202,233
2014,11,14,4,11,42,214,256
2014,11,14,4,12,54,320,374
2014,11,14,4,13,56,249,305
2014,11,14,4,14,60,242,302
2014,11,14,4,15,42,303,345
2014,11,14,4,16,47,499,546
2014,11,14,4,17,30,780,810
2014,11,14,4,18,13,610,623
2014,11,14,4,19,8,369,377
2014,11,14,4,20,18,251,269
2014,11,14,4,21,14,174,188
2014,11,14,4,22,4,150,154
2014,11,14,4,23,8,109,117
2014,11,15,5,0,0,89,89
2014,11,15,5,1,4,42,46
2014,11,15,5,2,1,37,38
2014,11,15,5,3,2,13,15
2014,11,15,5,4,0,6,6
2014,11,15,5,5,0,4,4
2014,11,15,5,6,3,16,19
2014,11,15,5,7,2,72,74
2014,11,15,5,8,14,124,138
2014,11,15,5,9,39,240,279
2014,11,15,5,10,73,352,425
2014,11,15,5,11,133,429,562
2014,11,15,5,12,148,404,552
2014,11,15,5,13,136,396,532
2014,11,15,5,14,135,450,585
2014,11,15,5,15,159,448,607
2014,11,15,5,16,148,352,500
2014,11,15,5,17,76,300,376
2014,11,15,5,18,45,253,298
2014,11,15,5,19,32,212,244
2014,11,15,5,20,18,158,176
2014,11,15,5,21,19,146,165
2014,11,15,5,22,21,132,153
2014,11,15,5,23,9,124,133
2014,11,16,6,0,10,82,92
2014,11,16,6,1,5,79,84
2014,11,16,6,2,8,59,67
2014,11,16,6,3,2,29,31
2014,11,16,6,4,0,3,3
2014,11,16,6,5,0,11,11
2014,11,16,6,6,1,11,12
2014,11,16,6,7,11,41,52
2014,11,16,6,8,28,116,144
2014,11,16,6,9,44,202,246
2014,11,16,6,10,76,348,424
2014,11,16,6,11,101,352,453
2014,11,16,6,12,94,427,521
2014,11,16,6,13,93,383,476
2014,11,16,6,14,103,356,459
2014,11,16,6,15,88,332,420
2014,11,16,6,16,66,328,394
2014,11,16,6,17,21,147,168
2014,11,16,6,18,21,132,153
2014,11,16,6,19,18,126,144
2014,11,16,6,20,24,117,141
2014,11,16,6,21,24,95,119
2014,11,16,6,22,15,90,105
2014,11,16,6,23,8,56,64
2014,11,17,0,0,1,18,19
2014,11,17,0,1,1,7,8
2014,11,17,0,2,0,3,3
2014,11,17,0,3,0,2,2
2014,11,17,0,4,1,2,3
2014,11,17,0,5,1,35,36
2014,11,17,0,6,2,89,91
2014,11,17,0,7,4,303,307
2014,11,17,0,8,7,269,276
2014,11,17,0,9,9,137,146
2014,11,17,0,10,3,40,43
2014,11,17,0,11,2,30,32
2014,11,17,0,12,8,54,62
2014,11,17,0,13,12,110,122
2014,11,17,0,14,11,108,119
2014,11,17,0,15,13,143,156
2014,11,17,0,16,11,296,307
2014,11,17,0,17,23,600,623
2014,11,17,0,18,26,630,656
2014,11,17,0,19,7,433,440
2014,11,17,0,20,12,281,293
2014,11,17,0,21,5,181,186
2014,11,17,0,22,4,130,134
2014,11,17,0,23,6,63,69
2014,11,18,1,0,4,23,27
2014,11,18,1,1,0,8,8
2014,11,18,1,2,0,3,3
2014,11,18,1,3,1,6,7
2014,11,18,1,4,0,4,4
2014,11,18,1,5,0,41,41
2014,11,18,1,6,0,155,155
2014,11,18,1,7,11,490,501
2014,11,18,1,8,23,844,867
2014,11,18,1,9,14,363,377
2014,11,18,1,10,16,140,156
2014,11,18,1,11,16,145,161
2014,11,18,1,12,24,201,225
2014,11,18,1,13,14,164,178
2014,11,18,1,14,22,148,170
2014,11,18,1,15,36,208,244
2014,11,18,1,16,28,347,375
2014,11,18,1,17,21,626,647
2014,11,18,1,18,15,535,550
2014,11,18,1,19,5,313,318
2014,11,18,1,20,4,237,241
2014,11,18,1,21,7,161,168
2014,11,18,1,22,5,96,101
2014,11,18,1,23,5,42,47
2014,11,19,2,0,1,23,24
2014,11,19,2,1,1,9,10
2014,11,19,2,2,2,2,4
2014,11,19,2,3,2,2,4
2014,11,19,2,4,0,5,5
2014,11,19,2,5,0,51,51
2014,11,19,2,6,0,179,179
2014,11,19,2,7,6,458,464
2014,11,19,2,8,11,781,792
2014,11,19,2,9,15,407,422
2014,11,19,2,10,17,169,186
2014,11,19,2,11,12,186,198
2014,11,19,2,12,30,218,248
2014,11,19,2,13,9,171,180
2014,11,19,2,14,7,190,197
2014,11,19,2,15,11,217,228
2014,11,19,2,16,24,373,397
2014,11,19,2,17,26,664,690
2014,11,19,2,18,6,650,656
2014,11,19,2,19,3,403,406
2014,11,19,2,20,3,235,238
2014,11,19,2,21,3,236,239
2014,11,19,2,22,4,152,156
2014,11,19,2,23,1,62,63
2014,11,20,3,0,0,31,31
2014,11,20,3,1,1,15,16
2014,11,20,3,2,0,3,3
2014,11,20,3,3,0,4,4
2014,11,20,3,4,0,5,5
2014,11,20,3,5,0,47,47
2014,11,20,3,6,2,175,177
2014,11,20,3,7,3,547,550
2014,11,20,3,8,8,899,907
2014,11,20,3,9,12,452,464
2014,11,20,3,10,14,202,216
2014,11,20,3,11,20,204,224
2014,11,20,3,12,19,288,307
2014,11,20,3,13,38,277,315
2014,11,20,3,14,33,252,285
2014,11,20,3,15,42,286,328
2014,11,20,3,16,22,500,522
2014,11,20,3,17,30,825,855
2014,11,20,3,18,24,704,728
2014,11,20,3,19,13,472,485
2014,11,20,3,20,6,349,355
2014,11,20,3,21,19,212,231
2014,11,20,3,22,4,166,170
2014,11,20,3,23,1,71,72
2014,11,21,4,0,2,36,38
2014,11,21,4,1,0,20,20
2014,11,21,4,2,0,6,6
2014,11,21,4,3,0,1,1
2014,11,21,4,4,0,4,4
2014,11,21,4,5,0,48,48
2014,11,21,4,6,0,142,142
2014,11,21,4,7,2,430,432
2014,11,21,4,8,20,864,884
2014,11,21,4,9,19,416,435
2014,11,21,4,10,26,198,224
2014,11,21,4,11,50,218,268
2014,11,21,4,12,31,244,275
2014,11,21,4,13,47,267,314
2014,11,21,4,14,31,217,248
2014,11,21,4,15,34,261,295
2014,11,21,4,16,42,451,493
2014,11,21,4,17,46,699,745
2014,11,21,4,18,12,561,573
2014,11,21,4,19,13,342,355
2014,11,21,4,20,10,203,213
2014,11,21,4,21,13,170,183
2014,11,21,4,22,8,114,122
2014,11,21,4,23,8,87,95
2014,11,22,5,0,3,76,79
2014,11,22,5,1,4,58,62
2014,11,22,5,2,4,52,56
2014,11,22,5,3,3,28,31
2014,11,22,5,4,0,4,4
2014,11,22,5,5,1,9,10
2014,11,22,5,6,0,19,19
2014,11,22,5,7,8,53,61
2014,11,22,5,8,6,149,155
2014,11,22,5,9,20,223,243
2014,11,22,5,10,35,307,342
2014,11,22,5,11,84,358,442
2014,11,22,5,12,60,408,468
2014,11,22,5,13,90,423,513
2014,11,22,5,14,107,425,532
2014,11,22,5,15,142,405,547
2014,11,22,5,16,120,371,491
2014,11,22,5,17,73,312,385
2014,11,22,5,18,50,277,327
2014,11,22,5,19,38,218,256
2014,11,22,5,20,23,166,189
2014,11,22,5,21,15,158,173
2014,11,22,5,22,11,100,111
2014,11,22,5,23,11,120,131
2014,11,23,6,0,8,99,107
2014,11,23,6,1,3,76,79
2014,11,23,6,2,3,48,51
2014,11,23,6,3,3,22,25
2014,11,23,6,4,1,9,10
2014,11,23,6,5,0,7,7
2014,11,23,6,6,0,7,7
2014,11,23,6,7,2,34,36
2014,11,23,6,8,17,90,107
2014,11,23,6,9,31,187,218
2014,11,23,6,10,76,332,408
2014,11,23,6,11,121,384,505
2014,11,23,6,12,116,441,557
2014,11,23,6,13,128,432,560
2014,11,23,6,14,120,429,549
2014,11,23,6,15,140,407,547
2014,11,23,6,16,108,378,486
2014,11,23,6,17,82,341,423
2014,11,23,6,18,55,320,375
2014,11,23,6,19,41,221,262
2014,11,23,6,20,24,111,135
2014,11,23,6,21,21,78,99
2014,11,23,6,22,7,59,66
2014,11,23,6,23,0,28,28
2014,11,24,0,0,1,10,11
2014,11,24,0,1,0,2,2
2014,11,24,0,2,0,6,6
2014,11,24,0,3,0,3,3
2014,11,24,0,4,0,4,4
2014,11,24,0,5,1,57,58
2014,11,24,0,6,0,198,198
2014,11,24,0,7,5,597,602
2014,11,24,0,8,15,1007,1022
2014,11,24,0,9,44,444,488
2014,11,24,0,10,77,201,278
2014,11,24,0,11,75,183,258
2014,11,24,0,12,88,326,414
2014,11,24,0,13,102,304,406
2014,11,24,0,14,144,320,464
2014,11,24,0,15,144,362,506
2014,11,24,0,16,93,544,637
2014,11,24,0,17,90,1116,1206
2014,11,24,0,18,41,884,925
2014,11,24,0,19,39,617,656
2014,11,24,0,20,21,417,438
2014,11,24,0,21,30,293,323
2014,11,24,0,22,39,209,248
2014,11,24,0,23,21,96,117
2014,11,25,1,0,25,45,70
2014,11,25,1,1,13,21,34
2014,11,25,1,2,8,4,12
2014,11,25,1,3,2,2,4
2014,11,25,1,4,0,5,5
2014,11,25,1,5,0,64,64
2014,11,25,1,6,2,221,223
2014,11,25,1,7,9,653,662
2014,11,25,1,8,32,1003,1035
2014,11,25,1,9,38,423,461
2014,11,25,1,10,62,239,301
2014,11,25,1,11,59,265,324
2014,11,25,1,12,81,254,335
2014,11,25,1,13,59,290,349
2014,11,25,1,14,94,239,333
2014,11,25,1,15,86,301,387
2014,11,25,1,16,102,542,644
2014,11,25,1,17,74,878,952
2014,11,25,1,18,45,650,695
2014,11,25,1,19,16,438,454
2014,11,25,1,20,29,301,330
2014,11,25,1,21,28,231,259
2014,11,25,1,22,13,172,185
2014,11,25,1,23,11,75,86
2014,11,26,2,0,7,34,41
2014,11,26,2,1,0,19,19
2014,11,26,2,2,0,7,7
2014,11,26,2,3,0,3,3
2014,11,26,2,4,0,2,2
2014,11,26,2,5,0,15,15
2014,11,26,2,6,0,39,39
2014,11,26,2,7,0,60,60
2014,11,26,2,8,2,98,100
2014,11,26,2,9,2,51,53
2014,11,26,2,10,3,37,40
2014,11,26,2,11,2,38,40
2014,11,26,2,12,3,56,59
2014,11,26,2,13,5,91,96
2014,11,26,2,14,2,54,56
2014,11,26,2,15,0,91,91
2014,11,26,2,16,7,95,102
2014,11,26,2,17,2,105,107
2014,11,26,2,18,1,126,127
2014,11,26,2,19,6,109,115
2014,11,26,2,20,6,78,84
2014,11,26,2,21,2,78,80
2014,11,26,2,22,1,66,67
2014,11,26,2,23,2,42,44
2014,11,27,3,0,0,30,30
2014,11,27,3,1,1,33,34
2014,11,27,3,2,2,19,21
2014,11,27,3,3,0,4,4
2014,11,27,3,4,0,7,7
2014,11,27,3,5,0,9,9
2014,11,27,3,6,0,22,22
2014,11,27,3,7,0,43,43
2014,11,27,3,8,9,82,91
2014,11,27,3,9,9,111,120
2014,11,27,3,10,30,131,161
2014,11,27,3,11,46,127,173
2014,11,27,3,12,58,151,209
2014,11,27,3,13,60,130,190
2014,11,27,3,14,46,129,175
2014,11,27,3,15,39,94,133
2014,11,27,3,16,62,62,124
2014,11,27,3,17,25,33,58
2014,11,27,3,18,10,30,40
2014,11,27,3,19,4,42,46
2014,11,27,3,20,10,31,41
2014,11,27,3,21,4,41,45
2014,11,27,3,22,2,40,42
2014,11,27,3,23,15,38,53
2014,11,28,4,0,10,17,27
2014,11,28,4,1,3,6,9
2014,11,28,4,2,0,4,4
2014,11,28,4,3,0,2,2
2014,11,28,4,4,0,4,4
2014,11,28,4,5,0,9,9
2014,11,28,4,6,2,31,33
2014,11,28,4,7,6,75,81
2014,11,28,4,8,9,116,125
2014,11,28,4,9,15,134,149
2014,11,28,4,10,31,95,126
2014,11,28,4,11,52,117,169
2014,11,28,4,12,45,169,214
2014,11,28,4,13,64,146,210
2014,11,28,4,14,48,182,230
2014,11,28,4,15,54,186,240
2014,11,28,4,16,70,177,247
2014,11,28,4,17,34,172,206
2014,11,28,4,18,25,124,149
2014,11,28,4,19,22,106,128
2014,11,28,4,20,20,93,113
2014,11,28,4,21,4,67,71
2014,11,28,4,22,1,55,56
2014,11,28,4,23,6,39,45
2014,11,29,5,0,5,33,38
2014,11,29,5,1,3,28,31
2014,11,29,5,2,6,19,25
2014,11,29,5,3,2,5,7
2014,11,29,5,4,0,3,3
2014,11,29,5,5,0,6,6
2014,11,29,5,6,0,5,5
2014,11,29,5,7,0,31,31
2014,11,29,5,8,14,71,85
2014,11,29,5,9,41,106,147
2014,11,29,5,10,63,149,212
2014,11,29,5,11,73,172,245
2014,11,29,5,12,115,216,331
2014,11,29,5,13,100,239,339
2014,11,29,5,14,116,234,350
2014,11,29,5,15,142,233,375
2014,11,29,5,16,101,233,334
2014,11,29,5,17,79,179,258
2014,11,29,5,18,45,188,233
2014,11,29,5,19,47,156,203
2014,11,29,5,20,9,110,119
2014,11,29,5,21,26,98,124
2014,11,29,5,22,15,96,111
2014,11,29,5,23,8,76,84
2014,11,30,6,0,6,61,67
2014,11,30,6,1,9,43,52
2014,11,30,6,2,5,27,32
2014,11,30,6,3,3,26,29
2014,11,30,6,4,6,2,8
2014,11,30,6,5,1,5,6
2014,11,30,6,6,0,7,7
2014,11,30,6,7,7,37,44
2014,11,30,6,8,15,64,79
2014,11,30,6,9,31,154,185
2014,11,30,6,10,54,223,277
2014,11,30,6,11,64,263,327
2014,11,30,6,12,102,314,416
2014,11,30,6,13,119,394,513
2014,11,30,6,14,131,356,487
2014,11,30,6,15,141,422,563
2014,11,30,6,16,115,437,552
2014,11,30,6,17,55,353,408
2014,11,30,6,18,46,278,324
2014,11,30,6,19,23,171,194
2014,11,30,6,20,14,158,172
2014,11,30,6,21,15,122,137
2014,11,30,6,22,6,85,91
2014,11,30,6,23,5,49,54
2014,12,1,0,0,4,21,25
2014,12,1,0,1,2,13,15
2014,12,1,0,2,0,4,4
2014,12,1,0,3,0,2,2
2014,12,1,0,4,0,4,4
2014,12,1,0,5,0,54,54
2014,12,1,0,6,2,192,194
2014,12,1,0,7,7,637,644
2014,12,1,0,8,11,978,989
2014,12,1,0,9,21,382,403
2014,12,1,0,10,28,216,244
2014,12,1,0,11,51,222,273
2014,12,1,0,12,49,307,356
2014,12,1,0,13,74,262,336
2014,12,1,0,14,69,275,344
2014,12,1,0,15,49,314,363
2014,12,1,0,16,40,439,479
2014,12,1,0,17,24,556,580
2014,12,1,0,18,4,368,372
2014,12,1,0,19,5,179,184
2014,12,1,0,20,7,182,189
2014,12,1,0,21,6,172,178
2014,12,1,0,22,4,94,98
2014,12,1,0,23,3,49,52
2014,12,2,1,0,3,17,20
2014,12,2,1,1,0,9,9
2014,12,2,1,2,0,4,4
2014,12,2,1,3,0,2,2
2014,12,2,1,4,0,1,1
2014,12,2,1,5,2,39,41
2014,12,2,1,6,1,135,136
2014,12,2,1,7,1,160,161
2014,12,2,1,8,1,143,144
2014,12,2,1,9,0,69,69
2014,12,2,1,10,3,75,78
2014,12,2,1,11,2,105,107
2014,12,2,1,12,1,121,122
2014,12,2,1,13,7,95,102
2014,12,2,1,14,3,100,103
2014,12,2,1,15,5,117,122
2014,12,2,1,16,7,167,174
2014,12,2,1,17,6,414,420
2014,12,2,1,18,7,426,433
2014,12,2,1,19,5,182,187
2014,12,2,1,20,0,74,74
2014,12,2,1,21,2,69,71
2014,12,2,1,22,1,52,53
2014,12,2,1,23,0,49,49
2014,12,3,2,0,0,20,20
2014,12,3,2,1,0,9,9
2014,12,3,2,2,0,5,5
2014,12,3,2,3,0,1,1
2014,12,3,2,4,0,4,4
2014,12,3,2,5,0,51,51
2014,12,3,2,6,2,151,153
2014,12,3,2,7,5,426,431
2014,12,3,2,8,6,833,839
2014,12,3,2,9,6,403,409
2014,12,3,2,10,10,171,181
2014,12,3,2,11,17,180,197
2014,12,3,2,12,10,265,275
2014,12,3,2,13,22,227,249
2014,12,3,2,14,17,213,230
2014,12,3,2,15,24,274,298
2014,12,3,2,16,25,425,450
2014,12,3,2,17,22,859,881
2014,12,3,2,18,17,801,818
2014,12,3,2,19,9,483,492
2014,12,3,2,20,13,370,383
2014,12,3,2,21,9,282,291
2014,12,3,2,22,3,177,180
2014,12,3,2,23,6,94,100
2014,12,4,3,0,1,38,39
2014,12,4,3,1,2,15,17
2014,12,4,3,2,0,6,6
2014,12,4,3,3,0,1,1
2014,12,4,3,4,0,4,4
2014,12,4,3,5,0,49,49
2014,12,4,3,6,1,191,192
2014,12,4,3,7,9,548,557
2014,12,4,3,8,11,965,976
2014,12,4,3,9,19,464,483
2014,12,4,3,10,22,194,216
2014,12,4,3,11,30,209,239
2014,12,4,3,12,23,266,289
2014,12,4,3,13,44,237,281
2014,12,4,3,14,30,231,261
2014,12,4,3,15,26,285,311
2014,12,4,3,16,24,455,479
2014,12,4,3,17,28,786,814
2014,12,4,3,18,20,791,811
2014,12,4,3,19,22,452,474
2014,12,4,3,20,15,327,342
2014,12,4,3,21,8,285,293
2014,12,4,3,22,8,139,147
2014,12,4,3,23,2,108,110
2014,12,5,4,0,1,52,53
2014,12,5,4,1,0,16,16
2014,12,5,4,2,0,12,12
2014,12,5,4,3,0,1,1
2014,12,5,4,4,0,5,5
2014,12,5,4,5,0,53,53
2014,12,5,4,6,3,148,151
2014,12,5,4,7,2,384,386
2014,12,5,4,8,12,831,843
2014,12,5,4,9,24,398,422
2014,12,5,4,10,30,188,218
2014,12,5,4,11,20,185,205
2014,12,5,4,12,29,263,292
2014,12,5,4,13,24,253,277
2014,12,5,4,14,17,212,229
2014,12,5,4,15,16,183,199
2014,12,5,4,16,21,304,325
2014,12,5,4,17,18,620,638
2014,12,5,4,18,12,552,564
2014,12,5,4,19,14,370,384
2014,12,5,4,20,5,236,241
2014,12,5,4,21,19,204,223
2014,12,5,4,22,9,158,167
2014,12,5,4,23,3,126,129
2014,12,6,5,0,4,103,107
2014,12,6,5,1,2,77,79
2014,12,6,5,2,8,58,66
2014,12,6,5,3,7,26,33
2014,12,6,5,4,2,8,10
2014,12,6,5,5,0,7,7
2014,12,6,5,6,1,15,16
2014,12,6,5,7,1,71,72
2014,12,6,5,8,10,141,151
2014,12,6,5,9,31,240,271
2014,12,6,5,10,43,308,351
2014,12,6,5,11,57,320,377
2014,12,6,5,12,27,183,210
2014,12,6,5,13,18,163,181
2014,12,6,5,14,14,67,81
2014,12,6,5,15,10,89,99
2014,12,6,5,16,15,186,201
2014,12,6,5,17,12,82,94
2014,12,6,5,18,7,80,87
2014,12,6,5,19,4,63,67
2014,12,6,5,20,6,41,47
2014,12,6,5,21,1,18,19
2014,12,6,5,22,5,26,31
2014,12,6,5,23,2,45,47
2014,12,7,6,0,0,68,68
2014,12,7,6,1,0,63,63
2014,12,7,6,2,2,50,52
2014,12,7,6,3,2,28,30
2014,12,7,6,4,1,11,12
2014,12,7,6,5,0,8,8
2014,12,7,6,6,2,12,14
2014,12,7,6,7,3,38,41
2014,12,7,6,8,12,135,147
2014,12,7,6,9,41,193,234
2014,12,7,6,10,52,302,354
2014,12,7,6,11,75,355,430
2014,12,7,6,12,73,447,520
2014,12,7,6,13,103,418,521
2014,12,7,6,14,108,438,546
2014,12,7,6,15,85,394,479
2014,12,7,6,16,61,416,477
2014,12,7,6,17,34,354,388
2014,12,7,6,18,22,281,303
2014,12,7,6,19,10,204,214
2014,12,7,6,20,7,138,145
2014,12,7,6,21,2,126,128
2014,12,7,6,22,6,93,99
2014,12,7,6,23,2,39,41
2014,12,8,0,0,0,24,24
2014,12,8,0,1,0,7,7
2014,12,8,0,2,0,9,9
2014,12,8,0,3,0,1,1
2014,12,8,0,4,0,6,6
2014,12,8,0,5,0,51,51
2014,12,8,0,6,3,181,184
2014,12,8,0,7,4,495,499
2014,12,8,0,8,11,853,864
2014,12,8,0,9,19,374,393
2014,12,8,0,10,20,149,169
2014,12,8,0,11,20,143,163
2014,12,8,0,12,32,196,228
2014,12,8,0,13,20,195,215
2014,12,8,0,14,11,183,194
2014,12,8,0,15,22,211,233
2014,12,8,0,16,37,395,432
2014,12,8,0,17,21,669,690
2014,12,8,0,18,10,623,633
2014,12,8,0,19,12,414,426
2014,12,8,0,20,4,260,264
2014,12,8,0,21,7,172,179
2014,12,8,0,22,8,135,143
2014,12,8,0,23,2,63,65
2014,12,9,1,0,0,27,27
2014,12,9,1,1,0,8,8
2014,12,9,1,2,0,2,2
2014,12,9,1,4,0,1,1
2014,12,9,1,5,0,25,25
2014,12,9,1,6,0,75,75
2014,12,9,1,7,0,143,143
2014,12,9,1,8,4,212,216
2014,12,9,1,9,1,127,128
2014,12,9,1,10,1,45,46
2014,12,9,1,11,6,68,74
2014,12,9,1,12,5,86,91
2014,12,9,1,13,5,102,107
2014,12,9,1,14,0,73,73
2014,12,9,1,15,5,90,95
2014,12,9,1,16,8,217,225
2014,12,9,1,17,4,452,456
2014,12,9,1,18,16,522,538
2014,12,9,1,19,6,337,343
2014,12,9,1,20,5,209,214
2014,12,9,1,21,2,188,190
2014,12,9,1,22,5,166,171
2014,12,9,1,23,2,70,72
2014,12,10,2,0,1,20,21
2014,12,10,2,1,1,11,12
2014,12,10,2,2,0,4,4
2014,12,10,2,3,0,2,2
2014,12,10,2,4,1,6,7
2014,12,10,2,5,0,51,51
2014,12,10,2,6,2,183,185
2014,12,10,2,7,5,533,538
2014,12,10,2,8,14,955,969
2014,12,10,2,9,18,476,494
2014,12,10,2,10,21,193,214
2014,12,10,2,11,11,187,198
2014,12,10,2,12,16,272,288
2014,12,10,2,13,14,225,239
2014,12,10,2,14,18,214,232
2014,12,10,2,15,22,221,243
2014,12,10,2,16,31,390,421
2014,12,10,2,17,23,760,783
2014,12,10,2,18,16,656,672
2014,12,10,2,19,15,438,453
2014,12,10,2,20,10,254,264
2014,12,10,2,21,12,219,231
2014,12,10,2,22,6,144,150
2014,12,10,2,23,4,74,78
2014,12,11,3,0,2,39,41
2014,12,11,3,1,0,10,10
2014,12,11,3,2,0,8,8
2014,12,11,3,3,0,3,3
2014,12,11,3,4,1,6,7
2014,12,11,3,5,2,34,36
2014,12,11,3,6,2,174,176
2014,12,11,3,7,5,488,493
2014,12,11,3,8,13,886,899
2014,12,11,3,9,28,441,469
2014,12,11,3,10,21,166,187
2014,12,11,3,11,27,188,215
2014,12,11,3,12,19,199,218
2014,12,11,3,13,26,214,240
2014,12,11,3,14,19,166,185
2014,12,11,3,15,16,217,233
2014,12,11,3,16,25,375,400
2014,12,11,3,17,26,684,710
2014,12,11,3,18,18,662,680
2014,12,11,3,19,13,396,409
2014,12,11,3,20,15,285,300
2014,12,11,3,21,8,209,217
2014,12,11,3,22,7,153,160
2014,12,11,3,23,0,81,81
2014,12,12,4,0,2,43,45
2014,12,12,4,1,0,28,28
2014,12,12,4,2,2,13,15
2014,12,12,4,3,0,3,3
2014,12,12,4,4,0,3,3
2014,12,12,4,5,0,48,48
2014,12,12,4,6,2,166,168
2014,12,12,4,7,5,442,447
2014,12,12,4,8,7,908,915
2014,12,12,4,9,16,432,448
2014,12,12,4,10,42,212,254
2014,12,12,4,11,38,198,236
2014,12,12,4,12,52,296,348
2014,12,12,4,13,42,260,302
2014,12,12,4,14,42,266,308
2014,12,12,4,15,56,319,375
2014,12,12,4,16,25,459,484
2014,12,12,4,17,30,708,738
2014,12,12,4,18,21,541,562
2014,12,12,4,19,4,320,324
2014,12,12,4,20,15,252,267
2014,12,12,4,21,18,173,191
2014,12,12,4,22,20,163,183
2014,12,12,4,23,7,134,141
2014,12,13,5,0,0,104,104
2014,12,13,5,1,2,76,78
2014,12,13,5,2,4,46,50
2014,12,13,5,3,3,18,21
2014,12,13,5,4,1,7,8
2014,12,13,5,5,0,9,9
2014,12,13,5,6,2,17,19
2014,12,13,5,7,1,60,61
2014,12,13,5,8,3,153,156
2014,12,13,5,9,17,243,260
2014,12,13,5,10,55,306,361
2014,12,13,5,11,56,382,438
2014,12,13,5,12,67,392,459
2014,12,13,5,13,70,494,564
2014,12,13,5,14,94,429,523
2014,12,13,5,15,100,424,524
2014,12,13,5,16,92,344,436
2014,12,13,5,17,69,360,429
2014,12,13,5,18,29,261,290
2014,12,13,5,19,16,240,256
2014,12,13,5,20,24,178,202
2014,12,13,5,21,14,156,170
2014,12,13,5,22,15,141,156
2014,12,13,5,23,4,101,105
2014,12,14,6,0,0,99,99
2014,12,14,6,1,0,86,86
2014,12,14,6,2,5,67,72
2014,12,14,6,3,0,28,28
2014,12,14,6,4,1,12,13
2014,12,14,6,5,0,5,5
2014,12,14,6,6,7,7,14
2014,12,14,6,7,2,34,36
2014,12,14,6,8,7,82,89
2014,12,14,6,9,18,174,192
2014,12,14,6,10,37,255,292
2014,12,14,6,11,70,338,408
2014,12,14,6,12,125,431,556
2014,12,14,6,13,104,431,535
2014,12,14,6,14,90,372,462
2014,12,14,6,15,70,399,469
2014,12,14,6,16,62,463,525
2014,12,14,6,17,59,381,440
2014,12,14,6,18,27,280,307
2014,12,14,6,19,13,196,209
2014,12,14,6,20,11,150,161
2014,12,14,6,21,18,117,135
2014,12,14,6,22,22,97,119
2014,12,14,6,23,7,52,59
2014,12,15,0,0,5,25,30
2014,12,15,0,1,4,14,18
2014,12,15,0,2,3,12,15
2014,12,15,0,3,0,3,3
2014,12,15,0,4,1,7,8
2014,12,15,0,5,1,65,66
2014,12,15,0,6,2,207,209
2014,12,15,0,7,6,540,546
2014,12,15,0,8,8,983,991
2014,12,15,0,9,30,474,504
2014,12,15,0,10,34,198,232
2014,12,15,0,11,54,185,239
2014,12,15,0,12,44,282,326
2014,12,15,0,13,64,265,329
2014,12,15,0,14,60,257,317
2014,12,15,0,15,47,308,355
2014,12,15,0,16,63,471,534
2014,12,15,0,17,43,841,884
2014,12,15,0,18,19,769,788
2014,12,15,0,19,17,503,520
2014,12,15,0,20,18,301,319
2014,12,15,0,21,11,214,225
2014,12,15,0,22,18,160,178
2014,12,15,0,23,3,68,71
2014,12,16,1,0,2,32,34
2014,12,16,1,1,0,17,17
2014,12,16,1,2,0,4,4
2014,12,16,1,3,0,4,4
2014,12,16,1,4,0,3,3
2014,12,16,1,5,2,63,65
2014,12,16,1,6,3,213,216
2014,12,16,1,7,10,630,640
2014,12,16,1,8,35,1106,1141
2014,12,16,1,9,31,511,542
2014,12,16,1,10,14,142,156
2014,12,16,1,11,3,41,44
2014,12,16,1,12,4,38,42
2014,12,16,1,13,6,105,111
2014,12,16,1,14,3,64,67
2014,12,16,1,15,15,152,167
2014,12,16,1,16,10,322,332
2014,12,16,1,17,12,650,662
2014,12,16,1,18,7,577,584
2014,12,16,1,19,15,417,432
2014,12,16,1,20,15,269,284
2014,12,16,1,21,15,229,244
2014,12,16,1,22,8,132,140
2014,12,16,1,23,2,75,77
2014,12,17,2,0,4,26,30
2014,12,17,2,1,1,15,16
2014,12,17,2,2,0,12,12
2014,12,17,2,3,0,2,2
2014,12,17,2,4,0,8,8
2014,12,17,2,5,0,64,64
2014,12,17,2,6,5,205,210
2014,12,17,2,7,11,615,626
2014,12,17,2,8,13,957,970
2014,12,17,2,9,20,447,467
2014,12,17,2,10,34,230,264
2014,12,17,2,11,64,189,253
2014,12,17,2,12,32,259,291
2014,12,17,2,13,58,273,331
2014,12,17,2,14,46,239,285
2014,12,17,2,15,52,299,351
2014,12,17,2,16,43,444,487
2014,12,17,2,17,34,749,783
2014,12,17,2,18,36,711,747
2014,12,17,2,19,11,451,462
2014,12,17,2,20,16,257,273
2014,12,17,2,21,3,213,216
2014,12,17,2,22,10,190,200
2014,12,17,2,23,3,83,86
2014,12,18,3,0,1,33,34
2014,12,18,3,1,1,12,13
2014,12,18,3,2,0,7,7
2014,12,18,3,3,1,8,9
2014,12,18,3,4,0,4,4
2014,12,18,3,5,0,60,60
2014,12,18,3,6,0,174,174
2014,12,18,3,7,2,500,502
2014,12,18,3,8,7,869,876
2014,12,18,3,9,16,453,469
2014,12,18,3,10,9,162,171
2014,12,18,3,11,33,229,262
2014,12,18,3,12,17,219,236
2014,12,18,3,13,21,211,232
2014,12,18,3,14,17,242,259
2014,12,18,3,15,12,262,274
2014,12,18,3,16,26,410,436
2014,12,18,3,17,18,659,677
2014,12,18,3,18,19,573,592
2014,12,18,3,19,5,409,414
2014,12,18,3,20,20,256,276
2014,12,18,3,21,9,166,175
2014,12,18,3,22,3,136,139
2014,12,18,3,23,4,75,79
2014,12,19,4,0,3,47,50
2014,12,19,4,1,2,14,16
2014,12,19,4,2,0,13,13
2014,12,19,4,3,0,7,7
2014,12,19,4,4,0,6,6
2014,12,19,4,5,1,40,41
2014,12,19,4,6,3,133,136
2014,12,19,4,7,7,398,405
2014,12,19,4,8,9,764,773
2014,12,19,4,9,22,402,424
2014,12,19,4,10,17,216,233
2014,12,19,4,11,23,228,251
2014,12,19,4,12,33,294,327
2014,12,19,4,13,25,242,267
2014,12,19,4,14,25,219,244
2014,12,19,4,15,44,286,330
2014,12,19,4,16,31,383,414
2014,12,19,4,17,36,620,656
2014,12,19,4,18,7,513,520
2014,12,19,4,19,4,282,286
2014,12,19,4,20,8,189,197
2014,12,19,4,21,4,135,139
2014,12,19,4,22,2,111,113
2014,12,19,4,23,2,68,70
2014,12,20,5,0,2,69,71
2014,12,20,5,1,1,64,65
2014,12,20,5,2,2,35,37
2014,12,20,5,3,0,10,10
2014,12,20,5,4,1,3,4
2014,12,20,5,5,0,6,6
2014,12,20,5,6,0,15,15
2014,12,20,5,7,0,31,31
2014,12,20,5,8,4,88,92
2014,12,20,5,9,17,149,166
2014,12,20,5,10,21,245,266
2014,12,20,5,11,47,305,352
2014,12,20,5,12,34,328,362
2014,12,20,5,13,63,297,360
2014,12,20,5,14,62,249,311
2014,12,20,5,15,49,328,377
2014,12,20,5,16,62,270,332
2014,12,20,5,17,23,212,235
2014,12,20,5,18,22,174,196
2014,12,20,5,19,16,166,182
2014,12,20,5,20,4,134,138
2014,12,20,5,21,8,125,133
2014,12,20,5,22,1,86,87
2014,12,20,5,23,3,58,61
2014,12,21,6,0,4,61,65
2014,12,21,6,1,3,64,67
2014,12,21,6,2,1,37,38
2014,12,21,6,3,2,19,21
2014,12,21,6,4,1,7,8
2014,12,21,6,5,0,2,2
2014,12,21,6,6,1,12,13
2014,12,21,6,7,1,36,37
2014,12,21,6,8,7,70,77
2014,12,21,6,9,36,119,155
2014,12,21,6,10,35,201,236
2014,12,21,6,11,74,245,319
2014,12,21,6,12,74,277,351
2014,12,21,6,13,56,269,325
2014,12,21,6,14,69,270,339
2014,12,21,6,15,71,269,340
2014,12,21,6,16,55,266,321
2014,12,21,6,17,39,194,233
2014,12,21,6,18,34,192,226
2014,12,21,6,19,22,138,160
2014,12,21,6,20,15,102,117
2014,12,21,6,21,8,57,65
2014,12,21,6,22,12,57,69
2014,12,21,6,23,2,33,35
2014,12,22,0,0,2,14,16
2014,12,22,0,1,0,5,5
2014,12,22,0,2,0,2,2
2014,12,22,0,3,0,2,2
2014,12,22,0,4,0,7,7
2014,12,22,0,5,1,36,37
2014,12,22,0,6,0,131,131
2014,12,22,0,7,3,311,314
2014,12,22,0,8,7,629,636
2014,12,22,0,9,24,348,372
2014,12,22,0,10,37,147,184
2014,12,22,0,11,24,140,164
2014,12,22,0,12,16,103,119
2014,12,22,0,13,9,80,89
2014,12,22,0,14,11,62,73
2014,12,22,0,15,7,77,84
2014,12,22,0,16,0,92,92
2014,12,22,0,17,2,192,194
2014,12,22,0,18,2,169,171
2014,12,22,0,19,1,77,78
2014,12,22,0,20,2,86,88
2014,12,22,0,21,1,71,72
2014,12,22,0,22,5,44,49
2014,12,22,0,23,1,21,22
2014,12,23,1,0,0,15,15
2014,12,23,1,1,0,3,3
2014,12,23,1,2,0,6,6
2014,12,23,1,3,0,3,3
2014,12,23,1,4,1,8,9
2014,12,23,1,5,1,29,30
2014,12,23,1,6,0,65,65
2014,12,23,1,7,0,218,218
2014,12,23,1,8,3,394,397
2014,12,23,1,9,12,272,284
2014,12,23,1,10,17,126,143
2014,12,23,1,11,23,158,181
2014,12,23,1,12,25,206,231
2014,12,23,1,13,28,201,229
2014,12,23,1,14,24,198,222
2014,12,23,1,15,22,193,215
2014,12,23,1,16,24,273,297
2014,12,23,1,17,15,392,407
2014,12,23,1,18,9,288,297
2014,12,23,1,19,4,172,176
2014,12,23,1,20,2,139,141
2014,12,23,1,21,4,87,91
2014,12,23,1,22,8,53,61
2014,12,23,1,23,2,32,34
2014,12,24,2,0,0,4,4
2014,12,24,2,1,0,3,3
2014,12,24,2,2,0,4,4
2014,12,24,2,3,1,1,2
2014,12,24,2,4,0,1,1
2014,12,24,2,5,0,13,13
2014,12,24,2,6,0,39,39
2014,12,24,2,7,0,66,66
2014,12,24,2,8,0,52,52
2014,12,24,2,9,1,52,53
2014,12,24,2,10,1,42,43
2014,12,24,2,11,0,65,65
2014,12,24,2,12,0,55,55
2014,12,24,2,13,5,54,59
2014,12,24,2,14,5,110,115
2014,12,24,2,15,0,139,139
2014,12,24,2,16,8,131,139
2014,12,24,2,17,6,91,97
2014,12,24,2,18,5,70,75
2014,12,24,2,19,4,50,54
2014,12,24,2,20,10,46,56
2014,12,24,2,21,4,30,34
2014,12,24,2,22,5,28,33
2014,12,24,2,23,2,21,23
2014,12,25,3,0,5,11,16
2014,12,25,3,1,6,11,17
2014,12,25,3,2,0,1,1
2014,12,25,3,3,0,1,1
2014,12,25,3,4,0,1,1
2014,12,25,3,5,1,2,3
2014,12,25,3,6,0,5,5
2014,12,25,3,7,0,7,7
2014,12,25,3,8,12,17,29
2014,12,25,3,9,7,37,44
2014,12,25,3,10,30,42,72
2014,12,25,3,11,55,78,133
2014,12,25,3,12,74,67,141
2014,12,25,3,13,110,88,198
2014,12,25,3,14,138,101,239
2014,12,25,3,15,123,90,213
2014,12,25,3,16,96,80,176
2014,12,25,3,17,35,52,87
2014,12,25,3,18,18,33,51
2014,12,25,3,19,25,45,70
2014,12,25,3,20,22,36,58
2014,12,25,3,21,13,30,43
2014,12,25,3,22,3,33,36
2014,12,25,3,23,6,15,21
2014,12,26,4,0,0,9,9
2014,12,26,4,1,4,3,7
2014,12,26,4,4,0,3,3
2014,12,26,4,5,0,8,8
2014,12,26,4,6,3,10,13
2014,12,26,4,7,9,28,37
2014,12,26,4,8,16,74,90
2014,12,26,4,9,47,84,131
2014,12,26,4,10,60,93,153
2014,12,26,4,11,88,115,203
2014,12,26,4,12,109,182,291
2014,12,26,4,13,126,193,319
2014,12,26,4,14,152,176,328
2014,12,26,4,15,175,171,346
2014,12,26,4,16,128,154,282
2014,12,26,4,17,72,114,186
2014,12,26,4,18,34,92,126
2014,12,26,4,19,35,78,113
2014,12,26,4,20,37,55,92
2014,12,26,4,21,31,54,85
2014,12,26,4,22,29,49,78
2014,12,26,4,23,15,33,48
2014,12,27,5,0,4,26,30
2014,12,27,5,1,2,23,25
2014,12,27,5,2,1,5,6
2014,12,27,5,3,3,5,8
2014,12,27,5,4,0,2,2
2014,12,27,5,5,1,6,7
2014,12,27,5,6,1,16,17
2014,12,27,5,7,5,30,35
2014,12,27,5,8,27,49,76
2014,12,27,5,9,58,71,129
2014,12,27,5,10,121,113,234
2014,12,27,5,11,145,151,296
2014,12,27,5,12,236,178,414
2014,12,27,5,13,240,179,419
2014,12,27,5,14,316,213,529
2014,12,27,5,15,302,230,532
2014,12,27,5,16,203,195,398
2014,12,27,5,17,184,139,323
2014,12,27,5,18,101,133,234
2014,12,27,5,19,82,99,181
2014,12,27,5,20,48,61,109
2014,12,27,5,21,28,60,88
2014,12,27,5,22,29,53,82
2014,12,27,5,23,14,31,45
2014,12,28,6,0,9,35,44
2014,12,28,6,1,3,30,33
2014,12,28,6,2,1,22,23
2014,12,28,6,3,0,13,13
2014,12,28,6,4,0,4,4
2014,12,28,6,5,1,8,9
2014,12,28,6,6,2,4,6
2014,12,28,6,7,8,18,26
2014,12,28,6,8,18,49,67
2014,12,28,6,9,72,94,166
2014,12,28,6,10,126,120,246
2014,12,28,6,11,151,152,303
2014,12,28,6,12,157,209,366
2014,12,28,6,13,142,175,317
2014,12,28,6,14,114,156,270
2014,12,28,6,15,91,141,232
2014,12,28,6,16,63,77,140
2014,12,28,6,17,32,90,122
2014,12,28,6,18,33,82,115
2014,12,28,6,19,48,88,136
2014,12,28,6,20,32,83,115
2014,12,28,6,21,12,64,76
2014,12,28,6,22,12,34,46
2014,12,28,6,23,0,13,13
2014,12,29,0,0,2,11,13
2014,12,29,0,1,2,4,6
2014,12,29,0,2,0,6,6
2014,12,29,0,3,0,3,3
2014,12,29,0,4,0,3,3
2014,12,29,0,5,0,23,23
2014,12,29,0,6,0,100,100
2014,12,29,0,7,10,254,264
2014,12,29,0,8,24,473,497
2014,12,29,0,9,56,274,330
2014,12,29,0,10,86,160,246
2014,12,29,0,11,124,144,268
2014,12,29,0,12,133,200,333
2014,12,29,0,13,104,200,304
2014,12,29,0,14,118,184,302
2014,12,29,0,15,150,220,370
2014,12,29,0,16,115,305,420
2014,12,29,0,17,81,467,548
2014,12,29,0,18,67,373,440
2014,12,29,0,19,37,246,283
2014,12,29,0,20,32,134,166
2014,12,29,0,21,18,94,112
2014,12,29,0,22,13,85,98
2014,12,29,0,23,3,50,53
2014,12,30,1,0,3,26,29
2014,12,30,1,1,0,12,12
2014,12,30,1,2,2,3,5
2014,12,30,1,3,0,1,1
2014,12,30,1,4,0,3,3
2014,12,30,1,5,1,30,31
2014,12,30,1,6,1,103,104
2014,12,30,1,7,4,277,281
2014,12,30,1,8,25,462,487
2014,12,30,1,9,41,309,350
2014,12,30,1,10,39,167,206
2014,12,30,1,11,97,209,306
2014,12,30,1,12,98,233,331
2014,12,30,1,13,86,250,336
2014,12,30,1,14,122,243,365
2014,12,30,1,15,103,263,366
2014,12,30,1,16,74,374,448
2014,12,30,1,17,41,521,562
2014,12,30,1,18,23,413,436
2014,12,30,1,19,12,246,258
2014,12,30,1,20,9,169,178
2014,12,30,1,21,17,108,125
2014,12,30,1,22,4,81,85
2014,12,30,1,23,1,37,38
2014,12,31,2,0,2,15,17
2014,12,31,2,1,0,11,11
2014,12,31,2,2,0,6,6
2014,12,31,2,3,0,4,4
2014,12,31,2,4,0,3,3
2014,12,31,2,5,1,28,29
2014,12,31,2,6,0,84,84
2014,12,31,2,7,2,195,197
2014,12,31,2,8,15,396,411
2014,12,31,2,9,25,278,303
2014,12,31,2,10,33,150,183
2014,12,31,2,11,68,201,269
2014,12,31,2,12,74,241,315
2014,12,31,2,13,64,252,316
2014,12,31,2,14,52,285,337
2014,12,31,2,15,63,352,415
2014,12,31,2,16,64,323,387
2014,12,31,2,17,43,265,308
2014,12,31,2,18,11,179,190
2014,12,31,2,19,5,161,166
2014,12,31,2,20,9,94,103
2014,12,31,2,21,7,79,86
2014,12,31,2,22,7,74,81
2014,12,31,2,23,5,28,33
2015,1,1,3,0,11,43,54
2015,1,1,3,1,9,109,118
2015,1,1,3,2,5,99,104
2015,1,1,3,3,0,16,16
2015,1,1,3,4,0,8,8
2015,1,1,3,5,0,6,6
2015,1,1,3,6,3,4,7
2015,1,1,3,7,3,8,11
2015,1,1,3,8,6,26,32
2015,1,1,3,9,7,39,46
2015,1,1,3,10,26,78,104
2015,1,1,3,11,55,164,219
2015,1,1,3,12,42,165,207
2015,1,1,3,13,40,170,210
2015,1,1,3,14,80,154,234
2015,1,1,3,15,53,198,251
2015,1,1,3,16,95,190,285
2015,1,1,3,17,56,147,203
2015,1,1,3,18,27,123,150
2015,1,1,3,19,14,84,98
2015,1,1,3,20,7,83,90
2015,1,1,3,21,11,60,71
2015,1,1,3,22,8,47,55
2015,1,1,3,23,1,31,32
2015,1,2,4,0,3,22,25
2015,1,2,4,1,1,17,18
2015,1,2,4,2,0,8,8
2015,1,2,4,3,3,2,5
2015,1,2,4,4,2,3,5
2015,1,2,4,5,0,24,24
2015,1,2,4,6,0,70,70
2015,1,2,4,7,0,163,163
2015,1,2,4,8,8,339,347
2015,1,2,4,9,31,279,310
2015,1,2,4,10,39,153,192
2015,1,2,4,11,76,216,292
2015,1,2,4,12,137,276,413
2015,1,2,4,13,102,274,376
2015,1,2,4,14,123,279,402
2015,1,2,4,15,109,311,420
2015,1,2,4,16,106,392,498
2015,1,2,4,17,69,396,465
2015,1,2,4,18,56,328,384
2015,1,2,4,19,40,211,251
2015,1,2,4,20,10,141,151
2015,1,2,4,21,4,135,139
2015,1,2,4,22,19,98,117
2015,1,2,4,23,0,80,80
2015,1,3,5,0,10,53,63
2015,1,3,5,1,10,41,51
2015,1,3,5,2,0,22,22
2015,1,3,5,3,2,12,14
2015,1,3,5,4,0,6,6
2015,1,3,5,5,0,2,2
2015,1,3,5,6,0,11,11
2015,1,3,5,7,0,26,26
2015,1,3,5,8,7,33,40
2015,1,3,5,9,11,73,84
2015,1,3,5,10,24,138,162
2015,1,3,5,11,24,112,136
2015,1,3,5,12,11,84,95
2015,1,3,5,13,19,101,120
2015,1,3,5,14,29,115,144
2015,1,3,5,15,28,129,157
2015,1,3,5,16,11,111,122
2015,1,3,5,17,11,93,104
2015,1,3,5,18,9,106,115
2015,1,3,5,19,6,79,85
2015,1,3,5,20,3,47,50
2015,1,3,5,21,0,26,26
2015,1,3,5,22,2,24,26
2015,1,3,5,23,0,57,57
2015,1,4,6,0,2,33,35
2015,1,4,6,1,2,30,32
2015,1,4,6,2,1,27,28
2015,1,4,6,3,0,10,10
2015,1,4,6,4,0,3,3
2015,1,4,6,5,0,4,4
2015,1,4,6,6,2,4,6
2015,1,4,6,7,0,12,12
2015,1,4,6,8,5,40,45
2015,1,4,6,9,5,107,112
2015,1,4,6,10,21,194,215
2015,1,4,6,11,34,231,265
2015,1,4,6,12,44,303,347
2015,1,4,6,13,65,281,346
2015,1,4,6,14,69,315,384
2015,1,4,6,15,56,390,446
2015,1,4,6,16,61,352,413
2015,1,4,6,17,59,280,339
2015,1,4,6,18,38,235,273
2015,1,4,6,19,10,93,103
2015,1,4,6,20,9,94,103
2015,1,4,6,21,6,72,78
2015,1,4,6,22,13,60,73
2015,1,4,6,23,1,38,39
2015,1,5,0,0,0,18,18
2015,1,5,0,1,0,3,3
2015,1,5,0,2,0,2,2
2015,1,5,0,3,0,2,2
2015,1,5,0,4,0,7,7
2015,1,5,0,5,1,54,55
2015,1,5,0,6,0,178,178
2015,1,5,0,7,3,473,476
2015,1,5,0,8,18,796,814
2015,1,5,0,9,16,334,350
2015,1,5,0,10,39,151,190
2015,1,5,0,11,30,127,157
2015,1,5,0,12,34,173,207
2015,1,5,0,13,27,189,216
2015,1,5,0,14,29,146,175
2015,1,5,0,15,25,170,195
2015,1,5,0,16,20,346,366
2015,1,5,0,17,27,607,634
2015,1,5,0,18,13,520,533
2015,1,5,0,19,3,325,328
2015,1,5,0,20,1,167,168
2015,1,5,0,21,0,102,102
2015,1,5,0,22,3,53,56
2015,1,5,0,23,4,26,30
2015,1,6,1,0,0,12,12
2015,1,6,1,1,0,6,6
2015,1,6,1,2,0,1,1
2015,1,6,1,4,0,1,1
2015,1,6,1,5,0,23,23
2015,1,6,1,6,1,58,59
2015,1,6,1,7,0,104,104
2015,1,6,1,8,3,148,151
2015,1,6,1,9,1,79,80
2015,1,6,1,10,1,43,44
2015,1,6,1,11,2,57,59
2015,1,6,1,12,0,67,67
2015,1,6,1,13,0,74,74
2015,1,6,1,14,1,73,74
2015,1,6,1,15,3,95,98
2015,1,6,1,16,10,165,175
2015,1,6,1,17,9,295,304
2015,1,6,1,18,1,279,280
2015,1,6,1,19,3,199,202
2015,1,6,1,20,4,124,128
2015,1,6,1,21,4,64,68
2015,1,6,1,22,0,52,52
2015,1,6,1,23,2,22,24
2015,1,7,2,0,0,8,8
2015,1,7,2,1,1,5,6
2015,1,7,2,2,0,1,1
2015,1,7,2,4,0,4,4
2015,1,7,2,5,0,31,31
2015,1,7,2,6,0,85,85
2015,1,7,2,7,1,226,227
2015,1,7,2,8,4,432,436
2015,1,7,2,9,5,269,274
2015,1,7,2,10,7,92,99
2015,1,7,2,11,7,100,107
2015,1,7,2,12,4,107,111
2015,1,7,2,13,6,103,109
2015,1,7,2,14,7,95,102
2015,1,7,2,15,5,125,130
2015,1,7,2,16,4,191,195
2015,1,7,2,17,4,356,360
2015,1,7,2,18,4,332,336
2015,1,7,2,19,3,169,172
2015,1,7,2,20,1,114,115
2015,1,7,2,21,2,82,84
2015,1,7,2,22,0,56,56
2015,1,7,2,23,0,15,15
2015,1,8,3,0,0,9,9
2015,1,8,3,1,0,5,5
2015,1,8,3,2,0,1,1
2015,1,8,3,3,1,2,3
2015,1,8,3,5,0,22,22
2015,1,8,3,6,0,50,50
2015,1,8,3,7,0,206,206
2015,1,8,3,8,6,424,430
2015,1,8,3,9,0,247,247
2015,1,8,3,10,3,97,100
2015,1,8,3,11,0,91,91
2015,1,8,3,12,3,98,101
2015,1,8,3,13,4,119,123
2015,1,8,3,14,2,88,90
2015,1,8,3,15,8,101,109
2015,1,8,3,16,2,172,174
2015,1,8,3,17,3,361,364
2015,1,8,3,18,3,355,358
2015,1,8,3,19,3,180,183
2015,1,8,3,20,0,129,129
2015,1,8,3,21,2,98,100
2015,1,8,3,22,0,54,54
2015,1,8,3,23,0,27,27
2015,1,9,4,0,1,6,7
2015,1,9,4,1,1,6,7
2015,1,9,4,2,0,7,7
2015,1,9,4,4,0,3,3
2015,1,9,4,5,0,22,22
2015,1,9,4,6,0,72,72
2015,1,9,4,7,2,261,263
2015,1,9,4,8,2,537,539
2015,1,9,4,9,5,340,345
2015,1,9,4,10,7,140,147
2015,1,9,4,11,7,152,159
2015,1,9,4,12,8,206,214
2015,1,9,4,13,3,199,202
2015,1,9,4,14,14,145,159
2015,1,9,4,15,8,213,221
2015,1,9,4,16,13,283,296
2015,1,9,4,17,7,547,554
2015,1,9,4,18,4,400,404
2015,1,9,4,19,1,234,235
2015,1,9,4,20,2,160,162
2015,1,9,4,21,0,96,96
2015,1,9,4,22,0,83,83
2015,1,9,4,23,2,38,40
2015,1,10,5,0,2,47,49
2015,1,10,5,1,1,33,34
2015,1,10,5,2,0,13,13
2015,1,10,5,3,1,6,7
2015,1,10,5,5,0,4,4
2015,1,10,5,6,0,9,9
2015,1,10,5,7,1,28,29
2015,1,10,5,8,2,95,97
2015,1,10,5,9,11,147,158
2015,1,10,5,10,7,150,157
2015,1,10,5,11,18,180,198
2015,1,10,5,12,8,215,223
2015,1,10,5,13,18,178,196
2015,1,10,5,14,19,203,222
2015,1,10,5,15,16,224,240
2015,1,10,5,16,11,224,235
2015,1,10,5,17,16,180,196
2015,1,10,5,18,7,172,179
2015,1,10,5,19,10,125,135
2015,1,10,5,20,5,110,115
2015,1,10,5,21,0,70,70
2015,1,10,5,22,3,66,69
2015,1,10,5,23,3,56,59
2015,1,11,6,0,1,56,57
2015,1,11,6,1,1,47,48
2015,1,11,6,2,0,24,24
2015,1,11,6,3,0,6,6
2015,1,11,6,4,0,2,2
2015,1,11,6,5,0,5,5
2015,1,11,6,6,0,2,2
2015,1,11,6,7,0,25,25
2015,1,11,6,8,10,70,80
2015,1,11,6,9,12,111,123
2015,1,11,6,10,16,167,183
2015,1,11,6,11,50,259,309
2015,1,11,6,12,35,310,345
2015,1,11,6,13,42,344,386
2015,1,11,6,14,33,298,331
2015,1,11,6,15,46,278,324
2015,1,11,6,16,44,287,331
2015,1,11,6,17,34,248,282
2015,1,11,6,18,15,196,211
2015,1,11,6,19,4,137,141
2015,1,11,6,20,8,113,121
2015,1,11,6,21,6,62,68
2015,1,11,6,22,4,55,59
2015,1,11,6,23,2,21,23
2015,1,12,0,0,1,13,14
2015,1,12,0,1,1,7,8
2015,1,12,0,2,0,2,2
2015,1,12,0,4,0,1,1
2015,1,12,0,5,0,34,34
2015,1,12,0,6,1,47,48
2015,1,12,0,7,6,60,66
2015,1,12,0,8,2,113,115
2015,1,12,0,9,4,124,128
2015,1,12,0,10,3,80,83
2015,1,12,0,11,1,39,40
2015,1,12,0,12,1,27,28
2015,1,12,0,13,1,30,31
2015,1,12,0,14,2,44,46
2015,1,12,0,15,3,68,71
2015,1,12,0,16,10,135,145
2015,1,12,0,17,8,315,323
2015,1,12,0,18,11,337,348
2015,1,12,0,19,9,282,291
2015,1,12,0,20,4,132,136
2015,1,12,0,21,5,87,92
2015,1,12,0,22,5,82,87
2015,1,12,0,23,5,26,31
2015,1,13,1,0,7,33,40
2015,1,13,1,1,0,13,13
2015,1,13,1,2,0,4,4
2015,1,13,1,4,0,8,8
2015,1,13,1,5,0,49,49
2015,1,13,1,6,1,129,130
2015,1,13,1,7,10,439,449
2015,1,13,1,8,11,823,834
2015,1,13,1,9,11,404,415
2015,1,13,1,10,18,149,167
2015,1,13,1,11,15,158,173
2015,1,13,1,12,25,163,188
2015,1,13,1,13,12,177,189
2015,1,13,1,14,18,141,159
2015,1,13,1,15,14,185,199
2015,1,13,1,16,14,313,327
2015,1,13,1,17,21,603,624
2015,1,13,1,18,7,580,587
2015,1,13,1,19,15,341,356
2015,1,13,1,20,13,225,238
2015,1,13,1,21,17,188,205
2015,1,13,1,22,9,99,108
2015,1,13,1,23,9,49,58
2015,1,14,2,0,9,19,28
2015,1,14,2,1,6,7,13
2015,1,14,2,2,0,3,3
2015,1,14,2,3,0,1,1
2015,1,14,2,4,0,2,2
2015,1,14,2,5,0,31,31
2015,1,14,2,6,1,85,86
2015,1,14,2,7,5,290,295
2015,1,14,2,8,9,476,485
2015,1,14,2,9,15,313,328
2015,1,14,2,10,8,151,159
2015,1,14,2,11,10,149,159
2015,1,14,2,12,6,171,177
2015,1,14,2,13,7,166,173
2015,1,14,2,14,23,120,143
2015,1,14,2,15,14,162,176
2015,1,14,2,16,21,295,316
2015,1,14,2,17,23,562,585
2015,1,14,2,18,11,549,560
2015,1,14,2,19,14,318,332
2015,1,14,2,20,5,208,213
2015,1,14,2,21,8,161,169
2015,1,14,2,22,8,108,116
2015,1,14,2,23,2,46,48
2015,1,15,3,0,3,19,22
2015,1,15,3,1,12,11,23
2015,1,15,3,2,0,3,3
2015,1,15,3,4,0,3,3
2015,1,15,3,5,0,46,46
2015,1,15,3,6,1,141,142
2015,1,15,3,7,2,440,442
2015,1,15,3,8,9,821,830
2015,1,15,3,9,10,359,369
2015,1,15,3,10,16,150,166
2015,1,15,3,11,17,144,161
2015,1,15,3,12,19,224,243
2015,1,15,3,13,25,213,238
2015,1,15,3,14,18,179,197
2015,1,15,3,15,36,208,244
2015,1,15,3,16,33,345,378
2015,1,15,3,17,33,617,650
2015,1,15,3,18,8,618,626
2015,1,15,3,19,9,379,388
2015,1,15,3,20,6,254,260
2015,1,15,3,21,3,179,182
2015,1,15,3,22,4,124,128
2015,1,15,3,23,8,63,71
2015,1,16,4,0,0,26,26
2015,1,16,4,1,0,16,16
2015,1,16,4,2,0,11,11
2015,1,16,4,3,0,1,1
2015,1,16,4,4,0,5,5
2015,1,16,4,5,0,42,42
2015,1,16,4,6,0,108,108
2015,1,16,4,7,3,362,365
2015,1,16,4,8,9,758,767
2015,1,16,4,9,12,401,413
2015,1,16,4,10,15,170,185
2015,1,16,4,11,16,174,190
2015,1,16,4,12,26,228,254
2015,1,16,4,13,39,226,265
2015,1,16,4,14,17,214,231
2015,1,16,4,15,33,270,303
2015,1,16,4,16,20,392,412
2015,1,16,4,17,33,652,685
2015,1,16,4,18,14,530,544
2015,1,16,4,19,9,304,313
2015,1,16,4,20,7,231,238
2015,1,16,4,21,9,129,138
2015,1,16,4,22,1,124,125
2015,1,16,4,23,0,92,92
2015,1,17,5,0,7,69,76
2015,1,17,5,1,1,63,64
2015,1,17,5,2,2,30,32
2015,1,17,5,3,0,12,12
2015,1,17,5,4,0,8,8
2015,1,17,5,5,0,6,6
2015,1,17,5,6,0,16,16
2015,1,17,5,7,2,48,50
2015,1,17,5,8,13,98,111
2015,1,17,5,9,25,177,202
2015,1,17,5,10,42,236,278
2015,1,17,5,11,70,277,347
2015,1,17,5,12,80,323,403
2015,1,17,5,13,87,324,411
2015,1,17,5,14,101,305,406
2015,1,17,5,15,83,369,452
2015,1,17,5,16,73,247,320
2015,1,17,5,17,45,241,286
2015,1,17,5,18,23,201,224
2015,1,17,5,19,4,173,177
2015,1,17,5,20,11,115,126
2015,1,17,5,21,15,87,102
2015,1,17,5,22,7,78,85
2015,1,17,5,23,4,67,71
2015,1,18,6,0,2,62,64
2015,1,18,6,1,2,34,36
2015,1,18,6,2,6,42,48
2015,1,18,6,3,0,17,17
2015,1,18,6,4,0,6,6
2015,1,18,6,5,0,3,3
2015,1,18,6,6,2,10,12
2015,1,18,6,7,1,22,23
2015,1,18,6,8,0,9,9
2015,1,18,6,9,1,24,25
2015,1,18,6,10,5,37,42
2015,1,18,6,11,6,80,86
2015,1,18,6,12,20,136,156
2015,1,18,6,13,20,176,196
2015,1,18,6,14,33,184,217
2015,1,18,6,15,38,233,271
2015,1,18,6,16,31,228,259
2015,1,18,6,17,43,216,259
2015,1,18,6,18,29,238,267
2015,1,18,6,19,10,139,149
2015,1,18,6,20,8,115,123
2015,1,18,6,21,10,97,107
2015,1,18,6,22,4,101,105
2015,1,18,6,23,6,62,68
2015,1,19,0,0,8,35,43
2015,1,19,0,1,4,23,27
2015,1,19,0,2,1,21,22
2015,1,19,0,3,4,9,13
2015,1,19,0,4,0,10,10
2015,1,19,0,5,4,8,12
2015,1,19,0,6,3,32,35
2015,1,19,0,7,2,99,101
2015,1,19,0,8,3,207,210
2015,1,19,0,9,10,167,177
2015,1,19,0,10,35,206,241
2015,1,19,0,11,61,242,303
2015,1,19,0,12,43,327,370
2015,1,19,0,13,78,328,406
2015,1,19,0,14,87,321,408
2015,1,19,0,15,66,313,379
2015,1,19,0,16,82,353,435
2015,1,19,0,17,65,364,429
2015,1,19,0,18,27,313,340
2015,1,19,0,19,13,238,251
2015,1,19,0,20,9,172,181
2015,1,19,0,21,8,119,127
2015,1,19,0,22,2,95,97
2015,1,19,0,23,3,67,70
2015,1,20,1,0,0,12,12
2015,1,20,1,1,0,5,5
2015,1,20,1,2,1,7,8
2015,1,20,1,4,0,7,7
2015,1,20,1,5,0,48,48
2015,1,20,1,6,1,170,171
2015,1,20,1,7,4,478,482
2015,1,20,1,8,8,845,853
2015,1,20,1,9,7,366,373
2015,1,20,1,10,9,184,193
2015,1,20,1,11,8,186,194
2015,1,20,1,12,17,197,214
2015,1,20,1,13,17,192,209
2015,1,20,1,14,18,182,200
2015,1,20,1,15,26,219,245
2015,1,20,1,16,23,384,407
2015,1,20,1,17,24,724,748
2015,1,20,1,18,11,704,715
2015,1,20,1,19,12,467,479
2015,1,20,1,20,7,341,348
2015,1,20,1,21,4,186,190
2015,1,20,1,22,4,120,124
2015,1,20,1,23,1,90,91
2015,1,21,2,0,1,25,26
2015,1,21,2,1,0,7,7
2015,1,21,2,2,0,1,1
2015,1,21,2,3,0,3,3
2015,1,21,2,4,0,8,8
2015,1,21,2,5,0,72,72
2015,1,21,2,6,1,192,193
2015,1,21,2,7,4,490,494
2015,1,21,2,8,4,882,886
2015,1,21,2,9,6,416,422
2015,1,21,2,10,10,145,155
2015,1,21,2,11,18,144,162
2015,1,21,2,12,5,158,163
2015,1,21,2,13,1,76,77
2015,1,21,2,14,8,73,81
2015,1,21,2,15,4,125,129
2015,1,21,2,16,10,229,239
2015,1,21,2,17,15,563,578
2015,1,21,2,18,11,575,586
2015,1,21,2,19,8,389,397
2015,1,21,2,20,4,302,306
2015,1,21,2,21,4,204,208
2015,1,21,2,22,6,110,116
2015,1,21,2,23,1,92,93
2015,1,22,3,0,3,21,24
2015,1,22,3,1,2,10,12
2015,1,22,3,2,1,3,4
2015,1,22,3,3,0,2,2
2015,1,22,3,4,0,3,3
2015,1,22,3,5,1,51,52
2015,1,22,3,6,0,143,143
2015,1,22,3,7,9,437,446
2015,1,22,3,8,10,821,831
2015,1,22,3,9,17,354,371
2015,1,22,3,10,27,187,214
2015,1,22,3,11,29,211,240
2015,1,22,3,12,33,264,297
2015,1,22,3,13,20,238,258
2015,1,22,3,14,8,182,190
2015,1,22,3,15,29,232,261
2015,1,22,3,16,29,376,405
2015,1,22,3,17,30,722,752
2015,1,22,3,18,16,670,686
2015,1,22,3,19,5,439,444
2015,1,22,3,20,15,306,321
2015,1,22,3,21,11,238,249
2015,1,22,3,22,8,131,139
2015,1,22,3,23,7,73,80
2015,1,23,4,0,2,33,35
2015,1,23,4,1,0,9,9
2015,1,23,4,2,0,12,12
2015,1,23,4,3,0,2,2
2015,1,23,4,4,0,6,6
2015,1,23,4,5,0,48,48
2015,1,23,4,6,0,145,145
2015,1,23,4,7,6,412,418
2015,1,23,4,8,15,855,870
2015,1,23,4,9,18,415,433
2015,1,23,4,10,21,182,203
2015,1,23,4,11,23,214,237
2015,1,23,4,12,33,285,318
2015,1,23,4,13,27,280,307
2015,1,23,4,14,21,253,274
2015,1,23,4,15,51,247,298
2015,1,23,4,16,17,332,349
2015,1,23,4,17,19,337,356
2015,1,23,4,18,2,195,197
2015,1,23,4,19,4,117,121
2015,1,23,4,20,3,70,73
2015,1,23,4,21,6,21,27
2015,1,23,4,22,0,19,19
2015,1,23,4,23,0,17,17
2015,1,24,5,0,0,12,12
2015,1,24,5,1,0,8,8
2015,1,24,5,2,0,6,6
2015,1,24,5,3,0,7,7
2015,1,24,5,4,0,2,2
2015,1,24,5,5,0,2,2
2015,1,24,5,6,0,7,7
2015,1,24,5,7,1,30,31
2015,1,24,5,8,5,64,69
2015,1,24,5,9,7,145,152
2015,1,24,5,10,12,199,211
2015,1,24,5,11,13,234,247
2015,1,24,5,12,25,259,284
2015,1,24,5,13,22,254,276
2015,1,24,5,14,16,237,253
2015,1,24,5,15,31,294,325
2015,1,24,5,16,34,282,316
2015,1,24,5,17,28,291,319
2015,1,24,5,18,9,269,278
2015,1,24,5,19,5,212,217
2015,1,24,5,20,7,124,131
2015,1,24,5,21,10,131,141
2015,1,24,5,22,3,111,114
2015,1,24,5,23,3,93,96
2015,1,25,6,0,1,55,56
2015,1,25,6,1,4,75,79
2015,1,25,6,2,2,57,59
2015,1,25,6,3,2,20,22
2015,1,25,6,4,1,8,9
2015,1,25,6,5,0,1,1
2015,1,25,6,6,1,11,12
2015,1,25,6,7,3,31,34
2015,1,25,6,8,1,85,86
2015,1,25,6,9,16,160,176
2015,1,25,6,10,43,318,361
2015,1,25,6,11,72,375,447
2015,1,25,6,12,84,442,526
2015,1,25,6,13,95,441,536
2015,1,25,6,14,65,421,486
2015,1,25,6,15,101,438,539
2015,1,25,6,16,65,416,481
2015,1,25,6,17,35,318,353
2015,1,25,6,18,19,289,308
2015,1,25,6,19,22,204,226
2015,1,25,6,20,12,142,154
2015,1,25,6,21,5,114,119
2015,1,25,6,22,6,93,99
2015,1,25,6,23,2,39,41
2015,1,26,0,0,0,23,23
2015,1,26,0,1,0,5,5
2015,1,26,0,2,0,3,3
2015,1,26,0,3,0,1,1
2015,1,26,0,5,0,31,31
2015,1,26,0,6,0,68,68
2015,1,26,0,7,3,157,160
2015,1,26,0,8,3,324,327
2015,1,26,0,9,0,206,206
2015,1,26,0,10,0,78,78
2015,1,26,0,11,1,58,59
2015,1,26,0,12,0,84,84
2015,1,26,0,13,3,73,76
2015,1,26,0,14,3,69,72
2015,1,26,0,15,2,106,108
2015,1,26,0,16,7,154,161
2015,1,26,0,17,3,332,335
2015,1,26,0,18,6,280,286
2015,1,26,0,19,1,133,134
2015,1,26,0,20,0,119,119
2015,1,26,0,21,1,57,58
2015,1,26,0,22,0,32,32
2015,1,26,0,23,1,21,22
2015,1,27,1,0,0,11,11
2015,1,27,1,1,0,5,5
2015,1,27,1,2,0,1,1
2015,1,27,1,3,0,1,1
2015,1,27,1,4,0,2,2
2015,1,27,1,5,0,24,24
2015,1,27,1,6,1,57,58
2015,1,27,1,7,1,170,171
2015,1,27,1,8,1,330,331
2015,1,27,1,9,2,305,307
2015,1,27,1,10,11,233,244
2015,1,27,1,11,4,130,134
2015,1,27,1,12,4,131,135
2015,1,27,1,13,6,148,154
2015,1,27,1,14,9,127,136
2015,1,27,1,15,11,172,183
2015,1,27,1,16,5,249,254
2015,1,27,1,17,11,562,573
2015,1,27,1,18,3,489,492
2015,1,27,1,19,0,343,343
2015,1,27,1,20,0,253,253
2015,1,27,1,21,2,159,161
2015,1,27,1,22,1,85,86
2015,1,27,1,23,0,43,43
2015,1,28,2,0,0,14,14
2015,1,28,2,1,0,7,7
2015,1,28,2,2,0,1,1
2015,1,28,2,3,0,1,1
2015,1,28,2,4,0,4,4
2015,1,28,2,5,1,44,45
2015,1,28,2,6,1,142,143
2015,1,28,2,7,2,387,389
2015,1,28,2,8,6,653,659
2015,1,28,2,9,6,350,356
2015,1,28,2,10,4,142,146
2015,1,28,2,11,3,132,135
2015,1,28,2,12,7,199,206
2015,1,28,2,13,9,174,183
2015,1,28,2,14,6,160,166
2015,1,28,2,15,9,184,193
2015,1,28,2,16,7,304,311
2015,1,28,2,17,18,606,624
2015,1,28,2,18,8,549,557
2015,1,28,2,19,9,355,364
2015,1,28,2,20,3,250,253
2015,1,28,2,21,2,181,183
2015,1,28,2,22,2,152,154
2015,1,28,2,23,0,37,37
2015,1,29,3,0,0,15,15
2015,1,29,3,1,0,5,5
2015,1,29,3,2,0,3,3
2015,1,29,3,3,0,4,4
2015,1,29,3,4,0,5,5
2015,1,29,3,5,0,47,47
2015,1,29,3,6,0,127,127
2015,1,29,3,7,4,407,411
2015,1,29,3,8,5,767,772
2015,1,29,3,9,7,379,386
2015,1,29,3,10,10,161,171
2015,1,29,3,11,6,159,165
2015,1,29,3,12,11,209,220
2015,1,29,3,13,13,173,186
2015,1,29,3,14,8,150,158
2015,1,29,3,15,6,178,184
2015,1,29,3,16,1,166,167
2015,1,29,3,17,3,365,368
2015,1,29,3,18,8,429,437
2015,1,29,3,19,4,298,302
2015,1,29,3,20,6,215,221
2015,1,29,3,21,2,159,161
2015,1,29,3,22,1,107,108
2015,1,29,3,23,0,56,56
2015,1,30,4,0,0,36,36
2015,1,30,4,1,2,12,14
2015,1,30,4,2,0,9,9
2015,1,30,4,3,0,2,2
2015,1,30,4,4,0,4,4
2015,1,30,4,5,0,44,44
2015,1,30,4,6,0,139,139
2015,1,30,4,7,2,402,404
2015,1,30,4,8,9,752,761
2015,1,30,4,9,8,418,426
2015,1,30,4,10,6,168,174
2015,1,30,4,11,9,172,181
2015,1,30,4,12,7,213,220
2015,1,30,4,13,18,210,228
2015,1,30,4,14,13,179,192
2015,1,30,4,15,20,196,216
2015,1,30,4,16,11,333,344
2015,1,30,4,17,11,533,544
2015,1,30,4,18,8,388,396
2015,1,30,4,19,2,244,246
2015,1,30,4,20,4,125,129
2015,1,30,4,21,0,81,81
2015,1,30,4,22,1,68,69
2015,1,30,4,23,0,46,46
2015,1,31,5,0,2,46,48
2015,1,31,5,1,2,35,37
2015,1,31,5,2,1,12,13
2015,1,31,5,3,0,9,9
2015,1,31,5,4,0,5,5
2015,1,31,5,5,0,3,3
2015,1,31,5,6,0,13,13
2015,1,31,5,7,0,44,44
2015,1,31,5,8,6,94,100
2015,1,31,5,9,6,161,167
2015,1,31,5,10,9,185,194
2015,1,31,5,11,28,219,247
2015,1,31,5,12,30,254,284
2015,1,31,5,13,40,244,284
2015,1,31,5,14,54,246,300
2015,1,31,5,15,20,262,282
2015,1,31,5,16,49,246,295
2015,1,31,5,17,25,207,232
2015,1,31,5,18,2,185,187
2015,1,31,5,19,16,200,216
2015,1,31,5,20,10,119,129
2015,1,31,5,21,9,85,94
2015,1,31,5,22,8,101,109
2015,1,31,5,23,4,75,79
2015,2,1,6,0,4,80,84
2015,2,1,6,1,3,46,49
2015,2,1,6,2,0,40,40
2015,2,1,6,3,0,12,12
2015,2,1,6,4,0,4,4
2015,2,1,6,5,1,4,5
2015,2,1,6,6,0,1,1
2015,2,1,6,7,2,25,27
2015,2,1,6,8,6,88,94
2015,2,1,6,9,12,130,142
2015,2,1,6,10,22,246,268
2015,2,1,6,11,27,249,276
2015,2,1,6,12,24,308,332
2015,2,1,6,13,34,285,319
2015,2,1,6,14,23,239,262
2015,2,1,6,15,31,293,324
2015,2,1,6,16,27,313,340
2015,2,1,6,17,29,338,367
2015,2,1,6,18,9,233,242
2015,2,1,6,19,3,88,91
2015,2,1,6,20,5,68,73
2015,2,1,6,21,4,60,64
2015,2,1,6,22,3,165,168
2015,2,1,6,23,0,37,37
2015,2,2,0,0,1,10,11
2015,2,2,0,1,0,7,7
2015,2,2,0,2,0,3,3
2015,2,2,0,3,0,1,1
2015,2,2,0,4,0,2,2
2015,2,2,0,5,1,47,48
2015,2,2,0,6,0,130,130
2015,2,2,0,7,3,323,326
2015,2,2,0,8,1,521,522
2015,2,2,0,9,3,171,174
2015,2,2,0,10,2,104,106
2015,2,2,0,11,5,114,119
2015,2,2,0,12,5,138,143
2015,2,2,0,13,6,161,167
2015,2,2,0,14,6,134,140
2015,2,2,0,15,5,179,184
2015,2,2,0,16,5,263,268
2015,2,2,0,17,6,533,539
2015,2,2,0,18,3,417,420
2015,2,2,0,19,0,256,256
2015,2,2,0,20,0,151,151
2015,2,2,0,21,1,105,106
2015,2,2,0,22,0,62,62
2015,2,2,0,23,1,25,26
2015,2,3,1,0,0,8,8
2015,2,3,1,1,0,8,8
2015,2,3,1,4,0,3,3
2015,2,3,1,5,0,34,34
2015,2,3,1,6,0,119,119
2015,2,3,1,7,1,376,377
2015,2,3,1,8,0,766,766
2015,2,3,1,9,1,360,361
2015,2,3,1,10,0,112,112
2015,2,3,1,11,0,126,126
2015,2,3,1,12,0,166,166
2015,2,3,1,13,2,190,192
2015,2,3,1,14,0,161,161
2015,2,3,1,15,1,220,221
2015,2,3,1,16,1,322,323
2015,2,3,1,17,0,657,657
2015,2,3,1,18,0,572,572
2015,2,3,1,19,0,403,403
2015,2,3,1,20,0,238,238
2015,2,3,1,21,0,179,179
2015,2,3,1,22,0,102,102
2015,2,3,1,23,0,34,34
2015,2,4,2,0,0,20,20
2015,2,4,2,1,0,6,6
2015,2,4,2,4,0,3,3
2015,2,4,2,5,0,55,55
2015,2,4,2,6,0,179,179
2015,2,4,2,7,0,483,483
2015,2,4,2,8,0,813,813
2015,2,4,2,9,0,350,350
2015,2,4,2,10,4,160,164
2015,2,4,2,11,0,170,170
2015,2,4,2,12,0,250,250
2015,2,4,2,13,0,194,194
2015,2,4,2,14,0,170,170
2015,2,4,2,15,0,213,213
2015,2,4,2,16,4,396,400
2015,2,4,2,17,8,735,743
2015,2,4,2,18,11,722,733
2015,2,4,2,19,2,449,451
2015,2,4,2,20,3,308,311
2015,2,4,2,21,4,209,213
2015,2,4,2,22,5,126,131
2015,2,4,2,23,2,84,86
2015,2,5,3,0,1,31,32
2015,2,5,3,1,0,11,11
2015,2,5,3,2,0,4,4
2015,2,5,3,3,0,4,4
2015,2,5,3,4,0,6,6
2015,2,5,3,5,1,39,40
2015,2,5,3,6,0,152,152
2015,2,5,3,7,2,446,448
2015,2,5,3,8,3,856,859
2015,2,5,3,9,9,363,372
2015,2,5,3,10,19,150,169
2015,2,5,3,11,3,148,151
2015,2,5,3,12,13,182,195
2015,2,5,3,13,18,156,174
2015,2,5,3,14,26,142,168
2015,2,5,3,15,18,167,185
2015,2,5,3,16,16,287,303
2015,2,5,3,17,16,539,555
2015,2,5,3,18,0,455,455
2015,2,5,3,19,1,306,307
2015,2,5,3,20,12,209,221
2015,2,5,3,21,2,142,144
2015,2,5,3,22,2,78,80
2015,2,5,3,23,0,41,41
2015,2,6,4,0,0,20,20
2015,2,6,4,1,0,12,12
2015,2,6,4,2,1,3,4
2015,2,6,4,4,0,5,5
2015,2,6,4,5,0,36,36
2015,2,6,4,6,1,105,106
2015,2,6,4,7,3,314,317
2015,2,6,4,8,3,622,625
2015,2,6,4,9,6,358,364
2015,2,6,4,10,17,155,172
2015,2,6,4,11,3,177,180
2015,2,6,4,12,12,198,210
2015,2,6,4,13,26,202,228
2015,2,6,4,14,11,155,166
2015,2,6,4,15,15,211,226
2015,2,6,4,16,19,335,354
2015,2,6,4,17,24,586,610
2015,2,6,4,18,10,479,489
2015,2,6,4,19,9,322,331
2015,2,6,4,20,11,193,204
2015,2,6,4,21,8,142,150
2015,2,6,4,22,1,107,108
2015,2,6,4,23,3,86,89
2015,2,7,5,0,5,81,86
2015,2,7,5,1,0,44,44
2015,2,7,5,2,2,19,21
2015,2,7,5,3,4,12,16
2015,2,7,5,4,0,2,2
2015,2,7,5,5,1,1,2
2015,2,7,5,6,2,11,13
2015,2,7,5,7,5,44,49
2015,2,7,5,8,14,112,126
2015,2,7,5,9,22,190,212
2015,2,7,5,10,26,258,284
2015,2,7,5,11,52,314,366
2015,2,7,5,12,107,373,480
2015,2,7,5,13,89,375,464
2015,2,7,5,14,100,356,456
2015,2,7,5,15,111,372,483
2015,2,7,5,16,52,345,397
2015,2,7,5,17,54,310,364
2015,2,7,5,18,49,268,317
2015,2,7,5,19,28,239,267
2015,2,7,5,20,18,178,196
2015,2,7,5,21,14,131,145
2015,2,7,5,22,6,127,133
2015,2,7,5,23,8,105,113
2015,2,8,6,0,18,77,95
2015,2,8,6,1,10,64,74
2015,2,8,6,2,4,55,59
2015,2,8,6,3,3,22,25
2015,2,8,6,4,0,3,3
2015,2,8,6,5,1,7,8
2015,2,8,6,6,0,4,4
2015,2,8,6,7,3,22,25
2015,2,8,6,8,9,86,95
2015,2,8,6,9,22,158,180
2015,2,8,6,10,46,266,312
2015,2,8,6,11,92,354,446
2015,2,8,6,12,132,400,532
2015,2,8,6,13,202,530,732
2015,2,8,6,14,216,515,731
2015,2,8,6,15,270,604,874
2015,2,8,6,16,283,598,881
2015,2,8,6,17,172,465,637
2015,2,8,6,18,67,362,429
2015,2,8,6,19,44,242,286
2015,2,8,6,20,14,136,150
2015,2,8,6,21,13,109,122
2015,2,8,6,22,11,69,80
2015,2,8,6,23,4,45,49
2015,2,9,0,0,3,15,18
2015,2,9,0,1,2,13,15
2015,2,9,0,2,1,8,9
2015,2,9,0,3,0,1,1
2015,2,9,0,4,1,5,6
2015,2,9,0,5,0,48,48
2015,2,9,0,6,1,158,159
2015,2,9,0,7,13,501,514
2015,2,9,0,8,11,849,860
2015,2,9,0,9,13,358,371
2015,2,9,0,10,17,142,159
2015,2,9,0,11,27,123,150
2015,2,9,0,12,14,186,200
2015,2,9,0,13,21,186,207
2015,2,9,0,14,12,145,157
2015,2,9,0,15,10,215,225
2015,2,9,0,16,16,317,333
2015,2,9,0,17,3,434,437
2015,2,9,0,18,5,495,500
2015,2,9,0,19,4,322,326
2015,2,9,0,20,5,161,166
2015,2,9,0,21,1,79,80
2015,2,9,0,22,1,55,56
2015,2,9,0,23,0,20,20
2015,2,10,1,0,0,8,8
2015,2,10,1,1,0,3,3
2015,2,10,1,3,0,2,2
2015,2,10,1,4,0,4,4
2015,2,10,1,5,0,42,42
2015,2,10,1,6,0,129,129
2015,2,10,1,7,5,401,406
2015,2,10,1,8,13,806,819
2015,2,10,1,9,7,349,356
2015,2,10,1,10,10,163,173
2015,2,10,1,11,15,148,163
2015,2,10,1,12,19,202,221
2015,2,10,1,13,19,199,218
2015,2,10,1,14,14,162,176
2015,2,10,1,15,13,201,214
2015,2,10,1,16,27,293,320
2015,2,10,1,17,20,728,748
2015,2,10,1,18,20,614,634
2015,2,10,1,19,5,418,423
2015,2,10,1,20,16,312,328
2015,2,10,1,21,3,217,220
2015,2,10,1,22,7,105,112
2015,2,10,1,23,1,48,49
2015,2,11,2,0,0,17,17
2015,2,11,2,1,0,4,4
2015,2,11,2,2,0,3,3
2015,2,11,2,3,1,1,2
2015,2,11,2,4,0,1,1
2015,2,11,2,5,2,49,51
2015,2,11,2,6,5,166,171
2015,2,11,2,7,8,454,462
2015,2,11,2,8,18,917,935
2015,2,11,2,9,29,408,437
2015,2,11,2,10,26,149,175
2015,2,11,2,11,24,225,249
2015,2,11,2,12,30,230,260
2015,2,11,2,13,33,221,254
2015,2,11,2,14,36,181,217
2015,2,11,2,15,33,227,260
2015,2,11,2,16,51,392,443
2015,2,11,2,17,69,767,836
2015,2,11,2,18,23,682,705
2015,2,11,2,19,27,441,468
2015,2,11,2,20,7,286,293
2015,2,11,2,21,7,257,264
2015,2,11,2,22,8,120,128
2015,2,11,2,23,3,70,73
2015,2,12,3,0,2,22,24
2015,2,12,3,1,4,7,11
2015,2,12,3,2,2,0,2
2015,2,12,3,4,0,1,1
2015,2,12,3,5,0,46,46
2015,2,12,3,6,3,157,160
2015,2,12,3,7,5,459,464
2015,2,12,3,8,25,901,926
2015,2,12,3,9,21,368,389
2015,2,12,3,10,12,161,173
2015,2,12,3,11,20,166,186
2015,2,12,3,12,12,183,195
2015,2,12,3,13,16,208,224
2015,2,12,3,14,14,157,171
2015,2,12,3,15,15,193,208
2015,2,12,3,16,18,324,342
2015,2,12,3,17,24,604,628
2015,2,12,3,18,8,562,570
2015,2,12,3,19,14,308,322
2015,2,12,3,20,9,224,233
2015,2,12,3,21,6,114,120
2015,2,12,3,22,1,80,81
2015,2,12,3,23,0,33,33
2015,2,13,4,0,0,20,20
2015,2,13,4,1,0,6,6
2015,2,13,4,2,0,3,3
2015,2,13,4,3,2,1,3
2015,2,13,4,4,0,4,4
2015,2,13,4,5,0,27,27
2015,2,13,4,6,2,59,61
2015,2,13,4,7,3,255,258
2015,2,13,4,8,4,512,516
2015,2,13,4,9,9,305,314
2015,2,13,4,10,3,136,139
2015,2,13,4,11,9,135,144
2015,2,13,4,12,15,182,197
2015,2,13,4,13,19,192,211
2015,2,13,4,14,12,151,163
2015,2,13,4,15,21,213,234
2015,2,13,4,16,25,284,309
2015,2,13,4,17,17,442,459
2015,2,13,4,18,11,362,373
2015,2,13,4,19,8,227,235
2015,2,13,4,20,3,175,178
2015,2,13,4,21,2,101,103
2015,2,13,4,22,6,70,76
2015,2,13,4,23,2,43,45
2015,2,14,5,0,0,44,44
2015,2,14,5,1,0,40,40
2015,2,14,5,2,0,23,23
2015,2,14,5,3,0,6,6
2015,2,14,5,4,0,3,3
2015,2,14,5,5,0,2,2
2015,2,14,5,6,0,11,11
2015,2,14,5,7,4,31,35
2015,2,14,5,8,10,106,116
2015,2,14,5,9,18,141,159
2015,2,14,5,10,30,195,225
2015,2,14,5,11,28,220,248
2015,2,14,5,12,47,206,253
2015,2,14,5,13,48,222,270
2015,2,14,5,14,87,206,293
2015,2,14,5,15,92,266,358
2015,2,14,5,16,64,259,323
2015,2,14,5,17,66,223,289
2015,2,14,5,18,18,144,162
2015,2,14,5,19,5,47,52
2015,2,14,5,20,1,24,25
2015,2,14,5,21,0,27,27
2015,2,14,5,22,0,26,26
2015,2,14,5,23,0,14,14
2015,2,15,6,0,1,11,12
2015,2,15,6,1,0,7,7
2015,2,15,6,2,0,11,11
2015,2,15,6,3,1,4,5
2015,2,15,6,5,0,1,1
2015,2,15,6,6,1,3,4
2015,2,15,6,7,0,7,7
2015,2,15,6,8,1,22,23
2015,2,15,6,9,5,36,41
2015,2,15,6,10,4,63,67
2015,2,15,6,11,6,66,72
2015,2,15,6,12,5,72,77
2015,2,15,6,13,5,80,85
2015,2,15,6,14,8,95,103
2015,2,15,6,15,4,80,84
2015,2,15,6,16,5,93,98
2015,2,15,6,17,17,91,108
2015,2,15,6,18,4,69,73
2015,2,15,6,19,2,50,52
2015,2,15,6,20,0,37,37
2015,2,15,6,21,3,36,39
2015,2,15,6,22,0,34,34
2015,2,15,6,23,0,15,15
2015,2,16,0,0,0,8,8
2015,2,16,0,1,0,3,3
2015,2,16,0,2,0,3,3
2015,2,16,0,3,0,1,1
2015,2,16,0,4,0,1,1
2015,2,16,0,5,0,4,4
2015,2,16,0,6,2,13,15
2015,2,16,0,7,2,41,43
2015,2,16,0,8,2,91,93
2015,2,16,0,9,9,91,100
2015,2,16,0,10,9,89,98
2015,2,16,0,11,15,108,123
2015,2,16,0,12,12,132,144
2015,2,16,0,13,13,136,149
2015,2,16,0,14,12,121,133
2015,2,16,0,15,8,112,120
2015,2,16,0,16,5,91,96
2015,2,16,0,17,8,64,72
2015,2,16,0,18,0,47,47
2015,2,16,0,19,0,30,30
2015,2,16,0,20,0,17,17
2015,2,16,0,21,1,10,11
2015,2,16,0,22,0,15,15
2015,2,16,0,23,0,9,9
2015,2,17,1,0,0,12,12
2015,2,17,1,1,0,8,8
2015,2,17,1,3,0,1,1
2015,2,17,1,5,0,2,2
2015,2,17,1,6,0,5,5
2015,2,17,1,7,0,12,12
2015,2,17,1,8,0,35,35
2015,2,17,1,9,0,41,41
2015,2,17,1,10,0,42,42
2015,2,17,1,11,5,47,52
2015,2,17,1,12,2,69,71
2015,2,17,1,13,3,84,87
2015,2,17,1,14,4,75,79
2015,2,17,1,15,5,89,94
2015,2,17,1,16,5,107,112
2015,2,17,1,17,5,124,129
2015,2,17,1,18,2,123,125
2015,2,17,1,19,3,96,99
2015,2,17,1,20,0,73,73
2015,2,17,1,21,1,50,51
2015,2,17,1,22,1,50,51
2015,2,17,1,23,0,17,17
2015,2,18,2,0,0,10,10
2015,2,18,2,1,0,4,4
2015,2,18,2,4,0,4,4
2015,2,18,2,5,0,20,20
2015,2,18,2,6,0,68,68
2015,2,18,2,7,0,213,213
2015,2,18,2,8,3,386,389
2015,2,18,2,9,5,239,244
2015,2,18,2,10,5,118,123
2015,2,18,2,11,1,97,98
2015,2,18,2,12,4,138,142
2015,2,18,2,13,3,120,123
2015,2,18,2,14,1,110,111
2015,2,18,2,15,3,129,132
2015,2,18,2,16,7,201,208
2015,2,18,2,17,7,420,427
2015,2,18,2,18,4,340,344
2015,2,18,2,19,2,204,206
2015,2,18,2,20,0,149,149
2015,2,18,2,21,0,83,83
2015,2,18,2,22,0,57,57
2015,2,18,2,23,0,28,28
2015,2,19,3,0,0,9,9
2015,2,19,3,1,0,3,3
2015,2,19,3,2,0,3,3
2015,2,19,3,4,0,3,3
2015,2,19,3,5,0,17,17
2015,2,19,3,6,0,79,79
2015,2,19,3,7,0,234,234
2015,2,19,3,8,3,436,439
2015,2,19,3,9,8,227,235
2015,2,19,3,10,1,84,85
2015,2,19,3,11,9,93,102
2015,2,19,3,12,8,90,98
2015,2,19,3,13,4,86,90
2015,2,19,3,14,3,64,67
2015,2,19,3,15,6,104,110
2015,2,19,3,16,2,153,155
2015,2,19,3,17,5,298,303
2015,2,19,3,18,2,271,273
2015,2,19,3,19,1,169,170
2015,2,19,3,20,1,107,108
2015,2,19,3,21,3,77,80
2015,2,19,3,22,2,42,44
2015,2,19,3,23,0,13,13
2015,2,20,4,0,0,9,9
2015,2,20,4,1,0,3,3
2015,2,20,4,2,0,1,1
2015,2,20,4,3,0,1,1
2015,2,20,4,4,0,2,2
2015,2,20,4,5,0,17,17
2015,2,20,4,6,0,48,48
2015,2,20,4,7,2,155,157
2015,2,20,4,8,5,320,325
2015,2,20,4,9,2,173,175
2015,2,20,4,10,3,66,69
2015,2,20,4,11,6,76,82
2015,2,20,4,12,7,93,100
2015,2,20,4,13,7,108,115
2015,2,20,4,14,4,92,96
2015,2,20,4,15,2,125,127
2015,2,20,4,16,12,181,193
2015,2,20,4,17,7,323,330
2015,2,20,4,18,1,242,243
2015,2,20,4,19,0,159,159
2015,2,20,4,20,3,104,107
2015,2,20,4,21,0,69,69
2015,2,20,4,22,1,44,45
2015,2,20,4,23,1,43,44
2015,2,21,5,0,0,25,25
2015,2,21,5,1,0,14,14
2015,2,21,5,2,0,15,15
2015,2,21,5,3,0,4,4
2015,2,21,5,4,0,3,3
2015,2,21,5,5,0,5,5
2015,2,21,5,6,1,7,8
2015,2,21,5,7,0,28,28
2015,2,21,5,8,3,69,72
2015,2,21,5,9,1,120,121
2015,2,21,5,10,7,155,162
2015,2,21,5,11,4,59,63
2015,2,21,5,12,1,47,48
2015,2,21,5,13,1,28,29
2015,2,21,5,14,0,21,21
2015,2,21,5,15,3,15,18
2015,2,21,5,16,0,28,28
2015,2,21,5,17,0,23,23
2015,2,21,5,18,1,18,19
2015,2,21,5,19,1,12,13
2015,2,21,5,20,0,6,6
2015,2,21,5,21,0,8,8
2015,2,21,5,22,0,14,14
2015,2,21,5,23,2,9,11
2015,2,22,6,0,0,8,8
2015,2,22,6,1,0,12,12
2015,2,22,6,2,0,6,6
2015,2,22,6,3,0,5,5
2015,2,22,6,4,0,2,2
2015,2,22,6,6,1,1,2
2015,2,22,6,7,0,9,9
2015,2,22,6,8,1,26,27
2015,2,22,6,9,2,38,40
2015,2,22,6,10,5,72,77
2015,2,22,6,11,5,118,123
2015,2,22,6,12,8,138,146
2015,2,22,6,13,18,146,164
2015,2,22,6,14,12,183,195
2015,2,22,6,15,30,255,285
2015,2,22,6,16,23,222,245
2015,2,22,6,17,23,180,203
2015,2,22,6,18,14,156,170
2015,2,22,6,19,2,112,114
2015,2,22,6,20,4,67,71
2015,2,22,6,21,0,44,44
2015,2,22,6,22,4,40,44
2015,2,22,6,23,0,29,29
2015,2,23,0,0,2,40,42
2015,2,23,0,1,3,5,8
2015,2,23,0,2,1,3,4
2015,2,23,0,3,1,2,3
2015,2,23,0,4,0,5,5
2015,2,23,0,5,0,36,36
2015,2,23,0,6,2,101,103
2015,2,23,0,7,3,324,327
2015,2,23,0,8,10,533,543
2015,2,23,0,9,1,288,289
2015,2,23,0,10,1,82,83
2015,2,23,0,11,1,88,89
2015,2,23,0,12,8,117,125
2015,2,23,0,13,1,109,110
2015,2,23,0,14,9,94,103
2015,2,23,0,15,13,129,142
2015,2,23,0,16,6,236,242
2015,2,23,0,17,7,429,436
2015,2,23,0,18,6,374,380
2015,2,23,0,19,2,254,256
2015,2,23,0,20,1,155,156
2015,2,23,0,21,3,105,108
2015,2,23,0,22,0,42,42
2015,2,23,0,23,0,23,23
2015,2,24,1,0,0,10,10
2015,2,24,1,1,0,4,4
2015,2,24,1,2,0,1,1
2015,2,24,1,3,0,1,1
2015,2,24,1,4,0,6,6
2015,2,24,1,5,0,21,21
2015,2,24,1,6,0,91,91
2015,2,24,1,7,1,316,317
2015,2,24,1,8,4,525,529
2015,2,24,1,9,1,272,273
2015,2,24,1,10,4,116,120
2015,2,24,1,11,5,117,122
2015,2,24,1,12,5,136,141
2015,2,24,1,13,4,127,131
2015,2,24,1,14,4,125,129
2015,2,24,1,15,7,133,140
2015,2,24,1,16,5,253,258
2015,2,24,1,17,5,452,457
2015,2,24,1,18,9,429,438
2015,2,24,1,19,2,281,283
2015,2,24,1,20,1,186,187
2015,2,24,1,21,1,150,151
2015,2,24,1,22,1,67,68
2015,2,24,1,23,1,42,43
2015,2,25,2,0,0,17,17
2015,2,25,2,1,0,8,8
2015,2,25,2,2,0,2,2
2015,2,25,2,3,0,1,1
2015,2,25,2,4,0,3,3
2015,2,25,2,5,0,35,35
2015,2,25,2,6,1,120,121
2015,2,25,2,7,1,366,367
2015,2,25,2,8,8,660,668
2015,2,25,2,9,4,346,350
2015,2,25,2,10,3,129,132
2015,2,25,2,11,7,144,151
2015,2,25,2,12,15,189,204
2015,2,25,2,13,15,160,175
2015,2,25,2,14,5,159,164
2015,2,25,2,15,8,184,192
2015,2,25,2,16,16,296,312
2015,2,25,2,17,17,611,628
2015,2,25,2,18,10,573,583
2015,2,25,2,19,7,335,342
2015,2,25,2,20,2,223,225
2015,2,25,2,21,1,131,132
2015,2,25,2,22,2,126,128
2015,2,25,2,23,1,75,76
2015,2,26,3,0,9,19,28
2015,2,26,3,1,3,16,19
2015,2,26,3,2,0,7,7
2015,2,26,3,3,0,2,2
2015,2,26,3,4,0,3,3
2015,2,26,3,5,0,20,20
2015,2,26,3,6,0,33,33
2015,2,26,3,7,1,85,86
2015,2,26,3,8,1,141,142
2015,2,26,3,9,4,151,155
2015,2,26,3,10,4,157,161
2015,2,26,3,11,2,117,119
2015,2,26,3,12,8,120,128
2015,2,26,3,13,4,133,137
2015,2,26,3,14,7,114,121
2015,2,26,3,15,3,165,168
2015,2,26,3,16,14,275,289
2015,2,26,3,17,15,511,526
2015,2,26,3,18,7,494,501
2015,2,26,3,19,4,314,318
2015,2,26,3,20,7,221,228
2015,2,26,3,21,7,149,156
2015,2,26,3,22,2,108,110
2015,2,26,3,23,4,70,74
2015,2,27,4,0,4,22,26
2015,2,27,4,1,0,9,9
2015,2,27,4,2,0,5,5
2015,2,27,4,3,0,4,4
2015,2,27,4,4,0,5,5
2015,2,27,4,5,0,33,33
2015,2,27,4,6,0,92,92
2015,2,27,4,7,2,315,317
2015,2,27,4,8,9,642,651
2015,2,27,4,9,13,356,369
2015,2,27,4,10,12,166,178
2015,2,27,4,11,15,150,165
2015,2,27,4,12,7,187,194
2015,2,27,4,13,19,193,212
2015,2,27,4,14,10,125,135
2015,2,27,4,15,17,226,243
2015,2,27,4,16,10,293,303
2015,2,27,4,17,31,534,565
2015,2,27,4,18,10,447,457
2015,2,27,4,19,18,291,309
2015,2,27,4,20,2,157,159
2015,2,27,4,21,8,84,92
2015,2,27,4,22,0,108,108
2015,2,27,4,23,4,64,68
2015,2,28,5,0,0,55,55
2015,2,28,5,1,0,30,30
2015,2,28,5,2,0,13,13
2015,2,28,5,3,1,4,5
2015,2,28,5,4,0,8,8
2015,2,28,5,5,1,1,2
2015,2,28,5,6,1,5,6
2015,2,28,5,7,1,39,40
2015,2,28,5,8,11,92,103
2015,2,28,5,9,13,160,173
2015,2,28,5,10,18,187,205
2015,2,28,5,11,9,220,229
2015,2,28,5,12,25,219,244
2015,2,28,5,13,59,249,308
2015,2,28,5,14,66,244,310
2015,2,28,5,15,45,266,311
2015,2,28,5,16,72,247,319
2015,2,28,5,17,50,224,274
2015,2,28,5,18,24,179,203
2015,2,28,5,19,3,120,123
2015,2,28,5,20,5,116,121
2015,2,28,5,21,2,83,85
2015,2,28,5,22,7,67,74
2015,2,28,5,23,1,52,53
2015,3,1,6,0,2,43,45
2015,3,1,6,1,2,35,37
2015,3,1,6,2,2,39,41
2015,3,1,6,3,0,10,10
2015,3,1,6,4,0,2,2
2015,3,1,6,5,0,3,3
2015,3,1,6,6,0,7,7
2015,3,1,6,7,1,44,45
2015,3,1,6,8,2,49,51
2015,3,1,6,9,7,79,86
2015,3,1,6,10,2,75,77
2015,3,1,6,11,6,60,66
2015,3,1,6,12,3,48,51
2015,3,1,6,13,7,31,38
2015,3,1,6,14,4,19,23
2015,3,1,6,15,5,30,35
2015,3,1,6,16,3,26,29
2015,3,1,6,17,0,29,29
2015,3,1,6,18,0,33,33
2015,3,1,6,19,0,16,16
2015,3,1,6,20,2,17,19
2015,3,1,6,21,0,24,24
2015,3,1,6,22,0,27,27
2015,3,1,6,23,2,6,8
2015,3,2,0,0,0,9,9
2015,3,2,0,3,0,1,1
2015,3,2,0,5,0,14,14
2015,3,2,0,6,0,38,38
2015,3,2,0,7,2,145,147
2015,3,2,0,8,6,309,315
2015,3,2,0,9,10,295,305
2015,3,2,0,10,10,233,243
2015,3,2,0,11,16,139,155
2015,3,2,0,12,13,151,164
2015,3,2,0,13,12,171,183
2015,3,2,0,14,15,149,164
2015,3,2,0,15,27,175,202
2015,3,2,0,16,15,280,295
2015,3,2,0,17,24,542,566
2015,3,2,0,18,12,492,504
2015,3,2,0,19,7,352,359
2015,3,2,0,20,4,207,211
2015,3,2,0,21,2,126,128
2015,3,2,0,22,4,80,84
2015,3,2,0,23,0,31,31
2015,3,3,1,0,0,18,18
2015,3,3,1,1,0,1,1
2015,3,3,1,2,0,2,2
2015,3,3,1,3,0,3,3
2015,3,3,1,4,0,5,5
2015,3,3,1,5,0,38,38
2015,3,3,1,6,1,122,123
2015,3,3,1,7,3,365,368
2015,3,3,1,8,7,757,764
2015,3,3,1,9,7,370,377
2015,3,3,1,10,16,154,170
2015,3,3,1,11,18,133,151
2015,3,3,1,12,16,134,150
2015,3,3,1,13,17,90,107
2015,3,3,1,14,15,77,92
2015,3,3,1,15,10,132,142
2015,3,3,1,16,17,148,165
2015,3,3,1,17,9,284,293
2015,3,3,1,18,6,254,260
2015,3,3,1,19,4,211,215
2015,3,3,1,20,4,162,166
2015,3,3,1,21,0,117,117
2015,3,3,1,22,4,104,108
2015,3,3,1,23,4,45,49
2015,3,4,2,0,0,17,17
2015,3,4,2,1,0,10,10
2015,3,4,2,2,0,1,1
2015,3,4,2,3,0,2,2
2015,3,4,2,4,0,3,3
2015,3,4,2,5,0,35,35
2015,3,4,2,6,1,114,115
2015,3,4,2,7,2,376,378
2015,3,4,2,8,11,709,720
2015,3,4,2,9,7,293,300
2015,3,4,2,10,4,140,144
2015,3,4,2,11,8,141,149
2015,3,4,2,12,22,209,231
2015,3,4,2,13,12,186,198
2015,3,4,2,14,2,146,148
2015,3,4,2,15,8,169,177
2015,3,4,2,16,6,230,236
2015,3,4,2,17,10,395,405
2015,3,4,2,18,7,360,367
2015,3,4,2,19,8,265,273
2015,3,4,2,20,3,103,106
2015,3,4,2,21,7,82,89
2015,3,4,2,22,1,48,49
2015,3,4,2,23,1,33,34
2015,3,5,3,0,0,9,9
2015,3,5,3,1,0,6,6
2015,3,5,3,2,0,4,4
2015,3,5,3,3,0,4,4
2015,3,5,3,4,0,4,4
2015,3,5,3,5,0,12,12
2015,3,5,3,6,0,20,20
2015,3,5,3,7,1,37,38
2015,3,5,3,8,0,66,66
2015,3,5,3,9,8,51,59
2015,3,5,3,10,2,29,31
2015,3,5,3,11,4,29,33
2015,3,5,3,12,8,25,33
2015,3,5,3,13,1,32,33
2015,3,5,3,14,1,11,12
2015,3,5,3,15,1,18,19
2015,3,5,3,16,2,20,22
2015,3,5,3,17,3,31,34
2015,3,5,3,18,3,23,26
2015,3,5,3,19,0,21,21
2015,3,5,3,20,1,17,18
2015,3,5,3,21,0,19,19
2015,3,5,3,22,0,19,19
2015,3,5,3,23,0,18,18
2015,3,6,4,0,0,7,7
2015,3,6,4,1,0,6,6
2015,3,6,4,2,0,3,3
2015,3,6,4,5,0,9,9
2015,3,6,4,6,0,12,12
2015,3,6,4,7,2,30,32
2015,3,6,4,8,2,107,109
2015,3,6,4,9,6,108,114
2015,3,6,4,10,7,99,106
2015,3,6,4,11,1,75,76
2015,3,6,4,12,1,67,68
2015,3,6,4,13,2,95,97
2015,3,6,4,14,9,78,87
2015,3,6,4,15,7,105,112
2015,3,6,4,16,10,163,173
2015,3,6,4,17,12,258,270
2015,3,6,4,18,3,238,241
2015,3,6,4,19,4,165,169
2015,3,6,4,20,2,96,98
2015,3,6,4,21,2,92,94
2015,3,6,4,22,0,47,47
2015,3,6,4,23,5,52,57
2015,3,7,5,0,1,22,23
2015,3,7,5,1,1,26,27
2015,3,7,5,2,0,16,16
2015,3,7,5,3,0,11,11
2015,3,7,5,4,0,2,2
2015,3,7,5,5,0,6,6
2015,3,7,5,6,0,8,8
2015,3,7,5,7,1,35,36
2015,3,7,5,8,1,74,75
2015,3,7,5,9,7,117,124
2015,3,7,5,10,7,167,174
2015,3,7,5,11,25,209,234
2015,3,7,5,12,25,246,271
2015,3,7,5,13,51,250,301
2015,3,7,5,14,45,265,310
2015,3,7,5,15,45,249,294
2015,3,7,5,16,46,225,271
2015,3,7,5,17,55,266,321
2015,3,7,5,18,24,194,218
2015,3,7,5,19,13,161,174
2015,3,7,5,20,6,109,115
2015,3,7,5,21,9,95,104
2015,3,7,5,22,12,68,80
2015,3,7,5,23,6,70,76
2015,3,8,6,0,11,76,87
2015,3,8,6,1,2,43,45
2015,3,8,6,3,7,59,66
2015,3,8,6,4,4,20,24
2015,3,8,6,5,1,6,7
2015,3,8,6,6,1,4,5
2015,3,8,6,7,3,17,20
2015,3,8,6,8,8,60,68
2015,3,8,6,9,18,102,120
2015,3,8,6,10,51,198,249
2015,3,8,6,11,66,241,307
2015,3,8,6,12,110,319,429
2015,3,8,6,13,150,363,513
2015,3,8,6,14,190,379,569
2015,3,8,6,15,170,468,638
2015,3,8,6,16,161,464,625
2015,3,8,6,17,153,403,556
2015,3,8,6,18,95,361,456
2015,3,8,6,19,50,243,293
2015,3,8,6,20,26,135,161
2015,3,8,6,21,29,96,125
2015,3,8,6,22,36,75,111
2015,3,8,6,23,12,43,55
2015,3,9,0,0,3,27,30
2015,3,9,0,1,1,9,10
2015,3,9,0,2,0,3,3
2015,3,9,0,3,0,1,1
2015,3,9,0,4,0,3,3
2015,3,9,0,5,0,49,49
2015,3,9,0,6,1,149,150
2015,3,9,0,7,6,431,437
2015,3,9,0,8,25,849,874
2015,3,9,0,9,30,424,454
2015,3,9,0,10,65,151,216
2015,3,9,0,11,80,167,247
2015,3,9,0,12,112,218,330
2015,3,9,0,13,132,255,387
2015,3,9,0,14,120,212,332
2015,3,9,0,15,146,251,397
2015,3,9,0,16,159,487,646
2015,3,9,0,17,170,913,1083
2015,3,9,0,18,128,912,1040
2015,3,9,0,19,72,528,600
2015,3,9,0,20,74,316,390
2015,3,9,0,21,41,238,279
2015,3,9,0,22,31,113,144
2015,3,9,0,23,13,60,73
2015,3,10,1,0,5,18,23
2015,3,10,1,1,3,8,11
2015,3,10,1,4,0,4,4
2015,3,10,1,5,0,50,50
2015,3,10,1,6,5,156,161
2015,3,10,1,7,23,508,531
2015,3,10,1,8,41,959,1000
2015,3,10,1,9,28,456,484
2015,3,10,1,10,59,150,209
2015,3,10,1,11,48,88,136
2015,3,10,1,12,46,96,142
2015,3,10,1,13,9,78,87
2015,3,10,1,14,8,62,70
2015,3,10,1,15,21,63,84
2015,3,10,1,16,16,125,141
2015,3,10,1,17,23,267,290
2015,3,10,1,18,14,188,202
2015,3,10,1,19,2,132,134
2015,3,10,1,20,2,94,96
2015,3,10,1,21,11,67,78
2015,3,10,1,22,8,26,34
2015,3,10,1,23,9,39,48
2015,3,11,2,0,1,12,13
2015,3,11,2,1,1,5,6
2015,3,11,2,2,0,2,2
2015,3,11,2,4,1,0,1
2015,3,11,2,5,2,48,50
2015,3,11,2,6,1,157,158
2015,3,11,2,7,25,454,479
2015,3,11,2,8,35,811,846
2015,3,11,2,9,31,318,349
2015,3,11,2,10,26,158,184
2015,3,11,2,11,32,164,196
2015,3,11,2,12,49,245,294
2015,3,11,2,13,68,247,315
2015,3,11,2,14,99,192,291
2015,3,11,2,15,89,276,365
2015,3,11,2,16,78,432,510
2015,3,11,2,17,149,891,1040
2015,3,11,2,18,116,962,1078
2015,3,11,2,19,90,573,663
2015,3,11,2,20,63,348,411
2015,3,11,2,21,59,266,325
2015,3,11,2,22,46,183,229
2015,3,11,2,23,14,90,104
2015,3,12,3,0,3,20,23
2015,3,12,3,1,3,15,18
2015,3,12,3,2,2,5,7
2015,3,12,3,5,0,43,43
2015,3,12,3,6,2,170,172
2015,3,12,3,7,19,570,589
2015,3,12,3,8,54,1023,1077
2015,3,12,3,9,55,412,467
2015,3,12,3,10,84,181,265
2015,3,12,3,11,103,183,286
2015,3,12,3,12,124,275,399
2015,3,12,3,13,138,267,405
2015,3,12,3,14,167,255,422
2015,3,12,3,15,219,276,495
2015,3,12,3,16,170,465,635
2015,3,12,3,17,220,969,1189
2015,3,12,3,18,142,933,1075
2015,3,12,3,19,101,546,647
2015,3,12,3,20,70,319,389
2015,3,12,3,21,66,276,342
2015,3,12,3,22,52,140,192
2015,3,12,3,23,17,61,78
2015,3,13,4,0,9,33,42
2015,3,13,4,1,3,15,18
2015,3,13,4,2,5,12,17
2015,3,13,4,3,0,1,1
2015,3,13,4,4,1,6,7
2015,3,13,4,5,1,38,39
2015,3,13,4,6,1,151,152
2015,3,13,4,7,16,425,441
2015,3,13,4,8,48,868,916
2015,3,13,4,9,74,408,482
2015,3,13,4,10,64,223,287
2015,3,13,4,11,106,257,363
2015,3,13,4,12,138,314,452
2015,3,13,4,13,202,317,519
2015,3,13,4,14,159,249,408
2015,3,13,4,15,123,302,425
2015,3,13,4,16,117,466,583
2015,3,13,4,17,146,885,1031
2015,3,13,4,18,89,682,771
2015,3,13,4,19,36,410,446
2015,3,13,4,20,45,244,289
2015,3,13,4,21,19,156,175
2015,3,13,4,22,6,136,142
2015,3,13,4,23,7,71,78
2015,3,14,5,0,6,37,43
2015,3,14,5,1,0,41,41
2015,3,14,5,2,1,11,12
2015,3,14,5,3,0,7,7
2015,3,14,5,4,0,1,1
2015,3,14,5,5,1,4,5
2015,3,14,5,6,3,65,68
2015,3,14,5,7,15,52,67
2015,3,14,5,8,26,70,96
2015,3,14,5,9,31,86,117
2015,3,14,5,10,19,114,133
2015,3,14,5,11,10,140,150
2015,3,14,5,12,41,173,214
2015,3,14,5,13,85,291,376
2015,3,14,5,14,105,313,418
2015,3,14,5,15,111,237,348
2015,3,14,5,16,44,103,147
2015,3,14,5,17,88,196,284
2015,3,14,5,18,62,226,288
2015,3,14,5,19,47,189,236
2015,3,14,5,20,51,152,203
2015,3,14,5,21,22,134,156
2015,3,14,5,22,27,113,140
2015,3,14,5,23,24,95,119
2015,3,15,6,0,29,106,135
2015,3,15,6,1,7,69,76
2015,3,15,6,2,3,51,54
2015,3,15,6,3,9,20,29
2015,3,15,6,4,0,5,5
2015,3,15,6,5,0,2,2
2015,3,15,6,6,2,9,11
2015,3,15,6,7,10,32,42
2015,3,15,6,8,33,103,136
2015,3,15,6,9,52,157,209
2015,3,15,6,10,124,287,411
2015,3,15,6,11,175,356,531
2015,3,15,6,12,176,428,604
2015,3,15,6,13,242,420,662
2015,3,15,6,14,265,427,692
2015,3,15,6,15,283,427,710
2015,3,15,6,16,227,414,641
2015,3,15,6,17,178,401,579
2015,3,15,6,18,115,315,430
2015,3,15,6,19,62,196,258
2015,3,15,6,20,15,143,158
2015,3,15,6,21,25,125,150
2015,3,15,6,22,14,86,100
2015,3,15,6,23,10,33,43
2015,3,16,0,0,5,24,29
2015,3,16,0,1,1,3,4
2015,3,16,0,2,2,7,9
2015,3,16,0,3,0,4,4
2015,3,16,0,4,0,3,3
2015,3,16,0,5,0,42,42
2015,3,16,0,6,4,154,158
2015,3,16,0,7,15,522,537
2015,3,16,0,8,24,923,947
2015,3,16,0,9,37,394,431
2015,3,16,0,10,50,152,202
2015,3,16,0,11,88,176,264
2015,3,16,0,12,132,256,388
2015,3,16,0,13,148,256,404
2015,3,16,0,14,196,191,387
2015,3,16,0,15,211,292,503
2015,3,16,0,16,166,511,677
2015,3,16,0,17,181,1036,1217
2015,3,16,0,18,161,997,1158
2015,3,16,0,19,98,554,652
2015,3,16,0,20,70,359,429
2015,3,16,0,21,46,276,322
2015,3,16,0,22,22,139,161
2015,3,16,0,23,28,66,94
2015,3,17,1,0,19,33,52
2015,3,17,1,1,8,10,18
2015,3,17,1,2,2,5,7
2015,3,17,1,3,1,3,4
2015,3,17,1,4,0,5,5
2015,3,17,1,5,0,59,59
2015,3,17,1,6,4,203,207
2015,3,17,1,7,13,612,625
2015,3,17,1,8,37,1033,1070
2015,3,17,1,9,55,434,489
2015,3,17,1,10,100,187,287
2015,3,17,1,11,102,213,315
2015,3,17,1,12,119,321,440
2015,3,17,1,13,138,264,402
2015,3,17,1,14,125,250,375
2015,3,17,1,15,164,289,453
2015,3,17,1,16,205,565,770
2015,3,17,1,17,182,1047,1229
2015,3,17,1,18,124,923,1047
2015,3,17,1,19,55,506,561
2015,3,17,1,20,23,339,362
2015,3,17,1,21,22,189,211
2015,3,17,1,22,9,170,179
2015,3,17,1,23,7,72,79
2015,3,18,2,0,4,24,28
2015,3,18,2,1,0,13,13
2015,3,18,2,2,0,5,5
2015,3,18,2,3,0,2,2
2015,3,18,2,4,0,2,2
2015,3,18,2,5,1,52,53
2015,3,18,2,6,3,174,177
2015,3,18,2,7,13,529,542
2015,3,18,2,8,24,874,898
2015,3,18,2,9,22,397,419
2015,3,18,2,10,39,171,210
2015,3,18,2,11,38,183,221
2015,3,18,2,12,48,252,300
2015,3,18,2,13,49,254,303
2015,3,18,2,14,79,210,289
2015,3,18,2,15,80,243,323
2015,3,18,2,16,97,414,511
2015,3,18,2,17,118,871,989
2015,3,18,2,18,52,774,826
2015,3,18,2,19,66,536,602
2015,3,18,2,20,34,321,355
2015,3,18,2,21,9,228,237
2015,3,18,2,22,20,130,150
2015,3,18,2,23,8,64,72
2015,3,19,3,0,6,29,35
2015,3,19,3,1,2,10,12
2015,3,19,3,2,4,8,12
2015,3,19,3,3,2,1,3
2015,3,19,3,4,0,6,6
2015,3,19,3,5,0,52,52
2015,3,19,3,6,4,172,176
2015,3,19,3,7,17,528,545
2015,3,19,3,8,26,907,933
2015,3,19,3,9,49,419,468
2015,3,19,3,10,50,177,227
2015,3,19,3,11,60,235,295
2015,3,19,3,12,106,276,382
2015,3,19,3,13,84,294,378
2015,3,19,3,14,114,203,317
2015,3,19,3,15,146,259,405
2015,3,19,3,16,124,431,555
2015,3,19,3,17,150,887,1037
2015,3,19,3,18,97,797,894
2015,3,19,3,19,54,486,540
2015,3,19,3,20,34,335,369
2015,3,19,3,21,27,241,268
2015,3,19,3,22,24,174,198
2015,3,19,3,23,11,84,95
2015,3,20,4,0,6,27,33
2015,3,20,4,1,12,22,34
2015,3,20,4,2,0,7,7
2015,3,20,4,3,2,0,2
2015,3,20,4,4,0,3,3
2015,3,20,4,5,1,16,17
2015,3,20,4,6,1,41,42
2015,3,20,4,7,3,88,91
2015,3,20,4,8,4,235,239
2015,3,20,4,9,5,126,131
2015,3,20,4,10,4,57,61
2015,3,20,4,11,8,55,63
2015,3,20,4,12,8,65,73
2015,3,20,4,13,7,71,78
2015,3,20,4,14,2,86,88
2015,3,20,4,15,11,95,106
2015,3,20,4,16,13,179,192
2015,3,20,4,17,14,442,456
2015,3,20,4,18,14,410,424
2015,3,20,4,19,13,270,283
2015,3,20,4,20,7,192,199
2015,3,20,4,21,10,131,141
2015,3,20,4,22,5,103,108
2015,3,20,4,23,1,84,85
2015,3,21,5,0,2,68,70
2015,3,21,5,1,5,41,46
2015,3,21,5,2,1,25,26
2015,3,21,5,3,0,15,15
2015,3,21,5,4,0,3,3
2015,3,21,5,5,0,8,8
2015,3,21,5,6,1,16,17
2015,3,21,5,7,13,42,55
2015,3,21,5,8,30,161,191
2015,3,21,5,9,48,250,298
2015,3,21,5,10,69,329,398
2015,3,21,5,11,141,369,510
2015,3,21,5,12,224,456,680
2015,3,21,5,13,342,468,810
2015,3,21,5,14,408,540,948
2015,3,21,5,15,419,567,986
2015,3,21,5,16,503,515,1018
2015,3,21,5,17,430,522,952
2015,3,21,5,18,283,508,791
2015,3,21,5,19,137,358,495
2015,3,21,5,20,135,211,346
2015,3,21,5,21,113,197,310
2015,3,21,5,22,69,175,244
2015,3,21,5,23,68,151,219
2015,3,22,6,0,29,112,141
2015,3,22,6,1,13,73,86
2015,3,22,6,2,12,72,84
2015,3,22,6,3,2,28,30
2015,3,22,6,4,1,4,5
2015,3,22,6,5,1,3,4
2015,3,22,6,6,1,11,12
2015,3,22,6,7,6,39,45
2015,3,22,6,8,29,81,110
2015,3,22,6,9,74,201,275
2015,3,22,6,10,137,302,439
2015,3,22,6,11,202,441,643
2015,3,22,6,12,233,479,712
2015,3,22,6,13,298,536,834
2015,3,22,6,14,361,445,806
2015,3,22,6,15,362,553,915
2015,3,22,6,16,265,464,729
2015,3,22,6,17,275,478,753
2015,3,22,6,18,198,394,592
2015,3,22,6,19,104,261,365
2015,3,22,6,20,74,184,258
2015,3,22,6,21,51,146,197
2015,3,22,6,22,40,105,145
2015,3,22,6,23,11,42,53
2015,3,23,0,0,16,13,29
2015,3,23,0,1,8,8,16
2015,3,23,0,2,0,2,2
2015,3,23,0,3,0,1,1
2015,3,23,0,4,1,9,10
2015,3,23,0,5,0,50,50
2015,3,23,0,6,2,168,170
2015,3,23,0,7,19,466,485
2015,3,23,0,8,25,866,891
2015,3,23,0,9,66,374,440
2015,3,23,0,10,72,164,236
2015,3,23,0,11,102,140,242
2015,3,23,0,12,107,217,324
2015,3,23,0,13,121,240,361
2015,3,23,0,14,137,237,374
2015,3,23,0,15,111,246,357
2015,3,23,0,16,151,477,628
2015,3,23,0,17,179,933,1112
2015,3,23,0,18,157,869,1026
2015,3,23,0,19,85,519,604
2015,3,23,0,20,34,318,352
2015,3,23,0,21,32,196,228
2015,3,23,0,22,32,116,148
2015,3,23,0,23,6,42,48
2015,3,24,1,0,8,20,28
2015,3,24,1,1,0,4,4
2015,3,24,1,2,1,7,8
2015,3,24,1,3,0,3,3
2015,3,24,1,4,0,6,6
2015,3,24,1,5,1,60,61
2015,3,24,1,6,3,187,190
2015,3,24,1,7,7,533,540
2015,3,24,1,8,26,908,934
2015,3,24,1,9,42,439,481
2015,3,24,1,10,58,189,247
2015,3,24,1,11,80,183,263
2015,3,24,1,12,75,242,317
2015,3,24,1,13,79,244,323
2015,3,24,1,14,91,176,267
2015,3,24,1,15,83,275,358
2015,3,24,1,16,89,455,544
2015,3,24,1,17,118,860,978
2015,3,24,1,18,112,823,935
2015,3,24,1,19,56,513,569
2015,3,24,1,20,35,344,379
2015,3,24,1,21,9,208,217
2015,3,24,1,22,15,135,150
2015,3,24,1,23,3,70,73
2015,3,25,2,0,2,20,22
2015,3,25,2,1,0,6,6
2015,3,25,2,2,0,5,5
2015,3,25,2,3,0,4,4
2015,3,25,2,4,3,1,4
2015,3,25,2,5,0,40,40
2015,3,25,2,6,3,184,187
2015,3,25,2,7,11,518,529
2015,3,25,2,8,16,861,877
2015,3,25,2,9,20,431,451
2015,3,25,2,10,14,119,133
2015,3,25,2,11,39,156,195
2015,3,25,2,12,38,213,251
2015,3,25,2,13,67,220,287
2015,3,25,2,14,65,222,287
2015,3,25,2,15,71,238,309
2015,3,25,2,16,93,424,517
2015,3,25,2,17,66,951,1017
2015,3,25,2,18,56,839,895
2015,3,25,2,19,44,510,554
2015,3,25,2,20,26,359,385
2015,3,25,2,21,24,284,308
2015,3,25,2,22,15,173,188
2015,3,25,2,23,16,86,102
2015,3,26,3,0,2,26,28
2015,3,26,3,1,0,8,8
2015,3,26,3,2,4,2,6
2015,3,26,3,3,0,3,3
2015,3,26,3,4,1,3,4
2015,3,26,3,5,1,57,58
2015,3,26,3,6,1,189,190
2015,3,26,3,7,10,569,579
2015,3,26,3,8,35,1090,1125
2015,3,26,3,9,52,336,388
2015,3,26,3,10,25,141,166
2015,3,26,3,11,25,110,135
2015,3,26,3,12,52,226,278
2015,3,26,3,13,85,277,362
2015,3,26,3,14,119,232,351
2015,3,26,3,15,160,310,470
2015,3,26,3,16,171,552,723
2015,3,26,3,17,210,1088,1298
2015,3,26,3,18,158,1083,1241
2015,3,26,3,19,82,627,709
2015,3,26,3,20,20,173,193
2015,3,26,3,21,18,262,280
2015,3,26,3,22,9,79,88
2015,3,26,3,23,8,87,95
2015,3,27,4,0,4,27,31
2015,3,27,4,1,3,8,11
2015,3,27,4,2,0,10,10
2015,3,27,4,3,0,3,3
2015,3,27,4,4,0,1,1
2015,3,27,4,5,2,16,18
2015,3,27,4,6,1,56,57
2015,3,27,4,7,3,185,188
2015,3,27,4,8,8,264,272
2015,3,27,4,9,11,310,321
2015,3,27,4,10,24,173,197
2015,3,27,4,11,35,166,201
2015,3,27,4,12,64,231,295
2015,3,27,4,13,58,240,298
2015,3,27,4,14,86,216,302
2015,3,27,4,15,100,290,390
2015,3,27,4,16,85,419,504
2015,3,27,4,17,140,813,953
2015,3,27,4,18,111,671,782
2015,3,27,4,19,65,451,516
2015,3,27,4,20,38,293,331
2015,3,27,4,21,18,177,195
2015,3,27,4,22,18,132,150
2015,3,27,4,23,13,102,115
2015,3,28,5,0,11,90,101
2015,3,28,5,1,4,59,63
2015,3,28,5,2,0,39,39
2015,3,28,5,3,2,7,9
2015,3,28,5,4,0,2,2
2015,3,28,5,5,0,4,4
2015,3,28,5,6,3,13,16
2015,3,28,5,7,8,52,60
2015,3,28,5,8,14,152,166
2015,3,28,5,9,40,232,272
2015,3,28,5,10,84,258,342
2015,3,28,5,11,121,309,430
2015,3,28,5,12,103,350,453
2015,3,28,5,13,118,355,473
2015,3,28,5,14,74,281,355
2015,3,28,5,15,83,305,388
2015,3,28,5,16,67,248,315
2015,3,28,5,17,52,251,303
2015,3,28,5,18,40,232,272
2015,3,28,5,19,23,185,208
2015,3,28,5,20,10,120,130
2015,3,28,5,21,14,88,102
2015,3,28,5,22,10,68,78
2015,3,28,5,23,6,89,95
2015,3,29,6,0,1,48,49
2015,3,29,6,1,4,46,50
2015,3,29,6,2,2,30,32
2015,3,29,6,3,1,9,10
2015,3,29,6,4,0,2,2
2015,3,29,6,5,1,1,2
2015,3,29,6,6,3,11,14
2015,3,29,6,7,2,37,39
2015,3,29,6,8,8,60,68
2015,3,29,6,9,22,146,168
2015,3,29,6,10,72,268,340
2015,3,29,6,11,138,311,449
2015,3,29,6,12,141,339,480
2015,3,29,6,13,137,358,495
2015,3,29,6,14,178,378,556
2015,3,29,6,15,243,382,625
2015,3,29,6,16,235,411,646
2015,3,29,6,17,232,412,644
2015,3,29,6,18,169,301,470
2015,3,29,6,19,76,253,329
2015,3,29,6,20,25,135,160
2015,3,29,6,21,13,95,108
2015,3,29,6,22,3,73,76
2015,3,29,6,23,6,43,49
2015,3,30,0,0,3,23,26
2015,3,30,0,1,0,7,7
2015,3,30,0,2,0,4,4
2015,3,30,0,3,0,2,2
2015,3,30,0,4,0,3,3
2015,3,30,0,5,1,38,39
2015,3,30,0,6,2,178,180
2015,3,30,0,7,9,474,483
2015,3,30,0,8,30,967,997
2015,3,30,0,9,54,391,445
2015,3,30,0,10,67,231,298
2015,3,30,0,11,98,182,280
2015,3,30,0,12,101,257,358
2015,3,30,0,13,160,251,411
2015,3,30,0,14,187,240,427
2015,3,30,0,15,188,292,480
2015,3,30,0,16,218,486,704
2015,3,30,0,17,175,1101,1276
2015,3,30,0,18,147,967,1114
2015,3,30,0,19,74,636,710
2015,3,30,0,20,54,370,424
2015,3,30,0,21,33,260,293
2015,3,30,0,22,25,143,168
2015,3,30,0,23,2,65,67
2015,3,31,1,0,4,20,24
2015,3,31,1,1,1,11,12
2015,3,31,1,2,1,6,7
2015,3,31,1,3,1,2,3
2015,3,31,1,4,0,4,4
2015,3,31,1,5,0,56,56
2015,3,31,1,6,2,205,207
2015,3,31,1,7,11,657,668
2015,3,31,1,8,41,1101,1142
2015,3,31,1,9,54,475,529
2015,3,31,1,10,141,241,382
2015,3,31,1,11,141,214,355
2015,3,31,1,12,119,313,432
2015,3,31,1,13,151,288,439
2015,3,31,1,14,183,307,490
2015,3,31,1,15,154,318,472
2015,3,31,1,16,81,349,430
2015,3,31,1,17,58,559,617
2015,3,31,1,18,51,662,713
2015,3,31,1,19,40,433,473
2015,3,31,1,20,27,274,301
2015,3,31,1,21,29,228,257
2015,3,31,1,22,13,113,126
2015,3,31,1,23,1,58,59
2015,7,1,2,0,16,44,60
2015,7,1,2,1,2,1,3
2015,7,1,2,2,3,5,8
2015,7,1,2,3,1,2,3
2015,7,1,2,4,1,8,9
2015,7,1,2,5,2,70,72
2015,7,1,2,6,11,287,298
2015,7,1,2,7,41,784,825
2015,7,1,2,8,54,1103,1157
2015,7,1,2,9,92,490,582
2015,7,1,2,10,109,201,310
2015,7,1,2,11,186,255,441
2015,7,1,2,12,168,342,510
2015,7,1,2,13,185,330,515
2015,7,1,2,14,229,254,483
2015,7,1,2,15,241,311,552
2015,7,1,2,16,214,580,794
2015,7,1,2,17,215,1126,1341
2015,7,1,2,18,87,836,923
2015,7,1,2,19,147,677,824
2015,7,1,2,20,157,476,633
2015,7,1,2,21,67,364,431
2015,7,1,2,22,44,234,278
2015,7,1,2,23,36,135,171
2015,7,2,3,0,22,56,78
2015,7,2,3,1,9,17,26
2015,7,2,3,2,1,6,7
2015,7,2,3,3,0,5,5
2015,7,2,3,4,0,6,6
2015,7,2,3,5,3,74,77
2015,7,2,3,6,5,108,113
2015,7,2,3,7,25,382,407
2015,7,2,3,8,43,916,959
2015,7,2,3,9,71,477,548
2015,7,2,3,10,77,229,306
2015,7,2,3,11,128,275,403
2015,7,2,3,12,138,384,522
2015,7,2,3,13,214,410,624
2015,7,2,3,14,206,484,690
2015,7,2,3,15,224,640,864
2015,7,2,3,16,198,750,948
2015,7,2,3,17,222,862,1084
2015,7,2,3,18,199,845,1044
2015,7,2,3,19,199,540,739
2015,7,2,3,20,168,452,620
2015,7,2,3,21,135,337,472
2015,7,2,3,22,107,282,389
2015,7,2,3,23,94,232,326
2015,7,3,4,0,49,123,172
2015,7,3,4,1,25,92,117
2015,7,3,4,2,26,72,98
2015,7,3,4,3,8,20,28
2015,7,3,4,4,2,9,11
2015,7,3,4,5,9,30,39
2015,7,3,4,6,10,55,65
2015,7,3,4,7,20,108,128
2015,7,3,4,8,64,209,273
2015,7,3,4,9,164,316,480
2015,7,3,4,10,349,417,766
2015,7,3,4,11,437,510,947
2015,7,3,4,12,580,511,1091
2015,7,3,4,13,654,536,1190
2015,7,3,4,14,767,494,1261
2015,7,3,4,15,665,512,1177
2015,7,3,4,16,687,535,1222
2015,7,3,4,17,603,478,1081
2015,7,3,4,18,427,402,829
2015,7,3,4,19,290,212,502
2015,7,3,4,20,229,229,458
2015,7,3,4,21,147,213,360
2015,7,3,4,22,138,124,262
2015,7,3,4,23,79,155,234
2015,7,4,5,0,94,94,188
2015,7,4,5,1,33,93,126
2015,7,4,5,2,22,64,86
2015,7,4,5,3,19,34,53
2015,7,4,5,4,22,4,26
2015,7,4,5,5,7,15,22
2015,7,4,5,6,17,28,45
2015,7,4,5,7,25,61,86
2015,7,4,5,8,77,157,234
2015,7,4,5,9,41,71,112
2015,7,4,5,10,86,144,230
2015,7,4,5,11,308,286,594
2015,7,4,5,12,413,349,762
2015,7,4,5,13,597,363,960
2015,7,4,5,14,690,425,1115
2015,7,4,5,15,779,423,1202
2015,7,4,5,16,186,126,312
2015,7,4,5,17,284,187,471
2015,7,4,5,18,446,246,692
2015,7,4,5,19,435,280,715
2015,7,4,5,20,376,291,667
2015,7,4,5,21,366,343,709
2015,7,4,5,22,304,257,561
2015,7,4,5,23,128,192,320
2015,7,5,6,0,145,173,318
2015,7,5,6,1,50,84,134
2015,7,5,6,2,46,60,106
2015,7,5,6,3,27,32,59
2015,7,5,6,4,26,14,40
2015,7,5,6,5,16,14,30
2015,7,5,6,6,13,23,36
2015,7,5,6,7,24,52,76
2015,7,5,6,8,110,127,237
2015,7,5,6,9,198,225,423
2015,7,5,6,10,364,352,716
2015,7,5,6,11,525,454,979
2015,7,5,6,12,587,454,1041
2015,7,5,6,13,580,502,1082
2015,7,5,6,14,586,390,976
2015,7,5,6,15,491,450,941
2015,7,5,6,16,558,502,1060
2015,7,5,6,17,494,454,948
2015,7,5,6,18,366,502,868
2015,7,5,6,19,272,336,608
2015,7,5,6,20,229,244,473
2015,7,5,6,21,202,303,505
2015,7,5,6,22,178,147,325
2015,7,5,6,23,124,94,218
2015,7,6,0,0,48,30,78
2015,7,6,0,1,23,20,43
2015,7,6,0,2,6,5,11
2015,7,6,0,3,10,4,14
2015,7,6,0,4,6,7,13
2015,7,6,0,5,2,69,71
2015,7,6,0,6,10,216,226
2015,7,6,0,7,31,639,670
2015,7,6,0,8,51,926,977
2015,7,6,0,9,100,426,526
2015,7,6,0,10,171,177,348
2015,7,6,0,11,189,253,442
2015,7,6,0,12,177,298,475
2015,7,6,0,13,235,327,562
2015,7,6,0,14,248,267,515
2015,7,6,0,15,190,363,553
2015,7,6,0,16,216,548,764
2015,7,6,0,17,215,1046,1261
2015,7,6,0,18,157,1003,1160
2015,7,6,0,19,129,646,775
2015,7,6,0,20,139,445,584
2015,7,6,0,21,152,295,447
2015,7,6,0,22,65,187,252
2015,7,6,0,23,44,91,135
2015,7,7,1,0,23,37,60
2015,7,7,1,1,10,19,29
2015,7,7,1,2,1,8,9
2015,7,7,1,3,1,4,5
2015,7,7,1,4,0,10,10
2015,7,7,1,5,5,92,97
2015,7,7,1,6,10,333,343
2015,7,7,1,7,33,864,897
2015,7,7,1,8,62,1138,1200
2015,7,7,1,9,99,462,561
2015,7,7,1,10,143,226,369
2015,7,7,1,11,129,240,369
2015,7,7,1,12,179,337,516
2015,7,7,1,13,118,306,424
2015,7,7,1,14,175,233,408
2015,7,7,1,15,211,340,551
2015,7,7,1,16,168,578,746
2015,7,7,1,17,244,1288,1532
2015,7,7,1,18,208,1120,1328
2015,7,7,1,19,164,758,922
2015,7,7,1,20,162,585,747
2015,7,7,1,21,118,455,573
2015,7,7,1,22,94,273,367
2015,7,7,1,23,36,124,160
2015,7,8,2,0,7,50,57
2015,7,8,2,1,5,23,28
2015,7,8,2,2,2,13,15
2015,7,8,2,3,0,4,4
2015,7,8,2,4,0,16,16
2015,7,8,2,5,1,102,103
2015,7,8,2,6,11,331,342
2015,7,8,2,7,30,862,892
2015,7,8,2,8,51,1164,1215
2015,7,8,2,9,101,483,584
2015,7,8,2,10,146,227,373
2015,7,8,2,11,149,249,398
2015,7,8,2,12,134,303,437
2015,7,8,2,13,153,333,486
2015,7,8,2,14,165,242,407
2015,7,8,2,15,140,232,372
2015,7,8,2,16,122,433,555
2015,7,8,2,17,93,655,748
2015,7,8,2,18,68,468,536
2015,7,8,2,19,98,617,715
2015,7,8,2,20,78,444,522
2015,7,8,2,21,57,272,329
2015,7,8,2,22,50,175,225
2015,7,8,2,23,22,114,136
2015,7,9,3,0,6,48,54
2015,7,9,3,1,23,18,41
2015,7,9,3,2,4,5,9
2015,7,9,3,3,0,5,5
2015,7,9,3,4,0,6,6
2015,7,9,3,5,6,88,94
2015,7,9,3,6,13,312,325
2015,7,9,3,7,25,885,910
2015,7,9,3,8,47,1109,1156
2015,7,9,3,9,96,460,556
2015,7,9,3,10,110,211,321
2015,7,9,3,11,163,222,385
2015,7,9,3,12,155,296,451
2015,7,9,3,13,152,319,471
2015,7,9,3,14,156,262,418
2015,7,9,3,15,166,290,456
2015,7,9,3,16,131,589,720
2015,7,9,3,17,146,1186,1332
2015,7,9,3,18,126,916,1042
2015,7,9,3,19,117,607,724
2015,7,9,3,20,103,548,651
2015,7,9,3,21,78,390,468
2015,7,9,3,22,60,240,300
2015,7,9,3,23,33,117,150
2015,7,10,4,0,29,72,101
2015,7,10,4,1,17,30,47
2015,7,10,4,2,6,22,28
2015,7,10,4,3,1,10,11
2015,7,10,4,4,0,7,7
2015,7,10,4,5,6,91,97
2015,7,10,4,6,23,292,315
2015,7,10,4,7,50,720,770
2015,7,10,4,8,71,1103,1174
2015,7,10,4,9,112,493,605
2015,7,10,4,10,131,249,380
2015,7,10,4,11,177,270,447
2015,7,10,4,12,194,407,601
2015,7,10,4,13,210,415,625
2015,7,10,4,14,231,334,565
2015,7,10,4,15,272,426,698
2015,7,10,4,16,233,673,906
2015,7,10,4,17,243,1138,1381
2015,7,10,4,18,218,1062,1280
2015,7,10,4,19,255,726,981
2015,7,10,4,20,210,479,689
2015,7,10,4,21,159,400,559
2015,7,10,4,22,129,303,432
2015,7,10,4,23,95,219,314
2015,7,11,5,0,56,173,229
2015,7,11,5,1,34,111,145
2015,7,11,5,2,12,65,77
2015,7,11,5,3,2,20,22
2015,7,11,5,4,2,5,7
2015,7,11,5,5,1,8,9
2015,7,11,5,6,4,45,49
2015,7,11,5,7,3,60,63
2015,7,11,5,8,28,174,202
2015,7,11,5,9,101,329,430
2015,7,11,5,10,194,420,614
2015,7,11,5,11,279,549,828
2015,7,11,5,12,420,616,1036
2015,7,11,5,13,472,570,1042
2015,7,11,5,14,478,597,1075
2015,7,11,5,15,488,597,1085
2015,7,11,5,16,468,511,979
2015,7,11,5,17,390,541,931
2015,7,11,5,18,398,564,962
2015,7,11,5,19,362,439,801
2015,7,11,5,20,251,422,673
2015,7,11,5,21,158,292,450
2015,7,11,5,22,164,258,422
2015,7,11,5,23,82,207,289
2015,7,12,6,0,43,179,222
2015,7,12,6,1,48,129,177
2015,7,12,6,2,24,104,128
2015,7,12,6,3,9,31,40
2015,7,12,6,4,3,17,20
2015,7,12,6,5,5,10,15
2015,7,12,6,6,9,24,33
2015,7,12,6,7,11,86,97
2015,7,12,6,8,51,167,218
2015,7,12,6,9,149,286,435
2015,7,12,6,10,265,458,723
2015,7,12,6,11,326,544,870
2015,7,12,6,12,428,571,999
2015,7,12,6,13,403,579,982
2015,7,12,6,14,386,574,960
2015,7,12,6,15,363,549,912
2015,7,12,6,16,395,594,989
2015,7,12,6,17,316,569,885
2015,7,12,6,18,276,568,844
2015,7,12,6,19,217,461,678
2015,7,12,6,20,223,349,572
2015,7,12,6,21,184,274,458
2015,7,12,6,22,111,186,297
2015,7,12,6,23,69,88,157
2015,7,13,0,0,35,35,70
2015,7,13,0,1,8,21,29
2015,7,13,0,2,1,7,8
2015,7,13,0,3,1,2,3
2015,7,13,0,4,1,7,8
2015,7,13,0,5,1,87,88
2015,7,13,0,6,15,290,305
2015,7,13,0,7,37,767,804
2015,7,13,0,8,29,597,626
2015,7,13,0,9,66,368,434
2015,7,13,0,10,107,211,318
2015,7,13,0,11,90,155,245
2015,7,13,0,12,78,236,314
2015,7,13,0,13,130,309,439
2015,7,13,0,14,169,248,417
2015,7,13,0,15,208,332,540
2015,7,13,0,16,182,592,774
2015,7,13,0,17,182,1221,1403
2015,7,13,0,18,141,1046,1187
2015,7,13,0,19,126,700,826
2015,7,13,0,20,117,513,630
2015,7,13,0,21,87,336,423
2015,7,13,0,22,41,185,226
2015,7,13,0,23,12,95,107
2015,7,14,1,0,31,71,102
2015,7,14,1,1,11,18,29
2015,7,14,1,2,1,9,10
2015,7,14,1,3,3,8,11
2015,7,14,1,4,4,11,15
2015,7,14,1,5,2,97,99
2015,7,14,1,6,16,333,349
2015,7,14,1,7,19,864,883
2015,7,14,1,8,56,1092,1148
2015,7,14,1,9,41,422,463
2015,7,14,1,10,133,225,358
2015,7,14,1,11,120,236,356
2015,7,14,1,12,145,345,490
2015,7,14,1,13,168,304,472
2015,7,14,1,14,134,267,401
2015,7,14,1,15,145,300,445
2015,7,14,1,16,137,564,701
2015,7,14,1,17,183,1250,1433
2015,7,14,1,18,177,1146,1323
2015,7,14,1,19,146,791,937
2015,7,14,1,20,98,542,640
2015,7,14,1,21,85,340,425
2015,7,14,1,22,60,246,306
2015,7,14,1,23,60,135,195
2015,7,15,2,0,21,52,73
2015,7,15,2,1,1,10,11
2015,7,15,2,2,2,4,6
2015,7,15,2,3,0,1,1
2015,7,15,2,4,0,18,18
2015,7,15,2,5,4,108,112
2015,7,15,2,6,17,323,340
2015,7,15,2,7,57,892,949
2015,7,15,2,8,61,1268,1329
2015,7,15,2,9,76,502,578
2015,7,15,2,10,105,242,347
2015,7,15,2,11,96,229,325
2015,7,15,2,12,137,299,436
2015,7,15,2,13,123,298,421
2015,7,15,2,14,104,261,365
2015,7,15,2,15,155,345,500
2015,7,15,2,16,155,586,741
2015,7,15,2,17,167,1196,1363
2015,7,15,2,18,206,1200,1406
2015,7,15,2,19,216,778,994
2015,7,15,2,20,153,626,779
2015,7,15,2,21,80,417,497
2015,7,15,2,22,62,260,322
2015,7,15,2,23,41,134,175
2015,7,16,3,0,31,62,93
2015,7,16,3,1,3,14,17
2015,7,16,3,2,6,8,14
2015,7,16,3,3,2,1,3
2015,7,16,3,4,0,11,11
2015,7,16,3,5,5,89,94
2015,7,16,3,6,17,311,328
2015,7,16,3,7,24,884,908
2015,7,16,3,8,58,1228,1286
2015,7,16,3,9,82,516,598
2015,7,16,3,10,141,238,379
2015,7,16,3,11,143,281,424
2015,7,16,3,12,175,421,596
2015,7,16,3,13,147,365,512
2015,7,16,3,14,172,300,472
2015,7,16,3,15,208,375,583
2015,7,16,3,16,188,686,874
2015,7,16,3,17,175,1339,1514
2015,7,16,3,18,195,1249,1444
2015,7,16,3,19,192,876,1068
2015,7,16,3,20,177,614,791
2015,7,16,3,21,135,391,526
2015,7,16,3,22,145,322,467
2015,7,16,3,23,95,160,255
2015,7,17,4,0,37,76,113
2015,7,17,4,1,23,42,65
2015,7,17,4,2,15,18,33
2015,7,17,4,3,1,4,5
2015,7,17,4,4,5,8,13
2015,7,17,4,5,11,91,102
2015,7,17,4,6,11,265,276
2015,7,17,4,7,39,734,773
2015,7,17,4,8,70,1110,1180
2015,7,17,4,9,98,503,601
2015,7,17,4,10,146,246,392
2015,7,17,4,11,207,268,475
2015,7,17,4,12,262,388,650
2015,7,17,4,13,215,359,574
2015,7,17,4,14,277,352,629
2015,7,17,4,15,258,466,724
2015,7,17,4,16,233,702,935
2015,7,17,4,17,243,1195,1438
2015,7,17,4,18,215,918,1133
2015,7,17,4,19,181,643,824
2015,7,17,4,20,158,423,581
2015,7,17,4,21,123,324,447
2015,7,17,4,22,96,304,400
2015,7,17,4,23,53,211,264
2015,7,18,5,0,38,159,197
2015,7,18,5,1,35,127,162
2015,7,18,5,2,9,88,97
2015,7,18,5,3,14,25,39
2015,7,18,5,4,5,9,14
2015,7,18,5,5,3,9,12
2015,7,18,5,6,11,48,59
2015,7,18,5,7,37,121,158
2015,7,18,5,8,79,260,339
2015,7,18,5,9,106,290,396
2015,7,18,5,10,89,226,315
2015,7,18,5,11,207,423,630
2015,7,18,5,12,323,493,816
2015,7,18,5,13,418,499,917
2015,7,18,5,14,406,518,924
2015,7,18,5,15,458,515,973
2015,7,18,5,16,361,450,811
2015,7,18,5,17,338,406,744
2015,7,18,5,18,350,474,824
2015,7,18,5,19,348,454,802
2015,7,18,5,20,293,381,674
2015,7,18,5,21,203,263,466
2015,7,18,5,22,182,235,417
2015,7,18,5,23,113,197,310
2015,7,19,6,0,89,150,239
2015,7,19,6,1,40,131,171
2015,7,19,6,2,24,82,106
2015,7,19,6,3,21,36,57
2015,7,19,6,4,7,11,18
2015,7,19,6,5,3,14,17
2015,7,19,6,6,21,27,48
2015,7,19,6,7,27,64,91
2015,7,19,6,8,108,160,268
2015,7,19,6,9,175,286,461
2015,7,19,6,10,362,447,809
2015,7,19,6,11,386,476,862
2015,7,19,6,12,381,467,848
2015,7,19,6,13,306,417,723
2015,7,19,6,14,357,425,782
2015,7,19,6,15,305,415,720
2015,7,19,6,16,302,421,723
2015,7,19,6,17,310,424,734
2015,7,19,6,18,246,394,640
2015,7,19,6,19,222,382,604
2015,7,19,6,20,205,316,521
2015,7,19,6,21,164,218,382
2015,7,19,6,22,71,158,229
2015,7,19,6,23,23,72,95
2015,7,20,0,0,24,35,59
2015,7,20,0,1,9,9,18
2015,7,20,0,2,4,7,11
2015,7,20,0,3,0,4,4
2015,7,20,0,4,1,10,11
2015,7,20,0,5,3,88,91
2015,7,20,0,6,13,276,289
2015,7,20,0,7,27,724,751
2015,7,20,0,8,64,913,977
2015,7,20,0,9,87,381,468
2015,7,20,0,10,140,174,314
2015,7,20,0,11,168,215,383
2015,7,20,0,12,153,312,465
2015,7,20,0,13,174,250,424
2015,7,20,0,14,150,195,345
2015,7,20,0,15,178,241,419
2015,7,20,0,16,191,515,706
2015,7,20,0,17,188,1137,1325
2015,7,20,0,18,159,1096,1255
2015,7,20,0,19,172,707,879
2015,7,20,0,20,156,565,721
2015,7,20,0,21,107,358,465
2015,7,20,0,22,88,221,309
2015,7,20,0,23,62,105,167
2015,7,21,1,0,5,36,41
2015,7,21,1,1,3,10,13
2015,7,21,1,2,1,8,9
2015,7,21,1,3,2,3,5
2015,7,21,1,4,0,13,13
2015,7,21,1,5,3,84,87
2015,7,21,1,6,15,304,319
2015,7,21,1,7,49,816,865
2015,7,21,1,8,64,1070,1134
2015,7,21,1,9,70,463,533
2015,7,21,1,10,122,197,319
2015,7,21,1,11,171,229,400
2015,7,21,1,12,161,291,452
2015,7,21,1,13,163,329,492
2015,7,21,1,14,155,266,421
2015,7,21,1,15,192,324,516
2015,7,21,1,16,165,555,720
2015,7,21,1,17,202,1244,1446
2015,7,21,1,18,185,1164,1349
2015,7,21,1,19,134,744,878
2015,7,21,1,20,146,565,711
2015,7,21,1,21,104,429,533
2015,7,21,1,22,82,299,381
2015,7,21,1,23,52,122,174
2015,7,22,2,0,22,42,64
2015,7,22,2,1,13,22,35
2015,7,22,2,2,9,8,17
2015,7,22,2,3,5,2,7
2015,7,22,2,4,4,11,15
2015,7,22,2,5,12,100,112
2015,7,22,2,6,27,373,400
2015,7,22,2,7,41,931,972
2015,7,22,2,8,67,1161,1228
2015,7,22,2,9,84,501,585
2015,7,22,2,10,115,289,404
2015,7,22,2,11,168,327,495
2015,7,22,2,12,163,380,543
2015,7,22,2,13,169,311,480
2015,7,22,2,14,158,277,435
2015,7,22,2,15,202,346,548
2015,7,22,2,16,208,628,836
2015,7,22,2,17,240,1337,1577
2015,7,22,2,18,188,1163,1351
2015,7,22,2,19,192,806,998
2015,7,22,2,20,164,612,776
2015,7,22,2,21,112,434,546
2015,7,22,2,22,75,273,348
2015,7,22,2,23,30,132,162
2015,7,23,3,0,31,66,97
2015,7,23,3,1,9,27,36
2015,7,23,3,2,4,14,18
2015,7,23,3,3,1,6,7
2015,7,23,3,4,0,14,14
2015,7,23,3,5,3,79,82
2015,7,23,3,6,9,316,325
2015,7,23,3,7,47,916,963
2015,7,23,3,8,63,1158,1221
2015,7,23,3,9,71,482,553
2015,7,23,3,10,155,217,372
2015,7,23,3,11,149,261,410
2015,7,23,3,12,148,425,573
2015,7,23,3,13,193,375,568
2015,7,23,3,14,191,298,489
2015,7,23,3,15,186,351,537
2015,7,23,3,16,192,649,841
2015,7,23,3,17,257,1307,1564
2015,7,23,3,18,239,1180,1419
2015,7,23,3,19,194,811,1005
2015,7,23,3,20,189,625,814
2015,7,23,3,21,136,384,520
2015,7,23,3,22,83,291,374
2015,7,23,3,23,25,165,190
2015,7,24,4,0,18,77,95
2015,7,24,4,1,27,41,68
2015,7,24,4,2,11,18,29
2015,7,24,4,3,2,6,8
2015,7,24,4,4,0,11,11
2015,7,24,4,5,8,84,92
2015,7,24,4,6,20,272,292
2015,7,24,4,7,39,758,797
2015,7,24,4,8,59,1142,1201
2015,7,24,4,9,119,525,644
2015,7,24,4,10,185,287,472
2015,7,24,4,11,202,331,533
2015,7,24,4,12,215,401,616
2015,7,24,4,13,221,413,634
2015,7,24,4,14,210,386,596
2015,7,24,4,15,239,469,708
2015,7,24,4,16,279,738,1017
2015,7,24,4,17,282,1247,1529
2015,7,24,4,18,280,971,1251
2015,7,24,4,19,254,593,847
2015,7,24,4,20,258,464,722
2015,7,24,4,21,138,327,465
2015,7,24,4,22,126,289,415
2015,7,24,4,23,88,209,297
2015,7,25,5,0,49,123,172
2015,7,25,5,1,20,88,108
2015,7,25,5,2,27,57,84
2015,7,25,5,3,12,31,43
2015,7,25,5,4,8,14,22
2015,7,25,5,5,9,13,22
2015,7,25,5,6,19,40,59
2015,7,25,5,7,50,119,169
2015,7,25,5,8,89,270,359
2015,7,25,5,9,209,377,586
2015,7,25,5,10,318,418,736
2015,7,25,5,11,385,552,937
2015,7,25,5,12,476,525,1001
2015,7,25,5,13,507,540,1047
2015,7,25,5,14,484,543,1027
2015,7,25,5,15,525,520,1045
2015,7,25,5,16,512,447,959
2015,7,25,5,17,481,490,971
2015,7,25,5,18,415,474,889
2015,7,25,5,19,344,422,766
2015,7,25,5,20,286,347,633
2015,7,25,5,21,256,255,511
2015,7,25,5,22,190,247,437
2015,7,25,5,23,136,183,319
2015,7,26,6,0,76,157,233
2015,7,26,6,1,26,104,130
2015,7,26,6,2,22,66,88
2015,7,26,6,3,14,34,48
2015,7,26,6,4,0,8,8
2015,7,26,6,5,5,12,17
2015,7,26,6,6,11,24,35
2015,7,26,6,7,42,62,104
2015,7,26,6,8,62,153,215
2015,7,26,6,9,223,350,573
2015,7,26,6,10,300,415,715
2015,7,26,6,11,302,487,789
2015,7,26,6,12,441,462,903
2015,7,26,6,13,372,493,865
2015,7,26,6,14,432,500,932
2015,7,26,6,15,423,517,940
2015,7,26,6,16,408,529,937
2015,7,26,6,17,368,517,885
2015,7,26,6,18,328,478,806
2015,7,26,6,19,290,447,737
2015,7,26,6,20,229,334,563
2015,7,26,6,21,143,217,360
2015,7,26,6,22,86,185,271
2015,7,26,6,23,79,81,160
2015,7,27,0,0,40,29,69
2015,7,27,0,1,26,12,38
2015,7,27,0,2,7,11,18
2015,7,27,0,3,1,4,5
2015,7,27,0,4,2,4,6
2015,7,27,0,5,0,37,37
2015,7,27,0,6,11,240,251
2015,7,27,0,7,28,692,720
2015,7,27,0,8,71,955,1026
2015,7,27,0,9,80,434,514
2015,7,27,0,10,182,203,385
2015,7,27,0,11,177,225,402
2015,7,27,0,12,216,311,527
2015,7,27,0,13,223,299,522
2015,7,27,0,14,201,262,463
2015,7,27,0,15,47,101,148
2015,7,27,0,16,129,425,554
2015,7,27,0,17,228,1174,1402
2015,7,27,0,18,193,1129,1322
2015,7,27,0,19,212,713,925
2015,7,27,0,20,155,556,711
2015,7,27,0,21,135,358,493
2015,7,27,0,22,78,160,238
2015,7,27,0,23,40,103,143
2015,7,28,1,0,24,44,68
2015,7,28,1,1,15,20,35
2015,7,28,1,2,0,17,17
2015,7,28,1,3,2,0,2
2015,7,28,1,4,1,10,11
2015,7,28,1,5,4,81,85
2015,7,28,1,6,15,362,377
2015,7,28,1,7,26,907,933
2015,7,28,1,8,66,1185,1251
2015,7,28,1,9,130,486,616
2015,7,28,1,10,202,190,392
2015,7,28,1,11,244,263,507
2015,7,28,1,12,204,329,533
2015,7,28,1,13,204,319,523
2015,7,28,1,14,221,243,464
2015,7,28,1,15,213,335,548
2015,7,28,1,16,195,611,806
2015,7,28,1,17,203,1250,1453
2015,7,28,1,18,170,1139,1309
2015,7,28,1,19,94,452,546
2015,7,28,1,20,119,501,620
2015,7,28,1,21,85,342,427
2015,7,28,1,22,46,227,273
2015,7,28,1,23,45,135,180
2015,7,29,2,0,17,43,60
2015,7,29,2,1,16,14,30
2015,7,29,2,2,14,10,24
2015,7,29,2,3,7,7,14
2015,7,29,2,4,1,9,10
2015,7,29,2,5,4,109,113
2015,7,29,2,6,16,341,357
2015,7,29,2,7,27,862,889
2015,7,29,2,8,66,1190,1256
2015,7,29,2,9,74,471,545
2015,7,29,2,10,141,216,357
2015,7,29,2,11,160,271,431
2015,7,29,2,12,158,307,465
2015,7,29,2,13,206,306,512
2015,7,29,2,14,202,258,460
2015,7,29,2,15,184,276,460
2015,7,29,2,16,163,585,748
2015,7,29,2,17,207,1186,1393
2015,7,29,2,18,218,1101,1319
2015,7,29,2,19,184,779,963
2015,7,29,2,20,137,606,743
2015,7,29,2,21,109,391,500
2015,7,29,2,22,83,261,344
2015,7,29,2,23,34,143,177
2015,7,30,3,0,39,62,101
2015,7,30,3,1,14,29,43
2015,7,30,3,2,4,4,8
2015,7,30,3,3,4,8,12
2015,7,30,3,4,0,7,7
2015,7,30,3,5,4,91,95
2015,7,30,3,6,18,320,338
2015,7,30,3,7,34,789,823
2015,7,30,3,8,51,1105,1156
2015,7,30,3,9,86,464,550
2015,7,30,3,10,101,210,311
2015,7,30,3,11,140,238,378
2015,7,30,3,12,143,316,459
2015,7,30,3,13,152,303,455
2015,7,30,3,14,31,50,81
2015,7,30,3,15,105,251,356
2015,7,30,3,16,156,585,741
2015,7,30,3,17,171,1099,1270
2015,7,30,3,18,145,1035,1180
2015,7,30,3,19,138,774,912
2015,7,30,3,20,121,513,634
2015,7,30,3,21,61,359,420
2015,7,30,3,22,56,249,305
2015,7,30,3,23,29,144,173
2015,7,31,4,0,17,64,81
2015,7,31,4,1,11,38,49
2015,7,31,4,2,2,20,22
2015,7,31,4,3,2,5,7
2015,7,31,4,4,3,13,16
2015,7,31,4,5,4,81,85
2015,7,31,4,6,23,284,307
2015,7,31,4,7,26,728,754
2015,7,31,4,8,71,1061,1132
2015,7,31,4,9,80,506,586
2015,7,31,4,10,140,229,369
2015,7,31,4,11,163,326,489
2015,7,31,4,12,172,421,593
2015,7,31,4,13,193,409,602
2015,7,31,4,14,180,354,534
2015,7,31,4,15,213,445,658
2015,7,31,4,16,203,726,929
2015,7,31,4,17,217,1072,1289
2015,7,31,4,18,224,902,1126
2015,7,31,4,19,246,619,865
2015,7,31,4,20,187,509,696
2015,7,31,4,21,137,336,473
2015,7,31,4,22,139,250,389
2015,7,31,4,23,98,247,345
2015,8,1,5,0,29,151,180
2015,8,1,5,1,22,101,123
2015,8,1,5,2,14,73,87
2015,8,1,5,3,12,18,30
2015,8,1,5,4,2,7,9
2015,8,1,5,5,6,11,17
2015,8,1,5,6,21,54,75
2015,8,1,5,7,25,107,132
2015,8,1,5,8,71,218,289
2015,8,1,5,9,143,413,556
2015,8,1,5,10,270,485,755
2015,8,1,5,11,283,477,760
2015,8,1,5,12,413,532,945
2015,8,1,5,13,461,561,1022
2015,8,1,5,14,467,496,963
2015,8,1,5,15,440,528,968
2015,8,1,5,16,448,439,887
2015,8,1,5,17,433,473,906
2015,8,1,5,18,332,485,817
2015,8,1,5,19,332,397,729
2015,8,1,5,20,240,319,559
2015,8,1,5,21,201,336,537
2015,8,1,5,22,167,222,389
2015,8,1,5,23,108,200,308
2015,8,2,6,0,79,168,247
2015,8,2,6,1,43,124,167
2015,8,2,6,2,18,91,109
2015,8,2,6,3,24,40,64
2015,8,2,6,4,13,12,25
2015,8,2,6,5,7,12,19
2015,8,2,6,6,10,20,30
2015,8,2,6,7,33,76,109
2015,8,2,6,8,88,157,245
2015,8,2,6,9,174,301,475
2015,8,2,6,10,284,445,729
2015,8,2,6,11,385,456,841
2015,8,2,6,12,398,573,971
2015,8,2,6,13,381,547,928
2015,8,2,6,14,436,493,929
2015,8,2,6,15,349,522,871
2015,8,2,6,16,436,574,1010
2015,8,2,6,17,321,479,800
2015,8,2,6,18,314,529,843
2015,8,2,6,19,236,443,679
2015,8,2,6,20,189,343,532
2015,8,2,6,21,139,239,378
2015,8,2,6,22,121,159,280
2015,8,2,6,23,72,94,166
2015,8,3,0,0,33,29,62
2015,8,3,0,1,12,12,24
2015,8,3,0,2,5,6,11
2015,8,3,0,3,0,3,3
2015,8,3,0,4,3,8,11
2015,8,3,0,5,1,82,83
2015,8,3,0,6,8,310,318
2015,8,3,0,7,17,785,802
2015,8,3,0,8,56,994,1050
2015,8,3,0,9,126,484,610
2015,8,3,0,10,171,233,404
2015,8,3,0,11,235,265,500
2015,8,3,0,12,181,309,490
2015,8,3,0,13,170,308,478
2015,8,3,0,14,224,293,517
2015,8,3,0,15,235,336,571
2015,8,3,0,16,173,576,749
2015,8,3,0,17,202,1202,1404
2015,8,3,0,18,220,1122,1342
2015,8,3,0,19,216,783,999
2015,8,3,0,20,192,489,681
2015,8,3,0,21,114,411,525
2015,8,3,0,22,70,223,293
2015,8,3,0,23,50,108,158
2015,8,4,1,0,25,42,67
2015,8,4,1,1,8,18,26
2015,8,4,1,2,3,9,12
2015,8,4,1,3,1,1,2
2015,8,4,1,4,3,11,14
2015,8,4,1,5,5,97,102
2015,8,4,1,6,16,347,363
2015,8,4,1,7,49,853,902
2015,8,4,1,8,58,1145,1203
2015,8,4,1,9,94,454,548
2015,8,4,1,10,159,190,349
2015,8,4,1,11,142,240,382
2015,8,4,1,12,134,313,447
2015,8,4,1,13,153,323,476
2015,8,4,1,14,155,278,433
2015,8,4,1,15,154,321,475
2015,8,4,1,16,162,585,747
2015,8,4,1,17,209,1203,1412
2015,8,4,1,18,185,1097,1282
2015,8,4,1,19,161,728,889
2015,8,4,1,20,129,481,610
2015,8,4,1,21,101,304,405
2015,8,4,1,22,69,233,302
2015,8,4,1,23,37,141,178
2015,8,5,2,0,13,40,53
2015,8,5,2,1,5,10,15
2015,8,5,2,2,1,8,9
2015,8,5,2,3,2,3,5
2015,8,5,2,4,1,8,9
2015,8,5,2,5,3,104,107
2015,8,5,2,6,13,316,329
2015,8,5,2,7,45,859,904
2015,8,5,2,8,60,1151,1211
2015,8,5,2,9,89,537,626
2015,8,5,2,10,116,245,361
2015,8,5,2,11,123,290,413
2015,8,5,2,12,178,345,523
2015,8,5,2,13,189,336,525
2015,8,5,2,14,193,252,445
2015,8,5,2,15,195,339,534
2015,8,5,2,16,214,637,851
2015,8,5,2,17,205,1250,1455
2015,8,5,2,18,182,1189,1371
2015,8,5,2,19,201,771,972
2015,8,5,2,20,138,579,717
2015,8,5,2,21,114,364,478
2015,8,5,2,22,83,300,383
2015,8,5,2,23,45,160,205
2015,8,6,3,0,34,57,91
2015,8,6,3,1,2,28,30
2015,8,6,3,2,6,7,13
2015,8,6,3,3,1,3,4
2015,8,6,3,4,0,5,5
2015,8,6,3,5,4,79,83
2015,8,6,3,6,12,311,323
2015,8,6,3,7,46,886,932
2015,8,6,3,8,73,1209,1282
2015,8,6,3,9,97,570,667
2015,8,6,3,10,146,279,425
2015,8,6,3,11,199,263,462
2015,8,6,3,12,191,357,548
2015,8,6,3,13,186,295,481
2015,8,6,3,14,216,278,494
2015,8,6,3,15,216,367,583
2015,8,6,3,16,208,607,815
2015,8,6,3,17,216,1286,1502
2015,8,6,3,18,211,1166,1377
2015,8,6,3,19,155,725,880
2015,8,6,3,20,116,536,652
2015,8,6,3,21,114,281,395
2015,8,6,3,22,65,246,311
2015,8,6,3,23,51,211,262
2015,8,7,4,0,27,92,119
2015,8,7,4,1,12,41,53
2015,8,7,4,2,2,21,23
2015,8,7,4,3,0,4,4
2015,8,7,4,4,4,8,12
2015,8,7,4,5,6,74,80
2015,8,7,4,6,11,223,234
2015,8,7,4,7,31,628,659
2015,8,7,4,8,48,1032,1080
2015,8,7,4,9,86,544,630
2015,8,7,4,10,122,262,384
2015,8,7,4,11,155,293,448
2015,8,7,4,12,208,392,600
2015,8,7,4,13,202,439,641
2015,8,7,4,14,228,337,565
2015,8,7,4,15,204,459,663
2015,8,7,4,16,242,685,927
2015,8,7,4,17,282,1092,1374
2015,8,7,4,18,246,936,1182
2015,8,7,4,19,235,563,798
2015,8,7,4,20,161,419,580
2015,8,7,4,21,130,298,428
2015,8,7,4,22,111,284,395
2015,8,7,4,23,74,228,302
2015,8,8,5,0,41,135,176
2015,8,8,5,1,33,107,140
2015,8,8,5,2,22,72,94
2015,8,8,5,3,10,30,40
2015,8,8,5,4,4,12,16
2015,8,8,5,5,4,22,26
2015,8,8,5,6,23,52,75
2015,8,8,5,7,45,109,154
2015,8,8,5,8,77,222,299
2015,8,8,5,9,160,381,541
2015,8,8,5,10,269,471,740
2015,8,8,5,11,358,506,864
2015,8,8,5,12,485,584,1069
2015,8,8,5,13,513,568,1081
2015,8,8,5,14,615,572,1187
2015,8,8,5,15,553,499,1052
2015,8,8,5,16,459,451,910
2015,8,8,5,17,549,511,1060
2015,8,8,5,18,360,507,867
2015,8,8,5,19,396,358,754
2015,8,8,5,20,260,329,589
2015,8,8,5,21,243,249,492
2015,8,8,5,22,206,212,418
2015,8,8,5,23,158,168,326
2015,8,9,6,0,103,172,275
2015,8,9,6,1,69,118,187
2015,8,9,6,2,41,68,109
2015,8,9,6,3,7,29,36
2015,8,9,6,4,0,12,12
2015,8,9,6,5,7,8,15
2015,8,9,6,6,18,28,46
2015,8,9,6,7,28,70,98
2015,8,9,6,8,46,175,221
2015,8,9,6,9,191,260,451
2015,8,9,6,10,338,464,802
2015,8,9,6,11,355,493,848
2015,8,9,6,12,356,582,938
2015,8,9,6,13,482,549,1031
2015,8,9,6,14,477,525,1002
2015,8,9,6,15,378,507,885
2015,8,9,6,16,418,500,918
2015,8,9,6,17,387,512,899
2015,8,9,6,18,330,487,817
2015,8,9,6,19,279,400,679
2015,8,9,6,20,190,304,494
2015,8,9,6,21,208,233,441
2015,8,9,6,22,135,149,284
2015,8,9,6,23,80,83,163
2015,8,10,0,0,44,28,72
2015,8,10,0,1,8,20,28
2015,8,10,0,2,6,3,9
2015,8,10,0,3,6,2,8
2015,8,10,0,4,0,2,2
2015,8,10,0,5,2,39,41
2015,8,10,0,6,11,213,224
2015,8,10,0,7,27,627,654
2015,8,10,0,8,46,850,896
2015,8,10,0,9,89,479,568
2015,8,10,0,10,158,188,346
2015,8,10,0,11,144,243,387
2015,8,10,0,12,180,265,445
2015,8,10,0,13,190,290,480
2015,8,10,0,14,208,250,458
2015,8,10,0,15,243,302,545
2015,8,10,0,16,167,542,709
2015,8,10,0,17,240,1227,1467
2015,8,10,0,18,183,1052,1235
2015,8,10,0,19,142,651,793
2015,8,10,0,20,131,469,600
2015,8,10,0,21,88,181,269
2015,8,10,0,22,36,145,181
2015,8,10,0,23,13,64,77
2015,8,11,1,0,2,22,24
2015,8,11,1,1,1,14,15
2015,8,11,1,2,2,1,3
2015,8,11,1,3,1,4,5
2015,8,11,1,4,1,8,9
2015,8,11,1,5,2,84,86
2015,8,11,1,6,4,200,204
2015,8,11,1,7,20,648,668
2015,8,11,1,8,48,1041,1089
2015,8,11,1,9,67,545,612
2015,8,11,1,10,106,210,316
2015,8,11,1,11,149,243,392
2015,8,11,1,12,143,339,482
2015,8,11,1,13,181,329,510
2015,8,11,1,14,165,283,448
2015,8,11,1,15,157,316,473
2015,8,11,1,16,143,558,701
2015,8,11,1,17,173,1309,1482
2015,8,11,1,18,193,1157,1350
2015,8,11,1,19,178,719,897
2015,8,11,1,20,139,547,686
2015,8,11,1,21,98,346,444
2015,8,11,1,22,79,236,315
2015,8,11,1,23,13,118,131
2015,8,12,2,0,33,40,73
2015,8,12,2,1,5,15,20
2015,8,12,2,2,2,11,13
2015,8,12,2,3,2,2,4
2015,8,12,2,4,2,9,11
2015,8,12,2,5,4,114,118
2015,8,12,2,6,5,361,366
2015,8,12,2,7,44,847,891
2015,8,12,2,8,50,1136,1186
2015,8,12,2,9,107,513,620
2015,8,12,2,10,123,226,349
2015,8,12,2,11,158,237,395
2015,8,12,2,12,190,358,548
2015,8,12,2,13,156,340,496
2015,8,12,2,14,194,238,432
2015,8,12,2,15,181,370,551
2015,8,12,2,16,200,628,828
2015,8,12,2,17,159,1335,1494
2015,8,12,2,18,228,1189,1417
2015,8,12,2,19,163,815,978
2015,8,12,2,20,136,618,754
2015,8,12,2,21,93,405,498
2015,8,12,2,22,42,251,293
2015,8,12,2,23,27,123,150
2015,8,13,3,0,6,45,51
2015,8,13,3,1,14,24,38
2015,8,13,3,2,7,17,24
2015,8,13,3,3,3,9,12
2015,8,13,3,4,2,6,8
2015,8,13,3,5,6,86,92
2015,8,13,3,6,14,341,355
2015,8,13,3,7,29,842,871
2015,8,13,3,8,61,1060,1121
2015,8,13,3,9,86,493,579
2015,8,13,3,10,129,230,359
2015,8,13,3,11,143,280,423
2015,8,13,3,12,164,357,521
2015,8,13,3,13,163,367,530
2015,8,13,3,14,154,309,463
2015,8,13,3,15,182,442,624
2015,8,13,3,16,207,609,816
2015,8,13,3,17,212,1330,1542
2015,8,13,3,18,239,1174,1413
2015,8,13,3,19,157,793,950
2015,8,13,3,20,123,504,627
2015,8,13,3,21,124,404,528
2015,8,13,3,22,80,225,305
2015,8,13,3,23,39,144,183
2015,8,14,4,0,41,76,117
2015,8,14,4,1,7,38,45
2015,8,14,4,2,2,18,20
2015,8,14,4,3,3,4,7
2015,8,14,4,4,3,7,10
2015,8,14,4,5,5,73,78
2015,8,14,4,6,8,283,291
2015,8,14,4,7,34,695,729
2015,8,14,4,8,54,1084,1138
2015,8,14,4,9,93,556,649
2015,8,14,4,10,164,247,411
2015,8,14,4,11,208,287,495
2015,8,14,4,12,243,439,682
2015,8,14,4,13,252,407,659
2015,8,14,4,14,273,333,606
2015,8,14,4,15,235,465,700
2015,8,14,4,16,255,735,990
2015,8,14,4,17,254,1189,1443
2015,8,14,4,18,198,887,1085
2015,8,14,4,19,215,521,736
2015,8,14,4,20,150,409,559
2015,8,14,4,21,116,341,457
2015,8,14,4,22,94,240,334
2015,8,14,4,23,65,243,308
2015,8,15,5,0,41,134,175
2015,8,15,5,1,19,93,112
2015,8,15,5,2,28,71,99
2015,8,15,5,3,8,33,41
2015,8,15,5,4,2,8,10
2015,8,15,5,5,3,19,22
2015,8,15,5,6,6,48,54
2015,8,15,5,7,31,115,146
2015,8,15,5,8,62,242,304
2015,8,15,5,9,128,357,485
2015,8,15,5,10,305,455,760
2015,8,15,5,11,407,535,942
2015,8,15,5,12,493,583,1076
2015,8,15,5,13,494,522,1016
2015,8,15,5,14,479,422,901
2015,8,15,5,15,449,501,950
2015,8,15,5,16,446,471,917
2015,8,15,5,17,420,428,848
2015,8,15,5,18,364,445,809
2015,8,15,5,19,332,416,748
2015,8,15,5,20,243,314,557
2015,8,15,5,21,217,249,466
2015,8,15,5,22,161,190,351
2015,8,15,5,23,123,170,293
2015,8,16,6,0,75,118,193
2015,8,16,6,1,36,98,134
2015,8,16,6,2,24,68,92
2015,8,16,6,3,22,33,55
2015,8,16,6,4,2,7,9
2015,8,16,6,5,6,12,18
2015,8,16,6,6,7,30,37
2015,8,16,6,7,27,62,89
2015,8,16,6,8,54,182,236
2015,8,16,6,9,167,311,478
2015,8,16,6,10,285,429,714
2015,8,16,6,11,375,506,881
2015,8,16,6,12,377,532,909
2015,8,16,6,13,374,471,845
2015,8,16,6,14,311,494,805
2015,8,16,6,15,338,434,772
2015,8,16,6,16,285,469,754
2015,8,16,6,17,251,476,727
2015,8,16,6,18,219,449,668
2015,8,16,6,19,237,432,669
2015,8,16,6,20,179,308,487
2015,8,16,6,21,97,193,290
2015,8,16,6,22,79,139,218
2015,8,16,6,23,45,67,112
2015,8,17,0,0,25,27,52
2015,8,17,0,1,20,8,28
2015,8,17,0,2,2,6,8
2015,8,17,0,3,1,9,10
2015,8,17,0,4,5,7,12
2015,8,17,0,5,2,73,75
2015,8,17,0,6,14,298,312
2015,8,17,0,7,28,774,802
2015,8,17,0,8,48,1021,1069
2015,8,17,0,9,124,416,540
2015,8,17,0,10,144,215,359
2015,8,17,0,11,158,196,354
2015,8,17,0,12,185,316,501
2015,8,17,0,13,128,301,429
2015,8,17,0,14,127,245,372
2015,8,17,0,15,172,316,488
2015,8,17,0,16,165,536,701
2015,8,17,0,17,139,1168,1307
2015,8,17,0,18,163,1086,1249
2015,8,17,0,19,150,731,881
2015,8,17,0,20,120,490,610
2015,8,17,0,21,124,320,444
2015,8,17,0,22,63,181,244
2015,8,17,0,23,28,96,124
2015,8,18,1,0,9,23,32
2015,8,18,1,1,2,9,11
2015,8,18,1,2,5,1,6
2015,8,18,1,3,0,2,2
2015,8,18,1,4,2,5,7
2015,8,18,1,5,4,93,97
2015,8,18,1,6,11,308,319
2015,8,18,1,7,23,891,914
2015,8,18,1,8,59,1144,1203
2015,8,18,1,9,56,465,521
2015,8,18,1,10,136,194,330
2015,8,18,1,11,167,261,428
2015,8,18,1,12,110,323,433
2015,8,18,1,13,131,316,447
2015,8,18,1,14,164,281,445
2015,8,18,1,15,169,361,530
2015,8,18,1,16,219,601,820
2015,8,18,1,17,218,1238,1456
2015,8,18,1,18,177,1129,1306
2015,8,18,1,19,157,708,865
2015,8,18,1,20,98,497,595
2015,8,18,1,21,83,299,382
2015,8,18,1,22,52,223,275
2015,8,18,1,23,46,125,171
2015,8,19,2,0,19,52,71
2015,8,19,2,1,8,18,26
2015,8,19,2,2,4,5,9
2015,8,19,2,3,4,4,8
2015,8,19,2,4,4,8,12
2015,8,19,2,5,0,131,131
2015,8,19,2,6,6,319,325
2015,8,19,2,7,41,885,926
2015,8,19,2,8,39,1167,1206
2015,8,19,2,9,70,520,590
2015,8,19,2,10,146,236,382
2015,8,19,2,11,159,257,416
2015,8,19,2,12,171,335,506
2015,8,19,2,13,173,351,524
2015,8,19,2,14,169,268,437
2015,8,19,2,15,141,364,505
2015,8,19,2,16,146,565,711
2015,8,19,2,17,156,1237,1393
2015,8,19,2,18,165,1136,1301
2015,8,19,2,19,117,832,949
2015,8,19,2,20,100,567,667
2015,8,19,2,21,60,333,393
2015,8,19,2,22,52,264,316
2015,8,19,2,23,35,127,162
2015,8,20,3,0,19,55,74
2015,8,20,3,1,17,37,54
2015,8,20,3,2,2,8,10
2015,8,20,3,3,3,1,4
2015,8,20,3,4,0,8,8
2015,8,20,3,5,0,78,78
2015,8,20,3,6,6,267,273
2015,8,20,3,7,28,705,733
2015,8,20,3,8,48,1060,1108
2015,8,20,3,9,59,471,530
2015,8,20,3,10,98,214,312
2015,8,20,3,11,144,255,399
2015,8,20,3,12,140,315,455
2015,8,20,3,13,136,288,424
2015,8,20,3,14,153,224,377
2015,8,20,3,15,186,331,517
2015,8,20,3,16,182,536,718
2015,8,20,3,17,202,1188,1390
2015,8,20,3,18,167,1087,1254
2015,8,20,3,19,95,516,611
2015,8,20,3,20,63,243,306
2015,8,20,3,21,36,207,243
2015,8,20,3,22,20,159,179
2015,8,20,3,23,19,116,135
2015,8,21,4,0,19,64,83
2015,8,21,4,1,7,25,32
2015,8,21,4,2,2,16,18
2015,8,21,4,3,1,1,2
2015,8,21,4,4,1,6,7
2015,8,21,4,5,11,88,99
2015,8,21,4,6,8,268,276
2015,8,21,4,7,23,694,717
2015,8,21,4,8,72,1059,1131
2015,8,21,4,9,97,549,646
2015,8,21,4,10,150,265,415
2015,8,21,4,11,205,325,530
2015,8,21,4,12,225,444,669
2015,8,21,4,13,218,434,652
2015,8,21,4,14,292,436,728
2015,8,21,4,15,236,506,742
2015,8,21,4,16,236,796,1032
2015,8,21,4,17,281,1145,1426
2015,8,21,4,18,256,914,1170
2015,8,21,4,19,197,627,824
2015,8,21,4,20,179,382,561
2015,8,21,4,21,139,314,453
2015,8,21,4,22,117,278,395
2015,8,21,4,23,92,202,294
2015,8,22,5,0,62,137,199
2015,8,22,5,1,14,100,114
2015,8,22,5,2,17,59,76
2015,8,22,5,3,18,16,34
2015,8,22,5,4,7,12,19
2015,8,22,5,5,1,12,13
2015,8,22,5,6,13,39,52
2015,8,22,5,7,33,122,155
2015,8,22,5,8,61,230,291
2015,8,22,5,9,159,384,543
2015,8,22,5,10,242,452,694
2015,8,22,5,11,347,585,932
2015,8,22,5,12,384,545,929
2015,8,22,5,13,431,550,981
2015,8,22,5,14,461,548,1009
2015,8,22,5,15,522,517,1039
2015,8,22,5,16,432,526,958
2015,8,22,5,17,444,548,992
2015,8,22,5,18,372,475,847
2015,8,22,5,19,283,431,714
2015,8,22,5,20,249,342,591
2015,8,22,5,21,197,306,503
2015,8,22,5,22,163,235,398
2015,8,22,5,23,83,173,256
2015,8,23,6,0,47,136,183
2015,8,23,6,1,30,99,129
2015,8,23,6,2,21,76,97
2015,8,23,6,3,14,38,52
2015,8,23,6,4,0,6,6
2015,8,23,6,5,2,17,19
2015,8,23,6,6,17,32,49
2015,8,23,6,7,41,82,123
2015,8,23,6,8,70,192,262
2015,8,23,6,9,161,345,506
2015,8,23,6,10,326,464,790
2015,8,23,6,11,315,539,854
2015,8,23,6,12,376,529,905
2015,8,23,6,13,323,487,810
2015,8,23,6,14,395,493,888
2015,8,23,6,15,412,531,943
2015,8,23,6,16,326,575,901
2015,8,23,6,17,370,540,910
2015,8,23,6,18,288,534,822
2015,8,23,6,19,235,419,654
2015,8,23,6,20,151,319,470
2015,8,23,6,21,109,208,317
2015,8,23,6,22,68,137,205
2015,8,23,6,23,22,64,86
2015,8,24,0,0,8,24,32
2015,8,24,0,1,2,11,13
2015,8,24,0,2,1,7,8
2015,8,24,0,3,2,3,5
2015,8,24,0,4,1,6,7
2015,8,24,0,5,4,91,95
2015,8,24,0,6,8,275,283
2015,8,24,0,7,25,822,847
2015,8,24,0,8,59,1032,1091
2015,8,24,0,9,96,460,556
2015,8,24,0,10,156,202,358
2015,8,24,0,11,177,212,389
2015,8,24,0,12,127,312,439
2015,8,24,0,13,157,321,478
2015,8,24,0,14,175,244,419
2015,8,24,0,15,168,299,467
2015,8,24,0,16,182,596,778
2015,8,24,0,17,227,1272,1499
2015,8,24,0,18,145,1080,1225
2015,8,24,0,19,96,461,557
2015,8,24,0,20,37,162,199
2015,8,24,0,21,53,214,267
2015,8,24,0,22,28,139,167
2015,8,24,0,23,29,75,104
2015,8,25,1,0,8,25,33
2015,8,25,1,1,5,5,10
2015,8,25,1,2,2,6,8
2015,8,25,1,3,3,1,4
2015,8,25,1,4,2,8,10
2015,8,25,1,5,3,89,92
2015,8,25,1,6,16,363,379
2015,8,25,1,7,32,953,985
2015,8,25,1,8,58,1261,1319
2015,8,25,1,9,95,448,543
2015,8,25,1,10,102,223,325
2015,8,25,1,11,135,286,421
2015,8,25,1,12,122,398,520
2015,8,25,1,13,128,330,458
2015,8,25,1,14,155,266,421
2015,8,25,1,15,157,360,517
2015,8,25,1,16,198,614,812
2015,8,25,1,17,215,1388,1603
2015,8,25,1,18,244,1274,1518
2015,8,25,1,19,170,819,989
2015,8,25,1,20,133,531,664
2015,8,25,1,21,110,398,508
2015,8,25,1,22,88,303,391
2015,8,25,1,23,39,103,142
2015,8,26,2,0,19,48,67
2015,8,26,2,1,6,20,26
2015,8,26,2,2,9,6,15
2015,8,26,2,3,4,6,10
2015,8,26,2,4,0,14,14
2015,8,26,2,5,2,109,111
2015,8,26,2,6,12,393,405
2015,8,26,2,7,38,927,965
2015,8,26,2,8,50,1234,1284
2015,8,26,2,9,69,472,541
2015,8,26,2,10,97,219,316
2015,8,26,2,11,136,283,419
2015,8,26,2,12,135,401,536
2015,8,26,2,13,142,335,477
2015,8,26,2,14,146,303,449
2015,8,26,2,15,159,376,535
2015,8,26,2,16,157,641,798
2015,8,26,2,17,185,1341,1526
2015,8,26,2,18,185,1256,1441
2015,8,26,2,19,150,777,927
2015,8,26,2,20,87,491,578
2015,8,26,2,21,68,318,386
2015,8,26,2,22,40,303,343
2015,8,26,2,23,37,124,161
2015,8,27,3,0,35,39,74
2015,8,27,3,1,11,17,28
2015,8,27,3,2,7,9,16
2015,8,27,3,3,2,10,12
2015,8,27,3,4,1,14,15
2015,8,27,3,5,0,72,72
2015,8,27,3,6,3,343,346
2015,8,27,3,7,37,886,923
2015,8,27,3,8,64,1168,1232
2015,8,27,3,9,55,532,587
2015,8,27,3,10,78,231,309
2015,8,27,3,11,111,277,388
2015,8,27,3,12,129,418,547
2015,8,27,3,13,148,363,511
2015,8,27,3,14,153,265,418
2015,8,27,3,15,177,354,531
2015,8,27,3,16,137,675,812
2015,8,27,3,17,183,1366,1549
2015,8,27,3,18,190,1219,1409
2015,8,27,3,19,167,798,965
2015,8,27,3,20,97,511,608
2015,8,27,3,21,138,344,482
2015,8,27,3,22,56,315,371
2015,8,27,3,23,43,158,201
2015,8,28,4,0,24,62,86
2015,8,28,4,1,9,27,36
2015,8,28,4,2,7,24,31
2015,8,28,4,3,0,4,4
2015,8,28,4,4,1,9,10
2015,8,28,4,5,1,75,76
2015,8,28,4,6,13,277,290
2015,8,28,4,7,26,750,776
2015,8,28,4,8,59,1099,1158
2015,8,28,4,9,67,511,578
2015,8,28,4,10,114,257,371
2015,8,28,4,11,165,306,471
2015,8,28,4,12,227,404,631
2015,8,28,4,13,202,395,597
2015,8,28,4,14,243,401,644
2015,8,28,4,15,191,489,680
2015,8,28,4,16,170,725,895
2015,8,28,4,17,227,1181,1408
2015,8,28,4,18,195,950,1145
2015,8,28,4,19,170,607,777
2015,8,28,4,20,86,404,490
2015,8,28,4,21,90,309,399
2015,8,28,4,22,78,309,387
2015,8,28,4,23,75,195,270
2015,8,29,5,0,36,133,169
2015,8,29,5,1,19,101,120
2015,8,29,5,2,20,71,91
2015,8,29,5,3,9,20,29
2015,8,29,5,4,3,9,12
2015,8,29,5,5,8,7,15
2015,8,29,5,6,8,43,51
2015,8,29,5,7,16,136,152
2015,8,29,5,8,68,223,291
2015,8,29,5,9,166,402,568
2015,8,29,5,10,237,504,741
2015,8,29,5,11,321,532,853
2015,8,29,5,12,361,576,937
2015,8,29,5,13,371,546,917
2015,8,29,5,14,422,507,929
2015,8,29,5,15,438,499,937
2015,8,29,5,16,404,496,900
2015,8,29,5,17,373,481,854
2015,8,29,5,18,342,493,835
2015,8,29,5,19,288,418,706
2015,8,29,5,20,172,269,441
2015,8,29,5,21,151,265,416
2015,8,29,5,22,113,191,304
2015,8,29,5,23,80,178,258
2015,8,30,6,0,34,153,187
2015,8,30,6,1,22,103,125
2015,8,30,6,2,14,63,77
2015,8,30,6,3,7,27,34
2015,8,30,6,4,5,9,14
2015,8,30,6,5,1,5,6
2015,8,30,6,6,13,31,44
2015,8,30,6,7,33,78,111
2015,8,30,6,8,66,194,260
2015,8,30,6,9,143,293,436
2015,8,30,6,10,222,474,696
2015,8,30,6,11,270,525,795
2015,8,30,6,12,354,600,954
2015,8,30,6,13,311,511,822
2015,8,30,6,14,354,494,848
2015,8,30,6,15,380,462,842
2015,8,30,6,16,320,547,867
2015,8,30,6,17,245,524,769
2015,8,30,6,18,253,496,749
2015,8,30,6,19,157,369,526
2015,8,30,6,20,131,299,430
2015,8,30,6,21,88,205,293
2015,8,30,6,22,58,130,188
2015,8,30,6,23,31,84,115
2015,8,31,0,0,22,30,52
2015,8,31,0,1,13,15,28
2015,8,31,0,2,11,7,18
2015,8,31,0,3,7,5,12
2015,8,31,0,4,1,4,5
2015,8,31,0,5,2,90,92
2015,8,31,0,6,8,298,306
2015,8,31,0,7,29,813,842
2015,8,31,0,8,52,1026,1078
2015,8,31,0,9,54,408,462
2015,8,31,0,10,139,200,339
2015,8,31,0,11,147,244,391
2015,8,31,0,12,136,376,512
2015,8,31,0,13,112,309,421
2015,8,31,0,14,140,242,382
2015,8,31,0,15,128,364,492
2015,8,31,0,16,140,557,697
2015,8,31,0,17,151,1306,1457
2015,8,31,0,18,115,1175,1290
2015,8,31,0,19,119,772,891
2015,8,31,0,20,85,506,591
2015,8,31,0,21,64,311,375
2015,8,31,0,22,29,192,221
2015,8,31,0,23,12,86,98
2015,9,1,1,0,12,33,45
2015,9,1,1,1,1,12,13
2015,9,1,1,2,5,11,16
2015,9,1,1,3,2,7,9
2015,9,1,1,4,1,10,11
2015,9,1,1,5,4,99,103
2015,9,1,1,6,13,349,362
2015,9,1,1,7,27,893,920
2015,9,1,1,8,43,1202,1245
2015,9,1,1,9,79,485,564
2015,9,1,1,10,115,247,362
2015,9,1,1,11,104,298,402
2015,9,1,1,12,121,346,467
2015,9,1,1,13,97,344,441
2015,9,1,1,14,70,274,344
2015,9,1,1,15,91,326,417
2015,9,1,1,16,120,660,780
2015,9,1,1,17,163,1260,1423
2015,9,1,1,18,139,1180,1319
2015,9,1,1,19,94,831,925
2015,9,1,1,20,84,486,570
2015,9,1,1,21,56,317,373
2015,9,1,1,22,37,225,262
2015,9,1,1,23,26,123,149
2015,9,2,2,0,29,42,71
2015,9,2,2,1,7,9,16
2015,9,2,2,2,2,10,12
2015,9,2,2,3,0,2,2
2015,9,2,2,4,3,12,15
2015,9,2,2,5,2,111,113
2015,9,2,2,6,6,358,364
2015,9,2,2,7,19,859,878
2015,9,2,2,8,61,1192,1253
2015,9,2,2,9,63,479,542
2015,9,2,2,10,92,204,296
2015,9,2,2,11,141,295,436
2015,9,2,2,12,120,350,470
2015,9,2,2,13,99,332,431
2015,9,2,2,14,124,275,399
2015,9,2,2,15,103,319,422
2015,9,2,2,16,106,601,707
2015,9,2,2,17,134,1236,1370
2015,9,2,2,18,134,1188,1322
2015,9,2,2,19,117,751,868
2015,9,2,2,20,64,518,582
2015,9,2,2,21,53,336,389
2015,9,2,2,22,35,222,257
2015,9,2,2,23,31,132,163
2015,9,3,3,0,15,44,59
2015,9,3,3,1,4,14,18
2015,9,3,3,2,0,8,8
2015,9,3,3,3,1,2,3
2015,9,3,3,4,1,15,16
2015,9,3,3,5,3,84,87
2015,9,3,3,6,9,333,342
2015,9,3,3,7,19,818,837
2015,9,3,3,8,37,1169,1206
2015,9,3,3,9,79,479,558
2015,9,3,3,10,103,249,352
2015,9,3,3,11,135,273,408
2015,9,3,3,12,136,347,483
2015,9,3,3,13,120,289,409
2015,9,3,3,14,128,268,396
2015,9,3,3,15,136,394,530
2015,9,3,3,16,144,579,723
2015,9,3,3,17,142,1196,1338
2015,9,3,3,18,126,1008,1134
2015,9,3,3,19,111,728,839
2015,9,3,3,20,67,471,538
2015,9,3,3,21,86,314,400
2015,9,3,3,22,46,237,283
2015,9,3,3,23,22,142,164
2015,9,4,4,0,8,58,66
2015,9,4,4,1,12,32,44
2015,9,4,4,2,1,16,17
2015,9,4,4,3,2,8,10
2015,9,4,4,4,1,8,9
2015,9,4,4,5,2,68,70
2015,9,4,4,6,8,244,252
2015,9,4,4,7,33,675,708
2015,9,4,4,8,40,1015,1055
2015,9,4,4,9,84,494,578
2015,9,4,4,10,142,290,432
2015,9,4,4,11,156,300,456
2015,9,4,4,12,168,394,562
2015,9,4,4,13,175,408,583
2015,9,4,4,14,182,487,669
2015,9,4,4,15,210,662,872
2015,9,4,4,16,216,797,1013
2015,9,4,4,17,159,833,992
2015,9,4,4,18,161,695,856
2015,9,4,4,19,111,439,550
2015,9,4,4,20,76,301,377
2015,9,4,4,21,113,251,364
2015,9,4,4,22,70,230,300
2015,9,4,4,23,57,158,215
2015,9,5,5,0,27,121,148
2015,9,5,5,1,17,84,101
2015,9,5,5,2,17,54,71
2015,9,5,5,3,3,27,30
2015,9,5,5,4,2,11,13
2015,9,5,5,5,3,14,17
2015,9,5,5,6,7,42,49
2015,9,5,5,7,19,105,124
2015,9,5,5,8,51,182,233
2015,9,5,5,9,144,282,426
2015,9,5,5,10,237,367,604
2015,9,5,5,11,319,448,767
2015,9,5,5,12,409,398,807
2015,9,5,5,13,459,468,927
2015,9,5,5,14,552,381,933
2015,9,5,5,15,505,392,897
2015,9,5,5,16,491,328,819
2015,9,5,5,17,453,384,837
2015,9,5,5,18,462,420,882
2015,9,5,5,19,344,359,703
2015,9,5,5,20,245,259,504
2015,9,5,5,21,201,194,395
2015,9,5,5,22,142,154,296
2015,9,5,5,23,151,133,284
2015,9,6,6,0,83,89,172
2015,9,6,6,1,48,80,128
2015,9,6,6,2,26,41,67
2015,9,6,6,3,8,20,28
2015,9,6,6,4,9,7,16
2015,9,6,6,5,1,16,17
2015,9,6,6,6,15,20,35
2015,9,6,6,7,40,51,91
2015,9,6,6,8,69,155,224
2015,9,6,6,9,256,292,548
2015,9,6,6,10,447,379,826
2015,9,6,6,11,518,420,938
2015,9,6,6,12,561,455,1016
2015,9,6,6,13,596,396,992
2015,9,6,6,14,614,382,996
2015,9,6,6,15,596,353,949
2015,9,6,6,16,634,416,1050
2015,9,6,6,17,564,422,986
2015,9,6,6,18,531,382,913
2015,9,6,6,19,420,339,759
2015,9,6,6,20,329,226,555
2015,9,6,6,21,280,186,466
2015,9,6,6,22,210,174,384
2015,9,6,6,23,115,129,244
2015,9,7,0,0,79,71,150
2015,9,7,0,1,42,67,109
2015,9,7,0,2,14,47,61
2015,9,7,0,3,6,16,22
2015,9,7,0,4,1,10,11
2015,9,7,0,5,3,15,18
2015,9,7,0,6,14,31,45
2015,9,7,0,7,40,93,133
2015,9,7,0,8,127,171,298
2015,9,7,0,9,197,313,510
2015,9,7,0,10,381,394,775
2015,9,7,0,11,442,497,939
2015,9,7,0,12,457,495,952
2015,9,7,0,13,391,454,845
2015,9,7,0,14,319,443,762
2015,9,7,0,15,354,444,798
2015,9,7,0,16,347,514,861
2015,9,7,0,17,296,446,742
2015,9,7,0,18,267,447,714
2015,9,7,0,19,203,384,587
2015,9,7,0,20,134,250,384
2015,9,7,0,21,93,210,303
2015,9,7,0,22,72,142,214
2015,9,7,0,23,16,102,118
2015,9,8,1,0,5,33,38
2015,9,8,1,1,6,7,13
2015,9,8,1,2,0,6,6
2015,9,8,1,3,1,0,1
2015,9,8,1,4,2,10,12
2015,9,8,1,5,2,87,89
2015,9,8,1,6,8,328,336
2015,9,8,1,7,23,896,919
2015,9,8,1,8,51,1072,1123
2015,9,8,1,9,69,420,489
2015,9,8,1,10,92,200,292
2015,9,8,1,11,116,208,324
2015,9,8,1,12,100,332,432
2015,9,8,1,13,129,290,419
2015,9,8,1,14,96,292,388
2015,9,8,1,15,95,338,433
2015,9,8,1,16,113,622,735
2015,9,8,1,17,121,1298,1419
2015,9,8,1,18,104,1182,1286
2015,9,8,1,19,76,762,838
2015,9,8,1,20,55,487,542
2015,9,8,1,21,42,326,368
2015,9,8,1,22,49,264,313
2015,9,8,1,23,26,124,150
2015,9,9,2,0,12,36,48
2015,9,9,2,1,6,14,20
2015,9,9,2,2,2,6,8
2015,9,9,2,3,3,2,5
2015,9,9,2,4,0,14,14
2015,9,9,2,5,3,112,115
2015,9,9,2,6,8,383,391
2015,9,9,2,7,25,945,970
2015,9,9,2,8,47,1145,1192
2015,9,9,2,9,79,524,603
2015,9,9,2,10,82,204,286
2015,9,9,2,11,69,217,286
2015,9,9,2,12,82,302,384
2015,9,9,2,13,101,292,393
2015,9,9,2,14,107,267,374
2015,9,9,2,15,89,324,413
2015,9,9,2,16,135,582,717
2015,9,9,2,17,137,1249,1386
2015,9,9,2,18,122,1163,1285
2015,9,9,2,19,81,738,819
2015,9,9,2,20,40,451,491
2015,9,9,2,21,48,351,399
2015,9,9,2,22,51,276,327
2015,9,9,2,23,23,116,139
2015,9,10,3,0,3,48,51
2015,9,10,3,1,2,13,15
2015,9,10,3,2,1,4,5
2015,9,10,3,3,1,1,2
2015,9,10,3,4,1,1,2
2015,9,10,3,5,2,64,66
2015,9,10,3,6,10,303,313
2015,9,10,3,7,26,864,890
2015,9,10,3,8,40,1114,1154
2015,9,10,3,9,50,458,508
2015,9,10,3,10,59,232,291
2015,9,10,3,11,66,248,314
2015,9,10,3,12,85,293,378
2015,9,10,3,13,85,297,382
2015,9,10,3,14,76,210,286
2015,9,10,3,15,70,296,366
2015,9,10,3,16,84,579,663
2015,9,10,3,17,118,1173,1291
2015,9,10,3,18,94,1134,1228
2015,9,10,3,19,72,703,775
2015,9,10,3,20,48,495,543
2015,9,10,3,21,51,342,393
2015,9,10,3,22,16,233,249
2015,9,10,3,23,18,173,191
2015,9,11,4,0,10,56,66
2015,9,11,4,1,11,25,36
2015,9,11,4,2,2,12,14
2015,9,11,4,3,0,4,4
2015,9,11,4,4,1,10,11
2015,9,11,4,5,0,83,83
2015,9,11,4,6,6,294,300
2015,9,11,4,7,17,853,870
2015,9,11,4,8,58,1136,1194
2015,9,11,4,9,65,504,569
2015,9,11,4,10,118,284,402
2015,9,11,4,11,156,323,479
2015,9,11,4,12,162,444,606
2015,9,11,4,13,172,385,557
2015,9,11,4,14,179,321,500
2015,9,11,4,15,171,450,621
2015,9,11,4,16,175,703,878
2015,9,11,4,17,169,1270,1439
2015,9,11,4,18,155,1066,1221
2015,9,11,4,19,164,720,884
2015,9,11,4,20,97,434,531
2015,9,11,4,21,69,285,354
2015,9,11,4,22,75,241,316
2015,9,11,4,23,53,179,232
2015,9,12,5,0,37,117,154
2015,9,12,5,1,32,85,117
2015,9,12,5,2,14,61,75
2015,9,12,5,3,5,32,37
2015,9,12,5,4,2,6,8
2015,9,12,5,5,4,8,12
2015,9,12,5,6,13,45,58
2015,9,12,5,7,15,111,126
2015,9,12,5,8,8,146,154
2015,9,12,5,9,31,178,209
2015,9,12,5,10,32,232,264
2015,9,12,5,11,74,333,407
2015,9,12,5,12,80,347,427
2015,9,12,5,13,48,186,234
2015,9,12,5,14,85,337,422
2015,9,12,5,15,110,389,499
2015,9,12,5,16,122,375,497
2015,9,12,5,17,148,502,650
2015,9,12,5,18,136,450,586
2015,9,12,5,19,130,387,517
2015,9,12,5,20,104,305,409
2015,9,12,5,21,69,244,313
2015,9,12,5,22,75,211,286
2015,9,12,5,23,43,161,204
2015,9,13,6,0,31,138,169
2015,9,13,6,1,28,92,120
2015,9,13,6,2,36,68,104
2015,9,13,6,3,13,35,48
2015,9,13,6,4,5,15,20
2015,9,13,6,5,15,31,46
2015,9,13,6,6,9,42,51
2015,9,13,6,7,15,93,108
2015,9,13,6,8,38,185,223
2015,9,13,6,9,124,318,442
2015,9,13,6,10,164,481,645
2015,9,13,6,11,254,535,789
2015,9,13,6,12,265,669,934
2015,9,13,6,13,275,602,877
2015,9,13,6,14,296,565,861
2015,9,13,6,15,339,519,858
2015,9,13,6,16,339,639,978
2015,9,13,6,17,260,572,832
2015,9,13,6,18,265,559,824
2015,9,13,6,19,142,430,572
2015,9,13,6,20,97,314,411
2015,9,13,6,21,54,181,235
2015,9,13,6,22,40,131,171
2015,9,13,6,23,23,56,79
2015,9,14,0,0,10,36,46
2015,9,14,0,1,2,15,17
2015,9,14,0,2,1,7,8
2015,9,14,0,3,2,3,5
2015,9,14,0,4,1,11,12
2015,9,14,0,5,2,82,84
2015,9,14,0,6,12,303,315
2015,9,14,0,7,9,858,867
2015,9,14,0,8,38,1036,1074
2015,9,14,0,9,60,448,508
2015,9,14,0,10,79,206,285
2015,9,14,0,11,117,249,366
2015,9,14,0,12,108,328,436
2015,9,14,0,13,151,310,461
2015,9,14,0,14,143,332,475
2015,9,14,0,15,136,362,498
2015,9,14,0,16,132,656,788
2015,9,14,0,17,172,1341,1513
2015,9,14,0,18,161,1250,1411
2015,9,14,0,19,98,761,859
2015,9,14,0,20,47,408,455
2015,9,14,0,21,62,294,356
2015,9,14,0,22,33,175,208
2015,9,14,0,23,16,93,109
2015,9,15,1,0,5,33,38
2015,9,15,1,1,9,6,15
2015,9,15,1,2,3,2,5
2015,9,15,1,3,4,1,5
2015,9,15,1,4,0,15,15
2015,9,15,1,5,1,83,84
2015,9,15,1,6,9,362,371
2015,9,15,1,7,29,961,990
2015,9,15,1,8,40,1239,1279
2015,9,15,1,9,58,455,513
2015,9,15,1,10,45,240,285
2015,9,15,1,11,120,256,376
2015,9,15,1,12,97,374,471
2015,9,15,1,13,103,354,457
2015,9,15,1,14,92,302,394
2015,9,15,1,15,94,367,461
2015,9,15,1,16,150,677,827
2015,9,15,1,17,178,1323,1501
2015,9,15,1,18,151,1318,1469
2015,9,15,1,19,120,812,932
2015,9,15,1,20,99,504,603
2015,9,15,1,21,67,372,439
2015,9,15,1,22,41,224,265
2015,9,15,1,23,25,123,148
2015,9,16,2,0,9,56,65
2015,9,16,2,1,7,15,22
2015,9,16,2,2,0,4,4
2015,9,16,2,3,2,4,6
2015,9,16,2,4,3,10,13
2015,9,16,2,5,4,111,115
2015,9,16,2,6,17,385,402
2015,9,16,2,7,26,954,980
2015,9,16,2,8,42,1223,1265
2015,9,16,2,9,42,485,527
2015,9,16,2,10,78,243,321
2015,9,16,2,11,114,293,407
2015,9,16,2,12,126,343,469
2015,9,16,2,13,103,341,444
2015,9,16,2,14,112,296,408
2015,9,16,2,15,106,394,500
2015,9,16,2,16,132,683,815
2015,9,16,2,17,183,1318,1501
2015,9,16,2,18,122,1266,1388
2015,9,16,2,19,116,837,953
2015,9,16,2,20,60,483,543
2015,9,16,2,21,34,340,374
2015,9,16,2,22,28,211,239
2015,9,16,2,23,19,158,177
2015,9,17,3,0,9,55,64
2015,9,17,3,1,7,25,32
2015,9,17,3,2,5,10,15
2015,9,17,3,3,1,3,4
2015,9,17,3,4,0,9,9
2015,9,17,3,5,3,88,91
2015,9,17,3,6,8,327,335
2015,9,17,3,7,30,881,911
2015,9,17,3,8,47,1228,1275
2015,9,17,3,9,50,499,549
2015,9,17,3,10,85,251,336
2015,9,17,3,11,102,270,372
2015,9,17,3,12,102,369,471
2015,9,17,3,13,123,363,486
2015,9,17,3,14,116,305,421
2015,9,17,3,15,139,389,528
2015,9,17,3,16,164,643,807
2015,9,17,3,17,139,1341,1480
2015,9,17,3,18,152,1224,1376
2015,9,17,3,19,84,793,877
2015,9,17,3,20,75,510,585
2015,9,17,3,21,53,363,416
2015,9,17,3,22,44,288,332
2015,9,17,3,23,23,154,177
2015,9,18,4,0,11,52,63
2015,9,18,4,1,6,34,40
2015,9,18,4,2,3,17,20
2015,9,18,4,3,2,5,7
2015,9,18,4,4,0,8,8
2015,9,18,4,5,2,88,90
2015,9,18,4,6,6,289,295
2015,9,18,4,7,21,757,778
2015,9,18,4,8,50,1213,1263
2015,9,18,4,9,56,492,548
2015,9,18,4,10,113,298,411
2015,9,18,4,11,115,326,441
2015,9,18,4,12,152,415,567
2015,9,18,4,13,131,413,544
2015,9,18,4,14,157,399,556
2015,9,18,4,15,141,469,610
2015,9,18,4,16,149,759,908
2015,9,18,4,17,171,1249,1420
2015,9,18,4,18,126,1027,1153
2015,9,18,4,19,130,639,769
2015,9,18,4,20,88,407,495
2015,9,18,4,21,57,320,377
2015,9,18,4,22,76,300,376
2015,9,18,4,23,46,171,217
2015,9,19,5,0,48,161,209
2015,9,19,5,1,11,119,130
2015,9,19,5,2,13,75,88
2015,9,19,5,3,6,18,24
2015,9,19,5,4,4,14,18
2015,9,19,5,5,6,16,22
2015,9,19,5,6,11,27,38
2015,9,19,5,7,25,123,148
2015,9,19,5,8,54,259,313
2015,9,19,5,9,145,403,548
2015,9,19,5,10,237,495,732
2015,9,19,5,11,267,560,827
2015,9,19,5,12,339,572,911
2015,9,19,5,13,304,572,876
2015,9,19,5,14,331,524,855
2015,9,19,5,15,369,558,927
2015,9,19,5,16,311,524,835
2015,9,19,5,17,372,497,869
2015,9,19,5,18,332,562,894
2015,9,19,5,19,276,499,775
2015,9,19,5,20,164,300,464
2015,9,19,5,21,144,301,445
2015,9,19,5,22,104,234,338
2015,9,19,5,23,98,196,294
2015,9,20,6,0,54,150,204
2015,9,20,6,1,30,97,127
2015,9,20,6,2,14,86,100
2015,9,20,6,3,11,47,58
2015,9,20,6,4,3,19,22
2015,9,20,6,5,6,19,25
2015,9,20,6,6,19,88,107
2015,9,20,6,7,39,109,148
2015,9,20,6,8,91,228,319
2015,9,20,6,9,165,330,495
2015,9,20,6,10,225,473,698
2015,9,20,6,11,292,528,820
2015,9,20,6,12,327,690,1017
2015,9,20,6,13,342,543,885
2015,9,20,6,14,335,542,877
2015,9,20,6,15,333,566,899
2015,9,20,6,16,334,663,997
2015,9,20,6,17,275,516,791
2015,9,20,6,18,235,524,759
2015,9,20,6,19,176,470,646
2015,9,20,6,20,143,298,441
2015,9,20,6,21,71,194,265
2015,9,20,6,22,57,139,196
2015,9,20,6,23,27,75,102
2015,9,21,0,0,22,35,57
2015,9,21,0,1,1,10,11
2015,9,21,0,2,1,12,13
2015,9,21,0,3,0,2,2
2015,9,21,0,4,2,8,10
2015,9,21,0,5,4,89,93
2015,9,21,0,6,14,308,322
2015,9,21,0,7,20,914,934
2015,9,21,0,8,62,1060,1122
2015,9,21,0,9,100,459,559
2015,9,21,0,10,97,205,302
2015,9,21,0,11,137,221,358
2015,9,21,0,12,160,310,470
2015,9,21,0,13,133,288,421
2015,9,21,0,14,150,227,377
2015,9,21,0,15,139,359,498
2015,9,21,0,16,128,466,594
2015,9,21,0,17,60,446,506
2015,9,21,0,18,20,351,371
2015,9,21,0,19,14,255,269
2015,9,21,0,20,18,155,173
2015,9,21,0,21,13,189,202
2015,9,21,0,22,10,89,99
2015,9,21,0,23,9,44,53
2015,9,22,1,0,4,30,34
2015,9,22,1,1,4,15,19
2015,9,22,1,2,2,9,11
2015,9,22,1,3,1,2,3
2015,9,22,1,4,1,6,7
2015,9,22,1,5,4,81,85
2015,9,22,1,6,8,316,324
2015,9,22,1,7,30,904,934
2015,9,22,1,8,51,1089,1140
2015,9,22,1,9,52,407,459
2015,9,22,1,10,96,224,320
2015,9,22,1,11,94,253,347
2015,9,22,1,12,137,341,478
2015,9,22,1,13,109,352,461
2015,9,22,1,14,115,312,427
2015,9,22,1,15,143,393,536
2015,9,22,1,16,190,688,878
2015,9,22,1,17,214,1325,1539
2015,9,22,1,18,177,1272,1449
2015,9,22,1,19,149,861,1010
2015,9,22,1,20,75,490,565
2015,9,22,1,21,65,419,484
2015,9,22,1,22,35,266,301
2015,9,22,1,23,27,114,141
2015,9,23,2,0,25,56,81
2015,9,23,2,1,4,14,18
2015,9,23,2,2,2,10,12
2015,9,23,2,3,12,14,26
2015,9,23,2,4,7,31,38
2015,9,23,2,5,15,147,162
2015,9,23,2,6,30,340,370
2015,9,23,2,7,58,767,825
2015,9,23,2,8,74,900,974
2015,9,23,2,9,75,519,594
2015,9,23,2,10,130,337,467
2015,9,23,2,11,140,399,539
2015,9,23,2,12,221,495,716
2015,9,23,2,13,188,454,642
2015,9,23,2,14,195,387,582
2015,9,23,2,15,185,455,640
2015,9,23,2,16,186,715,901
2015,9,23,2,17,238,1127,1365
2015,9,23,2,18,199,1129,1328
2015,9,23,2,19,130,806,936
2015,9,23,2,20,87,501,588
2015,9,23,2,21,61,386,447
2015,9,23,2,22,60,294,354
2015,9,23,2,23,17,151,168
2015,9,24,3,0,5,52,57
2015,9,24,3,1,8,17,25
2015,9,24,3,2,1,5,6
2015,9,24,3,3,6,11,17
2015,9,24,3,4,13,20,33
2015,9,24,3,5,11,105,116
2015,9,24,3,6,29,316,345
2015,9,24,3,7,43,799,842
2015,9,24,3,8,65,957,1022
2015,9,24,3,9,99,441,540
2015,9,24,3,10,164,277,441
2015,9,24,3,11,182,378,560
2015,9,24,3,12,232,441,673
2015,9,24,3,13,190,437,627
2015,9,24,3,14,176,378,554
2015,9,24,3,15,196,439,635
2015,9,24,3,16,201,605,806
2015,9,24,3,17,188,1167,1355
2015,9,24,3,18,185,1193,1378
2015,9,24,3,19,127,836,963
2015,9,24,3,20,57,509,566
2015,9,24,3,21,79,360,439
2015,9,24,3,22,50,258,308
2015,9,24,3,23,13,193,206
2015,9,25,4,0,15,75,90
2015,9,25,4,1,2,35,37
2015,9,25,4,2,5,17,22
2015,9,25,4,3,0,7,7
2015,9,25,4,4,3,6,9
2015,9,25,4,5,2,81,83
2015,9,25,4,6,10,302,312
2015,9,25,4,7,26,798,824
2015,9,25,4,8,63,1191,1254
2015,9,25,4,9,72,526,598
2015,9,25,4,10,111,267,378
2015,9,25,4,11,129,337,466
2015,9,25,4,12,164,418,582
2015,9,25,4,13,151,389,540
2015,9,25,4,14,188,384,572
2015,9,25,4,15,163,456,619
2015,9,25,4,16,145,574,719
2015,9,25,4,17,165,1167,1332
2015,9,25,4,18,144,890,1034
2015,9,25,4,19,73,581,654
2015,9,25,4,20,64,387,451
2015,9,25,4,21,69,304,373
2015,9,25,4,22,33,210,243
2015,9,25,4,23,17,187,204
2015,9,26,5,0,17,142,159
2015,9,26,5,1,17,99,116
2015,9,26,5,2,4,62,66
2015,9,26,5,3,1,21,22
2015,9,26,5,4,5,9,14
2015,9,26,5,5,1,9,10
2015,9,26,5,6,6,46,52
2015,9,26,5,7,15,123,138
2015,9,26,5,8,50,281,331
2015,9,26,5,9,105,446,551
2015,9,26,5,10,189,505,694
2015,9,26,5,11,292,633,925
2015,9,26,5,12,292,614,906
2015,9,26,5,13,416,591,1007
2015,9,26,5,14,422,629,1051
2015,9,26,5,15,358,627,985
2015,9,26,5,16,324,509,833
2015,9,26,5,17,355,548,903
2015,9,26,5,18,223,414,637
2015,9,26,5,19,150,336,486
2015,9,26,5,20,95,217,312
2015,9,26,5,21,53,211,264
2015,9,26,5,22,64,259,323
2015,9,26,5,23,55,198,253
2015,9,27,6,0,39,150,189
2015,9,27,6,1,23,108,131
2015,9,27,6,2,15,71,86
2015,9,27,6,3,8,42,50
2015,9,27,6,4,2,8,10
2015,9,27,6,5,7,11,18
2015,9,27,6,6,7,18,25
2015,9,27,6,7,10,61,71
2015,9,27,6,8,42,166,208
2015,9,27,6,9,119,304,423
2015,9,27,6,10,198,434,632
2015,9,27,6,11,255,553,808
2015,9,27,6,12,342,633,975
2015,9,27,6,13,340,625,965
2015,9,27,6,14,256,548,804
2015,9,27,6,15,303,550,853
2015,9,27,6,16,207,566,773
2015,9,27,6,17,200,484,684
2015,9,27,6,18,165,517,682
2015,9,27,6,19,115,388,503
2015,9,27,6,20,76,286,362
2015,9,27,6,21,79,228,307
2015,9,27,6,22,58,242,300
2015,9,27,6,23,26,94,120
2015,9,28,0,0,8,31,39
2015,9,28,0,1,3,10,13
2015,9,28,0,2,0,8,8
2015,9,28,0,3,4,2,6
2015,9,28,0,4,3,4,7
2015,9,28,0,5,2,84,86
2015,9,28,0,6,5,288,293
2015,9,28,0,7,23,811,834
2015,9,28,0,8,39,1184,1223
2015,9,28,0,9,67,474,541
2015,9,28,0,10,107,194,301
2015,9,28,0,11,100,282,382
2015,9,28,0,12,101,362,463
2015,9,28,0,13,150,325,475
2015,9,28,0,14,127,334,461
2015,9,28,0,15,128,370,498
2015,9,28,0,16,154,645,799
2015,9,28,0,17,178,1328,1506
2015,9,28,0,18,138,1174,1312
2015,9,28,0,19,96,736,832
2015,9,28,0,20,34,428,462
2015,9,28,0,21,53,349,402
2015,9,28,0,22,34,212,246
2015,9,28,0,23,15,101,116
2015,9,29,1,0,10,32,42
2015,9,29,1,1,5,11,16
2015,9,29,1,2,1,7,8
2015,9,29,1,3,0,8,8
2015,9,29,1,4,2,6,8
2015,9,29,1,5,3,99,102
2015,9,29,1,6,4,341,345
2015,9,29,1,7,29,974,1003
2015,9,29,1,8,43,1233,1276
2015,9,29,1,9,60,498,558
2015,9,29,1,10,78,219,297
2015,9,29,1,11,123,244,367
2015,9,29,1,12,113,333,446
2015,9,29,1,13,110,291,401
2015,9,29,1,14,108,277,385
2015,9,29,1,15,93,282,375
2015,9,29,1,16,61,486,547
2015,9,29,1,17,46,393,439
2015,9,29,1,18,20,218,238
2015,9,29,1,19,10,129,139
2015,9,29,1,20,6,62,68
2015,9,29,1,21,1,47,48
2015,9,29,1,22,2,50,52
2015,9,29,1,23,2,70,72
2015,9,30,2,0,5,23,28
2015,9,30,2,1,2,15,17
2015,9,30,2,2,0,7,7
2015,9,30,2,3,0,5,5
2015,9,30,2,4,0,9,9
2015,9,30,2,5,2,91,93
2015,9,30,2,6,16,291,307
2015,9,30,2,7,16,694,710
2015,9,30,2,8,29,1099,1128
2015,9,30,2,9,52,431,483
2015,9,30,2,10,38,189,227
2015,9,30,2,11,61,175,236
2015,9,30,2,12,85,285,370
2015,9,30,2,13,58,269,327
2015,9,30,2,14,66,243,309
2015,9,30,2,15,103,367,470
2015,9,30,2,16,92,579,671
2015,9,30,2,17,124,1177,1301
2015,9,30,2,18,106,1174,1280
2015,9,30,2,19,69,746,815
2015,9,30,2,20,51,518,569
2015,9,30,2,21,36,388,424
2015,9,30,2,22,19,233,252
2015,9,30,2,23,17,129,146
2016,1,1,4,0,9,47,56
2016,1,1,4,1,12,93,105
2016,1,1,4,2,15,59,74
2016,1,1,4,3,5,27,32
2016,1,1,4,4,5,8,13
2016,1,1,4,5,2,3,5
2016,1,1,4,6,1,9,10
2016,1,1,4,7,3,11,14
2016,1,1,4,8,9,45,54
2016,1,1,4,9,31,70,101
2016,1,1,4,10,40,80,120
2016,1,1,4,11,95,144,239
2016,1,1,4,12,89,143,232
2016,1,1,4,13,106,189,295
2016,1,1,4,14,125,199,324
2016,1,1,4,15,124,214,338
2016,1,1,4,16,125,217,342
2016,1,1,4,17,77,170,247
2016,1,1,4,18,37,148,185
2016,1,1,4,19,34,126,160
2016,1,1,4,20,18,72,90
2016,1,1,4,21,20,55,75
2016,1,1,4,22,10,60,70
2016,1,1,4,23,7,32,39
2016,1,2,5,0,7,30,37
2016,1,2,5,1,12,19,31
2016,1,2,5,2,1,16,17
2016,1,2,5,3,4,19,23
2016,1,2,5,4,3,1,4
2016,1,2,5,5,0,7,7
2016,1,2,5,6,0,10,10
2016,1,2,5,7,7,27,34
2016,1,2,5,8,14,66,80
2016,1,2,5,9,41,162,203
2016,1,2,5,10,75,199,274
2016,1,2,5,11,131,269,400
2016,1,2,5,12,178,322,500
2016,1,2,5,13,187,303,490
2016,1,2,5,14,197,298,495
2016,1,2,5,15,198,327,525
2016,1,2,5,16,201,328,529
2016,1,2,5,17,129,263,392
2016,1,2,5,18,39,193,232
2016,1,2,5,19,25,163,188
2016,1,2,5,20,30,120,150
2016,1,2,5,21,18,96,114
2016,1,2,5,22,7,84,91
2016,1,2,5,23,18,78,96
2016,1,3,6,0,14,45,59
2016,1,3,6,1,6,36,42
2016,1,3,6,2,7,32,39
2016,1,3,6,3,6,9,15
2016,1,3,6,4,1,5,6
2016,1,3,6,5,1,8,9
2016,1,3,6,6,0,5,5
2016,1,3,6,7,1,32,33
2016,1,3,6,8,12,75,87
2016,1,3,6,9,31,137,168
2016,1,3,6,10,78,230,308
2016,1,3,6,11,109,304,413
2016,1,3,6,12,124,379,503
2016,1,3,6,13,176,342,518
2016,1,3,6,14,189,335,524
2016,1,3,6,15,171,375,546
2016,1,3,6,16,147,432,579
2016,1,3,6,17,91,307,398
2016,1,3,6,18,23,214,237
2016,1,3,6,19,25,147,172
2016,1,3,6,20,10,105,115
2016,1,3,6,21,10,86,96
2016,1,3,6,22,7,57,64
2016,1,3,6,23,3,25,28
2016,1,4,0,0,2,18,20
2016,1,4,0,1,2,4,6
2016,1,4,0,2,0,2,2
2016,1,4,0,3,0,1,1
2016,1,4,0,4,0,3,3
2016,1,4,0,5,1,57,58
2016,1,4,0,6,2,190,192
2016,1,4,0,7,3,465,468
2016,1,4,0,8,7,752,759
2016,1,4,0,9,11,310,321
2016,1,4,0,10,39,106,145
2016,1,4,0,11,30,122,152
2016,1,4,0,12,32,167,199
2016,1,4,0,13,27,176,203
2016,1,4,0,14,19,126,145
2016,1,4,0,15,31,175,206
2016,1,4,0,16,24,341,365
2016,1,4,0,17,18,682,700
2016,1,4,0,18,7,540,547
2016,1,4,0,19,9,284,293
2016,1,4,0,20,1,145,146
2016,1,4,0,21,3,93,96
2016,1,4,0,22,4,58,62
2016,1,4,0,23,2,42,44
2016,1,5,1,0,0,5,5
2016,1,5,1,1,2,3,5
2016,1,5,1,2,2,1,3
2016,1,5,1,3,0,1,1
2016,1,5,1,4,0,2,2
2016,1,5,1,5,0,42,42
2016,1,5,1,6,0,131,131
2016,1,5,1,7,2,361,363
2016,1,5,1,8,12,671,683
2016,1,5,1,9,14,315,329
2016,1,5,1,10,19,127,146
2016,1,5,1,11,18,125,143
2016,1,5,1,12,18,133,151
2016,1,5,1,13,30,163,193
2016,1,5,1,14,25,150,175
2016,1,5,1,15,28,180,208
2016,1,5,1,16,23,342,365
2016,1,5,1,17,23,653,676
2016,1,5,1,18,6,513,519
2016,1,5,1,19,1,278,279
2016,1,5,1,20,3,175,178
2016,1,5,1,21,2,120,122
2016,1,5,1,22,10,76,86
2016,1,5,1,23,11,34,45
2016,1,6,2,0,0,10,10
2016,1,6,2,1,0,1,1
2016,1,6,2,2,0,2,2
2016,1,6,2,4,0,1,1
2016,1,6,2,5,0,57,57
2016,1,6,2,6,1,173,174
2016,1,6,2,7,1,418,419
2016,1,6,2,8,4,795,799
2016,1,6,2,9,7,384,391
2016,1,6,2,10,17,139,156
2016,1,6,2,11,13,136,149
2016,1,6,2,12,17,188,205
2016,1,6,2,13,29,188,217
2016,1,6,2,14,38,140,178
2016,1,6,2,15,30,191,221
2016,1,6,2,16,27,365,392
2016,1,6,2,17,24,746,770
2016,1,6,2,18,6,639,645
2016,1,6,2,19,6,369,375
2016,1,6,2,20,9,226,235
2016,1,6,2,21,8,159,167
2016,1,6,2,22,11,89,100
2016,1,6,2,23,5,43,48
2016,1,7,3,0,6,15,21
2016,1,7,3,1,0,9,9
2016,1,7,3,2,0,4,4
2016,1,7,3,4,0,2,2
2016,1,7,3,5,0,51,51
2016,1,7,3,6,0,185,185
2016,1,7,3,7,3,508,511
2016,1,7,3,8,17,924,941
2016,1,7,3,9,8,420,428
2016,1,7,3,10,27,157,184
2016,1,7,3,11,25,172,197
2016,1,7,3,12,33,225,258
2016,1,7,3,13,32,221,253
2016,1,7,3,14,36,170,206
2016,1,7,3,15,31,252,283
2016,1,7,3,16,36,393,429
2016,1,7,3,17,29,796,825
2016,1,7,3,18,31,701,732
2016,1,7,3,19,18,413,431
2016,1,7,3,20,12,255,267
2016,1,7,3,21,17,194,211
2016,1,7,3,22,8,92,100
2016,1,7,3,23,2,62,64
2016,1,8,4,0,0,17,17
2016,1,8,4,1,1,13,14
2016,1,8,4,2,0,6,6
2016,1,8,4,3,1,4,5
2016,1,8,4,4,0,2,2
2016,1,8,4,5,1,46,47
2016,1,8,4,6,0,169,169
2016,1,8,4,7,3,470,473
2016,1,8,4,8,9,894,903
2016,1,8,4,9,19,424,443
2016,1,8,4,10,12,155,167
2016,1,8,4,11,15,178,193
2016,1,8,4,12,48,217,265
2016,1,8,4,13,22,236,258
2016,1,8,4,14,27,226,253
2016,1,8,4,15,43,230,273
2016,1,8,4,16,30,369,399
2016,1,8,4,17,33,657,690
2016,1,8,4,18,24,583,607
2016,1,8,4,19,18,314,332
2016,1,8,4,20,9,211,220
2016,1,8,4,21,17,161,178
2016,1,8,4,22,13,124,137
2016,1,8,4,23,2,100,102
2016,1,9,5,0,3,93,96
2016,1,9,5,1,1,53,54
2016,1,9,5,2,0,37,37
2016,1,9,5,3,1,19,20
2016,1,9,5,4,1,7,8
2016,1,9,5,5,0,5,5
2016,1,9,5,6,0,10,10
2016,1,9,5,7,2,81,83
2016,1,9,5,8,7,134,141
2016,1,9,5,9,11,217,228
2016,1,9,5,10,39,294,333
2016,1,9,5,11,41,357,398
2016,1,9,5,12,70,413,483
2016,1,9,5,13,89,387,476
2016,1,9,5,14,87,355,442
2016,1,9,5,15,99,408,507
2016,1,9,5,16,90,395,485
2016,1,9,5,17,88,349,437
2016,1,9,5,18,60,292,352
2016,1,9,5,19,27,255,282
2016,1,9,5,20,29,191,220
2016,1,9,5,21,16,122,138
2016,1,9,5,22,1,34,35
2016,1,9,5,23,3,41,44
2016,1,10,6,0,0,36,36
2016,1,10,6,1,0,24,24
2016,1,10,6,2,2,24,26
2016,1,10,6,3,2,6,8
2016,1,10,6,4,0,2,2
2016,1,10,6,5,0,4,4
2016,1,10,6,6,2,13,15
2016,1,10,6,7,5,28,33
2016,1,10,6,8,15,91,106
2016,1,10,6,9,20,187,207
2016,1,10,6,10,47,295,342
2016,1,10,6,11,76,395,471
2016,1,10,6,12,129,526,655
2016,1,10,6,13,140,526,666
2016,1,10,6,14,141,526,667
2016,1,10,6,15,128,501,629
2016,1,10,6,16,95,409,504
2016,1,10,6,17,63,316,379
2016,1,10,6,18,26,257,283
2016,1,10,6,19,25,161,186
2016,1,10,6,20,18,173,191
2016,1,10,6,21,9,108,117
2016,1,10,6,22,11,69,80
2016,1,10,6,23,2,30,32
2016,1,11,0,0,5,15,20
2016,1,11,0,1,0,4,4
2016,1,11,0,2,0,4,4
2016,1,11,0,3,0,3,3
2016,1,11,0,4,0,5,5
2016,1,11,0,5,0,49,49
2016,1,11,0,6,4,192,196
2016,1,11,0,7,13,463,476
2016,1,11,0,8,16,814,830
2016,1,11,0,9,15,378,393
2016,1,11,0,10,22,143,165
2016,1,11,0,11,25,153,178
2016,1,11,0,12,44,213,257
2016,1,11,0,13,41,192,233
2016,1,11,0,14,30,199,229
2016,1,11,0,15,50,208,258
2016,1,11,0,16,39,398,437
2016,1,11,0,17,46,780,826
2016,1,11,0,18,22,659,681
2016,1,11,0,19,18,433,451
2016,1,11,0,20,12,263,275
2016,1,11,0,21,12,150,162
2016,1,11,0,22,5,100,105
2016,1,11,0,23,9,48,57
2016,1,12,1,0,5,29,34
2016,1,12,1,1,1,8,9
2016,1,12,1,2,0,4,4
2016,1,12,1,3,0,1,1
2016,1,12,1,4,0,4,4
2016,1,12,1,5,0,55,55
2016,1,12,1,6,3,212,215
2016,1,12,1,7,17,536,553
2016,1,12,1,8,20,924,944
2016,1,12,1,9,14,397,411
2016,1,12,1,10,20,136,156
2016,1,12,1,11,26,167,193
2016,1,12,1,12,37,219,256
2016,1,12,1,13,28,192,220
2016,1,12,1,14,30,166,196
2016,1,12,1,15,41,230,271
2016,1,12,1,16,29,420,449
2016,1,12,1,17,39,815,854
2016,1,12,1,18,39,739,778
2016,1,12,1,19,17,332,349
2016,1,12,1,20,6,226,232
2016,1,12,1,21,8,132,140
2016,1,12,1,22,4,92,96
2016,1,12,1,23,3,67,70
2016,1,13,2,0,3,11,14
2016,1,13,2,1,1,6,7
2016,1,13,2,2,0,3,3
2016,1,13,2,4,0,6,6
2016,1,13,2,5,1,52,53
2016,1,13,2,6,2,177,179
2016,1,13,2,7,17,438,455
2016,1,13,2,8,12,799,811
2016,1,13,2,9,18,379,397
2016,1,13,2,10,23,151,174
2016,1,13,2,11,19,153,172
2016,1,13,2,12,23,181,204
2016,1,13,2,13,28,163,191
2016,1,13,2,14,28,142,170
2016,1,13,2,15,23,193,216
2016,1,13,2,16,18,345,363
2016,1,13,2,17,21,675,696
2016,1,13,2,18,10,603,613
2016,1,13,2,19,9,344,353
2016,1,13,2,20,6,212,218
2016,1,13,2,21,6,187,193
2016,1,13,2,22,2,80,82
2016,1,13,2,23,1,49,50
2016,1,14,3,0,5,20,25
2016,1,14,3,1,2,7,9
2016,1,14,3,2,0,4,4
2016,1,14,3,3,0,1,1
2016,1,14,3,4,1,2,3
2016,1,14,3,5,0,49,49
2016,1,14,3,6,1,186,187
2016,1,14,3,7,4,511,515
2016,1,14,3,8,20,862,882
2016,1,14,3,9,24,402,426
2016,1,14,3,10,17,138,155
2016,1,14,3,11,19,175,194
2016,1,14,3,12,50,234,284
2016,1,14,3,13,52,213,265
2016,1,14,3,14,51,190,241
2016,1,14,3,15,41,292,333
2016,1,14,3,16,45,438,483
2016,1,14,3,17,56,881,937
2016,1,14,3,18,20,777,797
2016,1,14,3,19,15,478,493
2016,1,14,3,20,20,362,382
2016,1,14,3,21,19,230,249
2016,1,14,3,22,6,146,152
2016,1,14,3,23,10,88,98
2016,1,15,4,0,6,30,36
2016,1,15,4,1,3,18,21
2016,1,15,4,2,6,10,16
2016,1,15,4,3,1,3,4
2016,1,15,4,4,0,3,3
2016,1,15,4,5,0,52,52
2016,1,15,4,6,1,165,166
2016,1,15,4,7,5,486,491
2016,1,15,4,8,13,964,977
2016,1,15,4,9,19,427,446
2016,1,15,4,10,27,205,232
2016,1,15,4,11,35,237,272
2016,1,15,4,12,44,303,347
2016,1,15,4,13,56,269,325
2016,1,15,4,14,62,272,334
2016,1,15,4,15,67,338,405
2016,1,15,4,16,87,528,615
2016,1,15,4,17,41,634,675
2016,1,15,4,18,13,252,265
2016,1,15,4,19,2,108,110
2016,1,15,4,20,3,72,75
2016,1,15,4,21,4,50,54
2016,1,15,4,22,9,35,44
2016,1,15,4,23,2,16,18
2016,1,16,5,0,0,29,29
2016,1,16,5,1,3,36,39
2016,1,16,5,2,4,24,28
2016,1,16,5,3,2,5,7
2016,1,16,5,4,2,8,10
2016,1,16,5,5,2,5,7
2016,1,16,5,6,5,15,20
2016,1,16,5,7,1,52,53
2016,1,16,5,8,5,144,149
2016,1,16,5,9,27,235,262
2016,1,16,5,10,60,297,357
2016,1,16,5,11,128,379,507
2016,1,16,5,12,165,489,654
2016,1,16,5,13,208,426,634
2016,1,16,5,14,219,408,627
2016,1,16,5,15,189,409,598
2016,1,16,5,16,145,376,521
2016,1,16,5,17,96,279,375
2016,1,16,5,18,64,229,293
2016,1,16,5,19,45,177,222
2016,1,16,5,20,27,155,182
2016,1,16,5,21,14,102,116
2016,1,16,5,22,17,109,126
2016,1,16,5,23,8,84,92
2016,1,17,6,0,16,57,73
2016,1,17,6,1,5,44,49
2016,1,17,6,2,3,52,55
2016,1,17,6,3,12,25,37
2016,1,17,6,4,0,7,7
2016,1,17,6,5,0,6,6
2016,1,17,6,6,5,11,16
2016,1,17,6,7,5,30,35
2016,1,17,6,8,8,73,81
2016,1,17,6,9,24,168,192
2016,1,17,6,10,81,241,322
2016,1,17,6,11,82,254,336
2016,1,17,6,12,62,249,311
2016,1,17,6,13,44,151,195
2016,1,17,6,14,27,130,157
2016,1,17,6,15,35,219,254
2016,1,17,6,16,64,263,327
2016,1,17,6,17,56,186,242
2016,1,17,6,18,27,160,187
2016,1,17,6,19,14,133,147
2016,1,17,6,20,9,124,133
2016,1,17,6,21,19,83,102
2016,1,17,6,22,8,82,90
2016,1,17,6,23,0,46,46
2016,1,18,0,0,2,34,36
2016,1,18,0,1,2,20,22
2016,1,18,0,2,0,9,9
2016,1,18,0,3,0,5,5
2016,1,18,0,4,1,1,2
2016,1,18,0,5,0,20,20
2016,1,18,0,6,5,30,35
2016,1,18,0,7,2,66,68
2016,1,18,0,8,7,121,128
2016,1,18,0,9,10,118,128
2016,1,18,0,10,20,130,150
2016,1,18,0,11,15,186,201
2016,1,18,0,12,17,180,197
2016,1,18,0,13,15,216,231
2016,1,18,0,14,13,173,186
2016,1,18,0,15,7,192,199
2016,1,18,0,16,11,181,192
2016,1,18,0,17,5,216,221
2016,1,18,0,18,4,146,150
2016,1,18,0,19,4,120,124
2016,1,18,0,20,0,79,79
2016,1,18,0,21,0,51,51
2016,1,18,0,22,0,46,46
2016,1,18,0,23,2,17,19
2016,1,19,1,0,0,5,5
2016,1,19,1,1,0,3,3
2016,1,19,1,2,0,1,1
2016,1,19,1,4,0,3,3
2016,1,19,1,5,0,41,41
2016,1,19,1,6,2,114,116
2016,1,19,1,7,4,316,320
2016,1,19,1,8,5,583,588
2016,1,19,1,9,0,310,310
2016,1,19,1,10,2,108,110
2016,1,19,1,11,5,84,89
2016,1,19,1,12,2,126,128
2016,1,19,1,13,4,114,118
2016,1,19,1,14,6,109,115
2016,1,19,1,15,1,140,141
2016,1,19,1,16,6,227,233
2016,1,19,1,17,8,508,516
2016,1,19,1,18,3,446,449
2016,1,19,1,19,3,283,286
2016,1,19,1,20,3,129,132
2016,1,19,1,21,0,126,126
2016,1,19,1,22,1,51,52
2016,1,19,1,23,2,28,30
2016,1,20,2,0,0,12,12
2016,1,20,2,1,0,2,2
2016,1,20,2,2,0,1,1
2016,1,20,2,3,0,1,1
2016,1,20,2,4,1,8,9
2016,1,20,2,5,0,42,42
2016,1,20,2,6,2,154,156
2016,1,20,2,7,2,370,372
2016,1,20,2,8,3,694,697
2016,1,20,2,9,8,324,332
2016,1,20,2,10,2,136,138
2016,1,20,2,11,0,159,159
2016,1,20,2,12,8,167,175
2016,1,20,2,13,5,166,171
2016,1,20,2,14,5,152,157
2016,1,20,2,15,3,185,188
2016,1,20,2,16,6,326,332
2016,1,20,2,17,8,573,581
2016,1,20,2,18,2,422,424
2016,1,20,2,19,1,129,130
2016,1,20,2,20,2,101,103
2016,1,20,2,21,1,64,65
2016,1,20,2,22,3,41,44
2016,1,20,2,23,2,28,30
2016,1,21,3,0,1,9,10
2016,1,21,3,1,1,2,3
2016,1,21,3,4,0,1,1
2016,1,21,3,5,0,29,29
2016,1,21,3,6,0,83,83
2016,1,21,3,7,0,181,181
2016,1,21,3,8,1,404,405
2016,1,21,3,9,1,259,260
2016,1,21,3,10,1,124,125
2016,1,21,3,11,1,129,130
2016,1,21,3,12,8,154,162
2016,1,21,3,13,3,171,174
2016,1,21,3,14,5,166,171
2016,1,21,3,15,3,207,210
2016,1,21,3,16,22,313,335
2016,1,21,3,17,3,560,563
2016,1,21,3,18,2,494,496
2016,1,21,3,19,2,282,284
2016,1,21,3,20,3,267,270
2016,1,21,3,21,7,154,161
2016,1,21,3,22,2,115,117
2016,1,21,3,23,5,53,58
2016,1,22,4,0,3,28,31
2016,1,22,4,1,0,10,10
2016,1,22,4,2,0,17,17
2016,1,22,4,3,1,2,3
2016,1,22,4,4,0,3,3
2016,1,22,4,5,1,41,42
2016,1,22,4,6,1,114,115
2016,1,22,4,7,0,248,248
2016,1,22,4,8,4,529,533
2016,1,22,4,9,4,299,303
2016,1,22,4,10,5,197,202
2016,1,22,4,11,13,334,347
2016,1,22,4,12,14,487,501
2016,1,22,4,13,5,363,368
2016,1,22,4,14,5,121,126
2016,1,22,4,15,2,51,53
2016,1,22,4,16,4,33,37
2016,1,22,4,17,0,30,30
2016,1,22,4,18,0,16,16
2016,1,27,2,15,0,3,3
2016,1,27,2,16,1,37,38
2016,1,27,2,17,0,149,149
2016,1,27,2,18,1,126,127
2016,1,27,2,19,0,75,75
2016,1,27,2,20,0,41,41
2016,1,27,2,21,1,52,53
2016,1,27,2,22,0,29,29
2016,1,27,2,23,0,13,13
2016,1,28,3,1,0,1,1
2016,1,28,3,5,0,13,13
2016,1,28,3,6,0,29,29
2016,1,28,3,7,0,78,78
2016,1,28,3,8,0,173,173
2016,1,28,3,9,3,130,133
2016,1,28,3,10,4,64,68
2016,1,28,3,11,0,70,70
2016,1,28,3,12,2,62,64
2016,1,28,3,13,3,69,72
2016,1,28,3,14,3,69,72
2016,1,28,3,15,3,74,77
2016,1,28,3,16,5,158,163
2016,1,28,3,17,4,305,309
2016,1,28,3,18,4,266,270
2016,1,28,3,19,1,145,146
2016,1,28,3,20,2,101,103
2016,1,28,3,21,1,82,83
2016,1,28,3,22,2,63,65
2016,1,28,3,23,1,32,33
2016,1,29,4,0,0,13,13
2016,1,29,4,1,1,5,6
2016,1,29,4,2,0,5,5
2016,1,29,4,3,0,1,1
2016,1,29,4,4,0,1,1
2016,1,29,4,5,0,21,21
2016,1,29,4,6,0,60,60
2016,1,29,4,7,0,176,176
2016,1,29,4,8,2,356,358
2016,1,29,4,9,4,238,242
2016,1,29,4,10,8,91,99
2016,1,29,4,11,10,105,115
2016,1,29,4,12,8,122,130
2016,1,29,4,13,4,107,111
2016,1,29,4,14,7,94,101
2016,1,29,4,15,10,132,142
2016,1,29,4,16,10,232,242
2016,1,29,4,17,11,355,366
2016,1,29,4,18,4,277,281
2016,1,29,4,19,3,184,187
2016,1,29,4,20,4,111,115
2016,1,29,4,21,2,65,67
2016,1,29,4,22,1,51,52
2016,1,29,4,23,5,46,51
2016,1,30,5,0,1,27,28
2016,1,30,5,1,0,36,36
2016,1,30,5,2,0,15,15
2016,1,30,5,3,0,5,5
2016,1,30,5,4,0,3,3
2016,1,30,5,5,0,3,3
2016,1,30,5,6,0,7,7
2016,1,30,5,7,1,35,36
2016,1,30,5,8,1,80,81
2016,1,30,5,9,4,104,108
2016,1,30,5,10,23,147,170
2016,1,30,5,11,21,175,196
2016,1,30,5,12,30,189,219
2016,1,30,5,13,28,215,243
2016,1,30,5,14,39,204,243
2016,1,30,5,15,45,240,285
2016,1,30,5,16,40,212,252
2016,1,30,5,17,35,191,226
2016,1,30,5,18,13,181,194
2016,1,30,5,19,7,130,137
2016,1,30,5,20,20,91,111
2016,1,30,5,21,2,77,79
2016,1,30,5,22,5,70,75
2016,1,30,5,23,6,64,70
2016,1,31,6,0,2,52,54
2016,1,31,6,1,1,33,34
2016,1,31,6,2,1,25,26
2016,1,31,6,3,3,18,21
2016,1,31,6,4,0,5,5
2016,1,31,6,5,0,2,2
2016,1,31,6,6,0,6,6
2016,1,31,6,7,1,22,23
2016,1,31,6,8,5,67,72
2016,1,31,6,9,13,115,128
2016,1,31,6,10,38,160,198
2016,1,31,6,11,43,225,268
2016,1,31,6,12,51,260,311
2016,1,31,6,13,71,283,354
2016,1,31,6,14,57,321,378
2016,1,31,6,15,91,347,438
2016,1,31,6,16,46,281,327
2016,1,31,6,17,25,259,284
2016,1,31,6,18,8,207,215
2016,1,31,6,19,3,148,151
2016,1,31,6,20,3,124,127
2016,1,31,6,21,8,78,86
2016,1,31,6,22,2,72,74
2016,1,31,6,23,5,24,29
2016,2,1,0,0,8,11,19
2016,2,1,0,1,4,5,9
2016,2,1,0,2,1,3,4
2016,2,1,0,3,1,1,2
2016,2,1,0,4,1,2,3
2016,2,1,0,5,0,57,57
2016,2,1,0,6,0,149,149
2016,2,1,0,7,5,434,439
2016,2,1,0,8,2,665,667
2016,2,1,0,9,7,310,317
2016,2,1,0,10,27,124,151
2016,2,1,0,11,17,150,167
2016,2,1,0,12,19,186,205
2016,2,1,0,13,28,166,194
2016,2,1,0,14,12,93,105
2016,2,1,0,15,2,67,69
2016,2,1,0,16,6,202,208
2016,2,1,0,17,18,505,523
2016,2,1,0,18,5,428,433
2016,2,1,0,19,3,331,334
2016,2,1,0,20,7,217,224
2016,2,1,0,21,7,160,167
2016,2,1,0,22,6,85,91
2016,2,1,0,23,4,63,67
2016,2,2,1,0,0,17,17
2016,2,2,1,1,0,5,5
2016,2,2,1,2,0,6,6
2016,2,2,1,4,0,4,4
2016,2,2,1,5,2,64,66
2016,2,2,1,6,1,216,217
2016,2,2,1,7,5,539,544
2016,2,2,1,8,7,909,916
2016,2,2,1,9,7,364,371
2016,2,2,1,10,5,167,172
2016,2,2,1,11,16,162,178
2016,2,2,1,12,24,242,266
2016,2,2,1,13,24,197,221
2016,2,2,1,14,27,195,222
2016,2,2,1,15,26,245,271
2016,2,2,1,16,23,411,434
2016,2,2,1,17,27,823,850
2016,2,2,1,18,7,698,705
2016,2,2,1,19,13,438,451
2016,2,2,1,20,1,262,263
2016,2,2,1,21,5,212,217
2016,2,2,1,22,3,128,131
2016,2,2,1,23,4,53,57
2016,2,3,2,0,1,22,23
2016,2,3,2,1,1,5,6
2016,2,3,2,2,0,1,1
2016,2,3,2,4,0,6,6
2016,2,3,2,5,0,62,62
2016,2,3,2,6,1,199,200
2016,2,3,2,7,2,478,480
2016,2,3,2,8,5,697,702
2016,2,3,2,9,2,222,224
2016,2,3,2,10,5,128,133
2016,2,3,2,11,3,130,133
2016,2,3,2,12,2,84,86
2016,2,3,2,13,0,27,27
2016,2,3,2,14,2,44,46
2016,2,3,2,15,3,64,67
2016,2,3,2,16,6,159,165
2016,2,3,2,17,3,365,368
2016,2,3,2,18,11,488,499
2016,2,3,2,19,10,357,367
2016,2,3,2,20,5,248,253
2016,2,3,2,21,2,173,175
2016,2,3,2,22,6,152,158
2016,2,3,2,23,2,60,62
2016,2,4,3,0,5,15,20
2016,2,4,3,1,0,8,8
2016,2,4,3,3,0,1,1
2016,2,4,3,4,0,2,2
2016,2,4,3,5,0,60,60
2016,2,4,3,6,2,199,201
2016,2,4,3,7,3,554,557
2016,2,4,3,8,10,924,934
2016,2,4,3,9,16,366,382
2016,2,4,3,10,12,160,172
2016,2,4,3,11,11,188,199
2016,2,4,3,12,20,206,226
2016,2,4,3,13,20,211,231
2016,2,4,3,14,37,172,209
2016,2,4,3,15,31,235,266
2016,2,4,3,16,42,409,451
2016,2,4,3,17,24,778,802
2016,2,4,3,18,18,766,784
2016,2,4,3,19,9,443,452
2016,2,4,3,20,15,287,302
2016,2,4,3,21,11,193,204
2016,2,4,3,22,9,150,159
2016,2,4,3,23,6,63,69
2016,2,5,4,0,6,22,28
2016,2,5,4,1,1,10,11
2016,2,5,4,2,0,6,6
2016,2,5,4,4,1,3,4
2016,2,5,4,5,0,40,40
2016,2,5,4,6,4,141,145
2016,2,5,4,7,2,307,309
2016,2,5,4,8,19,742,761
2016,2,5,4,9,8,385,393
2016,2,5,4,10,22,173,195
2016,2,5,4,11,26,173,199
2016,2,5,4,12,38,217,255
2016,2,5,4,13,37,236,273
2016,2,5,4,14,45,225,270
2016,2,5,4,15,47,234,281
2016,2,5,4,16,28,428,456
2016,2,5,4,17,37,696,733
2016,2,5,4,18,18,574,592
2016,2,5,4,19,8,304,312
2016,2,5,4,20,12,188,200
2016,2,5,4,21,6,147,153
2016,2,5,4,22,9,100,109
2016,2,5,4,23,8,89,97
2016,2,6,5,0,6,68,74
2016,2,6,5,1,5,47,52
2016,2,6,5,2,2,26,28
2016,2,6,5,3,5,11,16
2016,2,6,5,4,3,5,8
2016,2,6,5,5,0,1,1
2016,2,6,5,6,0,14,14
2016,2,6,5,7,8,67,75
2016,2,6,5,8,11,151,162
2016,2,6,5,9,31,224,255
2016,2,6,5,10,36,284,320
2016,2,6,5,11,63,351,414
2016,2,6,5,12,84,383,467
2016,2,6,5,13,92,349,441
2016,2,6,5,14,91,391,482
2016,2,6,5,15,85,366,451
2016,2,6,5,16,80,327,407
2016,2,6,5,17,92,270,362
2016,2,6,5,18,50,242,292
2016,2,6,5,19,16,194,210
2016,2,6,5,20,5,151,156
2016,2,6,5,21,6,130,136
2016,2,6,5,22,11,114,125
2016,2,6,5,23,6,88,94
2016,2,7,6,0,6,65,71
2016,2,7,6,1,7,65,72
2016,2,7,6,2,4,43,47
2016,2,7,6,3,2,28,30
2016,2,7,6,4,1,5,6
2016,2,7,6,5,0,5,5
2016,2,7,6,6,2,14,16
2016,2,7,6,7,6,31,37
2016,2,7,6,8,9,96,105
2016,2,7,6,9,32,156,188
2016,2,7,6,10,63,244,307
2016,2,7,6,11,80,313,393
2016,2,7,6,12,63,338,401
2016,2,7,6,13,69,371,440
2016,2,7,6,14,61,349,410
2016,2,7,6,15,57,317,374
2016,2,7,6,16,75,364,439
2016,2,7,6,17,36,363,399
2016,2,7,6,18,27,262,289
2016,2,7,6,19,6,90,96
2016,2,7,6,20,16,95,111
2016,2,7,6,21,26,81,107
2016,2,7,6,22,10,207,217
2016,2,7,6,23,13,91,104
2016,2,8,0,0,2,16,18
2016,2,8,0,1,0,3,3
2016,2,8,0,2,2,3,5
2016,2,8,0,4,0,4,4
2016,2,8,0,5,1,46,47
2016,2,8,0,6,1,154,155
2016,2,8,0,7,5,498,503
2016,2,8,0,8,8,896,904
2016,2,8,0,9,24,347,371
2016,2,8,0,10,13,138,151
2016,2,8,0,11,26,169,195
2016,2,8,0,12,30,215,245
2016,2,8,0,13,19,214,233
2016,2,8,0,14,33,181,214
2016,2,8,0,15,27,212,239
2016,2,8,0,16,25,403,428
2016,2,8,0,17,20,807,827
2016,2,8,0,18,7,686,693
2016,2,8,0,19,8,323,331
2016,2,8,0,20,6,184,190
2016,2,8,0,21,6,147,153
2016,2,8,0,22,3,48,51
2016,2,8,0,23,0,34,34
2016,2,9,1,0,0,15,15
2016,2,9,1,1,0,4,4
2016,2,9,1,3,0,2,2
2016,2,9,1,4,0,2,2
2016,2,9,1,5,0,31,31
2016,2,9,1,6,1,69,70
2016,2,9,1,7,1,184,185
2016,2,9,1,8,3,454,457
2016,2,9,1,9,2,199,201
2016,2,9,1,10,4,90,94
2016,2,9,1,11,10,64,74
2016,2,9,1,12,6,91,97
2016,2,9,1,13,4,94,98
2016,2,9,1,14,15,107,122
2016,2,9,1,15,1,167,168
2016,2,9,1,16,15,293,308
2016,2,9,1,17,15,677,692
2016,2,9,1,18,10,560,570
2016,2,9,1,19,5,335,340
2016,2,9,1,20,3,222,225
2016,2,9,1,21,5,159,164
2016,2,9,1,22,7,82,89
2016,2,9,1,23,4,41,45
2016,2,10,2,0,1,16,17
2016,2,10,2,1,0,7,7
2016,2,10,2,2,0,2,2
2016,2,10,2,4,0,3,3
2016,2,10,2,5,0,41,41
2016,2,10,2,6,0,163,163
2016,2,10,2,7,0,464,464
2016,2,10,2,8,6,806,812
2016,2,10,2,9,12,397,409
2016,2,10,2,10,10,144,154
2016,2,10,2,11,19,156,175
2016,2,10,2,12,20,197,217
2016,2,10,2,13,15,202,217
2016,2,10,2,14,27,180,207
2016,2,10,2,15,14,185,199
2016,2,10,2,16,24,366,390
2016,2,10,2,17,21,662,683
2016,2,10,2,18,6,561,567
2016,2,10,2,19,4,320,324
2016,2,10,2,20,3,205,208
2016,2,10,2,21,1,124,125
2016,2,10,2,22,1,69,70
2016,2,10,2,23,0,39,39
2016,2,11,3,0,0,10,10
2016,2,11,3,1,0,2,2
2016,2,11,3,2,0,2,2
2016,2,11,3,3,0,1,1
2016,2,11,3,4,0,4,4
2016,2,11,3,5,0,39,39
2016,2,11,3,6,1,114,115
2016,2,11,3,7,2,347,349
2016,2,11,3,8,7,625,632
2016,2,11,3,9,3,323,326
2016,2,11,3,10,6,114,120
2016,2,11,3,11,6,131,137
2016,2,11,3,12,13,143,156
2016,2,11,3,13,13,150,163
2016,2,11,3,14,4,102,106
2016,2,11,3,15,7,130,137
2016,2,11,3,16,9,277,286
2016,2,11,3,17,9,524,533
2016,2,11,3,18,5,440,445
2016,2,11,3,19,1,281,282
2016,2,11,3,20,3,169,172
2016,2,11,3,21,2,113,115
2016,2,11,3,22,0,77,77
2016,2,11,3,23,0,37,37
2016,2,12,4,0,0,22,22
2016,2,12,4,1,1,7,8
2016,2,12,4,2,0,1,1
2016,2,12,4,4,0,3,3
2016,2,12,4,5,0,40,40
2016,2,12,4,6,1,97,98
2016,2,12,4,7,1,281,282
2016,2,12,4,8,5,605,610
2016,2,12,4,9,5,333,338
2016,2,12,4,10,11,137,148
2016,2,12,4,11,12,151,163
2016,2,12,4,12,24,187,211
2016,2,12,4,13,13,195,208
2016,2,12,4,14,10,159,169
2016,2,12,4,15,23,227,250
2016,2,12,4,16,20,306,326
2016,2,12,4,17,15,507,522
2016,2,12,4,18,15,386,401
2016,2,12,4,19,10,213,223
2016,2,12,4,20,2,126,128
2016,2,12,4,21,0,106,106
2016,2,12,4,22,2,58,60
2016,2,12,4,23,2,44,46
2016,2,13,5,0,7,38,45
2016,2,13,5,1,0,15,15
2016,2,13,5,2,0,17,17
2016,2,13,5,3,1,3,4
2016,2,13,5,4,0,3,3
2016,2,13,5,5,0,3,3
2016,2,13,5,6,1,3,4
2016,2,13,5,7,0,25,25
2016,2,13,5,8,4,38,42
2016,2,13,5,9,2,56,58
2016,2,13,5,10,22,107,129
2016,2,13,5,11,3,104,107
2016,2,13,5,12,11,129,140
2016,2,13,5,13,12,117,129
2016,2,13,5,14,2,117,119
2016,2,13,5,15,12,124,136
2016,2,13,5,16,14,121,135
2016,2,13,5,17,10,111,121
2016,2,13,5,18,6,91,97
2016,2,13,5,19,4,71,75
2016,2,13,5,20,3,53,56
2016,2,13,5,21,1,31,32
2016,2,13,5,22,3,24,27
2016,2,13,5,23,0,16,16
2016,2,14,6,0,1,22,23
2016,2,14,6,1,1,15,16
2016,2,14,6,2,0,9,9
2016,2,14,6,3,0,4,4
2016,2,14,6,4,0,1,1
2016,2,14,6,5,0,3,3
2016,2,14,6,6,0,3,3
2016,2,14,6,7,0,17,17
2016,2,14,6,8,3,35,38
2016,2,14,6,9,4,69,73
2016,2,14,6,10,12,104,116
2016,2,14,6,11,22,105,127
2016,2,14,6,12,29,135,164
2016,2,14,6,13,18,174,192
2016,2,14,6,14,16,146,162
2016,2,14,6,15,26,140,166
2016,2,14,6,16,22,152,174
2016,2,14,6,17,27,147,174
2016,2,14,6,18,17,111,128
2016,2,14,6,19,11,84,95
2016,2,14,6,20,8,60,68
2016,2,14,6,21,5,42,47
2016,2,14,6,22,3,29,32
2016,2,14,6,23,0,19,19
2016,2,15,0,0,0,9,9
2016,2,15,0,1,0,1,1
2016,2,15,0,2,0,3,3
2016,2,15,0,3,0,1,1
2016,2,15,0,4,0,2,2
2016,2,15,0,5,0,8,8
2016,2,15,0,6,0,9,9
2016,2,15,0,7,0,24,24
2016,2,15,0,8,0,34,34
2016,2,15,0,9,2,29,31
2016,2,15,0,10,2,14,16
2016,2,15,0,11,0,29,29
2016,2,15,0,12,0,25,25
2016,2,15,0,13,3,29,32
2016,2,15,0,14,1,36,37
2016,2,15,0,15,4,37,41
2016,2,15,0,16,10,44,54
2016,2,15,0,17,1,35,36
2016,2,15,0,18,0,34,34
2016,2,15,0,19,0,26,26
2016,2,15,0,20,0,14,14
2016,2,15,0,21,0,14,14
2016,2,15,0,22,0,13,13
2016,2,15,0,23,1,7,8
2016,2,16,1,0,0,2,2
2016,2,16,1,1,0,1,1
2016,2,16,1,2,0,2,2
2016,2,16,1,4,0,3,3
2016,2,16,1,5,0,13,13
2016,2,16,1,6,0,25,25
2016,2,16,1,7,1,48,49
2016,2,16,1,8,0,65,65
2016,2,16,1,9,0,49,49
2016,2,16,1,10,0,42,42
2016,2,16,1,11,3,50,53
2016,2,16,1,12,4,76,80
2016,2,16,1,13,2,111,113
2016,2,16,1,14,11,109,120
2016,2,16,1,15,13,159,172
2016,2,16,1,16,12,285,297
2016,2,16,1,17,16,679,695
2016,2,16,1,18,0,546,546
2016,2,16,1,19,9,329,338
2016,2,16,1,20,5,219,224
2016,2,16,1,21,2,188,190
2016,2,16,1,22,4,106,110
2016,2,16,1,23,1,48,49
2016,2,17,2,0,1,14,15
2016,2,17,2,1,0,7,7
2016,2,17,2,2,0,2,2
2016,2,17,2,3,0,2,2
2016,2,17,2,4,0,5,5
2016,2,17,2,5,0,54,54
2016,2,17,2,6,0,181,181
2016,2,17,2,7,7,496,503
2016,2,17,2,8,5,864,869
2016,2,17,2,9,7,373,380
2016,2,17,2,10,7,152,159
2016,2,17,2,11,14,180,194
2016,2,17,2,12,19,227,246
2016,2,17,2,13,25,187,212
2016,2,17,2,14,33,157,190
2016,2,17,2,15,33,201,234
2016,2,17,2,16,30,410,440
2016,2,17,2,17,27,746,773
2016,2,17,2,18,6,627,633
2016,2,17,2,19,4,361,365
2016,2,17,2,20,8,265,273
2016,2,17,2,21,8,178,186
2016,2,17,2,22,5,109,114
2016,2,17,2,23,2,58,60
2016,2,18,3,0,7,18,25
2016,2,18,3,1,2,3,5
2016,2,18,3,2,0,5,5
2016,2,18,3,3,0,3,3
2016,2,18,3,4,0,4,4
2016,2,18,3,5,0,54,54
2016,2,18,3,6,1,168,169
2016,2,18,3,7,3,458,461
2016,2,18,3,8,5,844,849
2016,2,18,3,9,10,375,385
2016,2,18,3,10,14,146,160
2016,2,18,3,11,26,164,190
2016,2,18,3,12,17,196,213
2016,2,18,3,13,11,194,205
2016,2,18,3,14,30,143,173
2016,2,18,3,15,21,203,224
2016,2,18,3,16,18,319,337
2016,2,18,3,17,26,732,758
2016,2,18,3,18,1,640,641
2016,2,18,3,19,8,366,374
2016,2,18,3,20,6,247,253
2016,2,18,3,21,5,168,173
2016,2,18,3,22,3,102,105
2016,2,18,3,23,3,53,56
2016,2,19,4,0,0,20,20
2016,2,19,4,1,0,9,9
2016,2,19,4,2,0,2,2
2016,2,19,4,3,0,3,3
2016,2,19,4,4,0,3,3
2016,2,19,4,5,0,58,58
2016,2,19,4,6,1,142,143
2016,2,19,4,7,4,394,398
2016,2,19,4,8,8,736,744
2016,2,19,4,9,14,379,393
2016,2,19,4,10,12,145,157
2016,2,19,4,11,25,167,192
2016,2,19,4,12,26,202,228
2016,2,19,4,13,34,198,232
2016,2,19,4,14,19,198,217
2016,2,19,4,15,36,264,300
2016,2,19,4,16,30,403,433
2016,2,19,4,17,28,673,701
2016,2,19,4,18,16,520,536
2016,2,19,4,19,11,312,323
2016,2,19,4,20,6,201,207
2016,2,19,4,21,4,120,124
2016,2,19,4,22,9,118,127
2016,2,19,4,23,6,77,83
2016,2,20,5,0,10,57,67
2016,2,20,5,1,4,51,55
2016,2,20,5,2,3,34,37
2016,2,20,5,3,3,17,20
2016,2,20,5,4,1,8,9
2016,2,20,5,5,0,7,7
2016,2,20,5,6,0,21,21
2016,2,20,5,7,6,57,63
2016,2,20,5,8,13,182,195
2016,2,20,5,9,35,244,279
2016,2,20,5,10,80,284,364
2016,2,20,5,11,147,399,546
2016,2,20,5,12,206,495,701
2016,2,20,5,13,297,512,809
2016,2,20,5,14,400,542,942
2016,2,20,5,15,364,535,899
2016,2,20,5,16,391,533,924
2016,2,20,5,17,276,423,699
2016,2,20,5,18,128,361,489
2016,2,20,5,19,98,226,324
2016,2,20,5,20,60,179,239
2016,2,20,5,21,41,171,212
2016,2,20,5,22,55,143,198
2016,2,20,5,23,33,113,146
2016,2,21,6,0,30,104,134
2016,2,21,6,1,12,80,92
2016,2,21,6,2,7,61,68
2016,2,21,6,3,7,28,35
2016,2,21,6,4,2,6,8
2016,2,21,6,5,0,5,5
2016,2,21,6,6,4,14,18
2016,2,21,6,7,7,49,56
2016,2,21,6,8,24,122,146
2016,2,21,6,9,62,218,280
2016,2,21,6,10,90,332,422
2016,2,21,6,11,69,271,340
2016,2,21,6,12,44,193,237
2016,2,21,6,13,68,243,311
2016,2,21,6,14,66,290,356
2016,2,21,6,15,77,285,362
2016,2,21,6,16,44,257,301
2016,2,21,6,17,42,254,296
2016,2,21,6,18,20,233,253
2016,2,21,6,19,10,183,193
2016,2,21,6,20,13,117,130
2016,2,21,6,21,11,79,90
2016,2,21,6,22,14,61,75
2016,2,21,6,23,10,36,46
2016,2,22,0,0,1,17,18
2016,2,22,0,1,1,5,6
2016,2,22,0,2,0,4,4
2016,2,22,0,3,1,3,4
2016,2,22,0,4,0,3,3
2016,2,22,0,5,1,50,51
2016,2,22,0,6,3,178,181
2016,2,22,0,7,4,545,549
2016,2,22,0,8,26,924,950
2016,2,22,0,9,20,390,410
2016,2,22,0,10,26,165,191
2016,2,22,0,11,45,158,203
2016,2,22,0,12,39,210,249
2016,2,22,0,13,35,224,259
2016,2,22,0,14,63,190,253
2016,2,22,0,15,49,264,313
2016,2,22,0,16,52,430,482
2016,2,22,0,17,56,930,986
2016,2,22,0,18,36,799,835
2016,2,22,0,19,15,473,488
2016,2,22,0,20,15,306,321
2016,2,22,0,21,21,200,221
2016,2,22,0,22,10,106,116
2016,2,22,0,23,3,52,55
2016,2,23,1,0,2,17,19
2016,2,23,1,1,4,5,9
2016,2,23,1,2,6,7,13
2016,2,23,1,3,0,4,4
2016,2,23,1,4,1,4,5
2016,2,23,1,5,1,49,50
2016,2,23,1,6,0,78,78
2016,2,23,1,7,4,142,146
2016,2,23,1,8,4,193,197
2016,2,23,1,9,4,104,108
2016,2,23,1,10,2,71,73
2016,2,23,1,11,5,57,62
2016,2,23,1,12,1,64,65
2016,2,23,1,13,1,66,67
2016,2,23,1,14,1,47,48
2016,2,23,1,15,4,72,76
2016,2,23,1,16,2,161,163
2016,2,23,1,17,3,360,363
2016,2,23,1,18,5,313,318
2016,2,23,1,19,1,256,257
2016,2,23,1,20,0,182,182
2016,2,23,1,21,2,161,163
2016,2,23,1,22,3,89,92
2016,2,23,1,23,1,26,27
2016,2,24,2,0,0,21,21
2016,2,24,2,1,0,7,7
2016,2,24,2,2,0,4,4
2016,2,24,2,3,0,1,1
2016,2,24,2,4,0,4,4
2016,2,24,2,5,0,51,51
2016,2,24,2,6,0,108,108
2016,2,24,2,7,3,281,284
2016,2,24,2,8,4,346,350
2016,2,24,2,9,2,250,252
2016,2,24,2,10,4,111,115
2016,2,24,2,11,3,96,99
2016,2,24,2,12,7,137,144
2016,2,24,2,13,8,115,123
2016,2,24,2,14,12,92,104
2016,2,24,2,15,3,68,71
2016,2,24,2,16,1,186,187
2016,2,24,2,17,9,518,527
2016,2,24,2,18,0,49,49
2016,2,24,2,19,2,196,198
2016,2,24,2,20,1,199,200
2016,2,24,2,21,2,187,189
2016,2,24,2,22,4,136,140
2016,2,24,2,23,2,49,51
2016,2,25,3,0,5,20,25
2016,2,25,3,1,2,12,14
2016,2,25,3,2,0,1,1
2016,2,25,3,3,0,2,2
2016,2,25,3,4,0,3,3
2016,2,25,3,5,0,51,51
2016,2,25,3,6,4,198,202
2016,2,25,3,7,10,518,528
2016,2,25,3,8,10,969,979
2016,2,25,3,9,8,417,425
2016,2,25,3,10,12,172,184
2016,2,25,3,11,18,193,211
2016,2,25,3,12,5,190,195
2016,2,25,3,13,18,222,240
2016,2,25,3,14,24,179,203
2016,2,25,3,15,10,226,236
2016,2,25,3,16,7,344,351
2016,2,25,3,17,6,788,794
2016,2,25,3,18,6,647,653
2016,2,25,3,19,3,375,378
2016,2,25,3,20,10,257,267
2016,2,25,3,21,5,183,188
2016,2,25,3,22,2,130,132
2016,2,25,3,23,4,64,68
2016,2,26,4,0,3,23,26
2016,2,26,4,1,0,9,9
2016,2,26,4,2,0,7,7
2016,2,26,4,4,0,4,4
2016,2,26,4,5,0,56,56
2016,2,26,4,6,0,148,148
2016,2,26,4,7,3,425,428
2016,2,26,4,8,6,785,791
2016,2,26,4,9,2,353,355
2016,2,26,4,10,9,155,164
2016,2,26,4,11,18,176,194
2016,2,26,4,12,10,206,216
2016,2,26,4,13,11,215,226
2016,2,26,4,14,18,182,200
2016,2,26,4,15,14,233,247
2016,2,26,4,16,13,382,395
2016,2,26,4,17,9,599,608
2016,2,26,4,18,4,506,510
2016,2,26,4,19,2,284,286
2016,2,26,4,20,1,158,159
2016,2,26,4,21,9,123,132
2016,2,26,4,22,9,85,94
2016,2,26,4,23,5,85,90
2016,2,27,5,0,0,68,68
2016,2,27,5,1,0,35,35
2016,2,27,5,2,2,29,31
2016,2,27,5,3,1,14,15
2016,2,27,5,4,0,4,4
2016,2,27,5,5,1,4,5
2016,2,27,5,6,0,18,18
2016,2,27,5,7,0,58,58
2016,2,27,5,8,13,144,157
2016,2,27,5,9,20,270,290
2016,2,27,5,10,43,274,317
2016,2,27,5,11,57,353,410
2016,2,27,5,12,109,381,490
2016,2,27,5,13,101,376,477
2016,2,27,5,14,133,341,474
2016,2,27,5,15,155,379,534
2016,2,27,5,16,134,347,481
2016,2,27,5,17,102,323,425
2016,2,27,5,18,40,312,352
2016,2,27,5,19,28,214,242
2016,2,27,5,20,13,153,166
2016,2,27,5,21,13,152,165
2016,2,27,5,22,11,108,119
2016,2,27,5,23,6,93,99
2016,2,28,6,0,7,70,77
2016,2,28,6,1,5,60,65
2016,2,28,6,2,7,32,39
2016,2,28,6,3,2,11,13
2016,2,28,6,4,0,5,5
2016,2,28,6,5,0,4,4
2016,2,28,6,6,0,8,8
2016,2,28,6,7,6,47,53
2016,2,28,6,8,11,117,128
2016,2,28,6,9,46,193,239
2016,2,28,6,10,111,354,465
2016,2,28,6,11,182,512,694
2016,2,28,6,12,319,583,902
2016,2,28,6,13,361,556,917
2016,2,28,6,14,425,579,1004
2016,2,28,6,15,406,650,1056
2016,2,28,6,16,365,626,991
2016,2,28,6,17,261,504,765
2016,2,28,6,18,124,398,522
2016,2,28,6,19,61,247,308
2016,2,28,6,20,49,147,196
2016,2,28,6,21,21,109,130
2016,2,28,6,22,17,92,109
2016,2,28,6,23,6,36,42
2016,2,29,0,0,3,51,54
2016,2,29,0,1,4,8,12
2016,2,29,0,2,0,2,2
2016,2,29,0,3,0,3,3
2016,2,29,0,4,0,6,6
2016,2,29,0,5,3,54,57
2016,2,29,0,6,4,187,191
2016,2,29,0,7,10,605,615
2016,2,29,0,8,15,890,905
2016,2,29,0,9,32,359,391
2016,2,29,0,10,52,175,227
2016,2,29,0,11,64,196,260
2016,2,29,0,12,56,256,312
2016,2,29,0,13,78,272,350
2016,2,29,0,14,49,202,251
2016,2,29,0,15,52,292,344
2016,2,29,0,16,53,486,539
2016,2,29,0,17,64,1070,1134
2016,2,29,0,18,31,854,885
2016,2,29,0,19,29,471,500
2016,2,29,0,20,26,308,334
2016,2,29,0,21,7,257,264
2016,2,29,0,22,5,126,131
2016,2,29,0,23,10,51,61
2016,3,1,1,0,1,14,15
2016,3,1,1,1,5,7,12
2016,3,1,1,2,1,6,7
2016,3,1,1,3,0,5,5
2016,3,1,1,4,1,10,11
2016,3,1,1,5,0,59,59
2016,3,1,1,6,4,237,241
2016,3,1,1,7,13,719,732
2016,3,1,1,8,19,1104,1123
2016,3,1,1,9,26,416,442
2016,3,1,1,10,31,189,220
2016,3,1,1,11,43,206,249
2016,3,1,1,12,48,305,353
2016,3,1,1,13,58,276,334
2016,3,1,1,14,78,230,308
2016,3,1,1,15,74,293,367
2016,3,1,1,16,65,491,556
2016,3,1,1,17,84,1085,1169
2016,3,1,1,18,42,895,937
2016,3,1,1,19,30,536,566
2016,3,1,1,20,33,325,358
2016,3,1,1,21,14,247,261
2016,3,1,1,22,10,182,192
2016,3,1,1,23,6,65,71
2016,3,2,2,0,1,14,15
2016,3,2,2,1,0,7,7
2016,3,2,2,2,0,1,1
2016,3,2,2,3,0,3,3
2016,3,2,2,4,0,3,3
2016,3,2,2,5,1,60,61
2016,3,2,2,6,2,184,186
2016,3,2,2,7,10,526,536
2016,3,2,2,8,14,892,906
2016,3,2,2,9,16,381,397
2016,3,2,2,10,10,159,169
2016,3,2,2,11,13,166,179
2016,3,2,2,12,20,220,240
2016,3,2,2,13,7,176,183
2016,3,2,2,14,29,158,187
2016,3,2,2,15,12,200,212
2016,3,2,2,16,22,348,370
2016,3,2,2,17,23,759,782
2016,3,2,2,18,8,565,573
2016,3,2,2,19,11,335,346
2016,3,2,2,20,4,238,242
2016,3,2,2,21,6,175,181
2016,3,2,2,22,1,97,98
2016,3,2,2,23,0,41,41
2016,3,3,3,0,1,12,13
2016,3,3,3,1,0,8,8
2016,3,3,3,2,0,2,2
2016,3,3,3,4,0,6,6
2016,3,3,3,5,0,51,51
2016,3,3,3,6,3,189,192
2016,3,3,3,7,3,503,506
2016,3,3,3,8,16,868,884
2016,3,3,3,9,21,378,399
2016,3,3,3,10,13,139,152
2016,3,3,3,11,21,158,179
2016,3,3,3,12,22,185,207
2016,3,3,3,13,30,197,227
2016,3,3,3,14,35,169,204
2016,3,3,3,15,15,218,233
2016,3,3,3,16,24,372,396
2016,3,3,3,17,20,741,761
2016,3,3,3,18,13,631,644
2016,3,3,3,19,8,377,385
2016,3,3,3,20,5,219,224
2016,3,3,3,21,0,137,137
2016,3,3,3,22,1,53,54
2016,3,3,3,23,0,38,38
2016,3,4,4,0,1,12,13
2016,3,4,4,1,0,6,6
2016,3,4,4,2,0,5,5
2016,3,4,4,4,0,3,3
2016,3,4,4,5,0,47,47
2016,3,4,4,6,0,103,103
2016,3,4,4,7,3,295,298
2016,3,4,4,8,6,611,617
2016,3,4,4,9,9,343,352
2016,3,4,4,10,11,168,179
2016,3,4,4,11,17,173,190
2016,3,4,4,12,20,237,257
2016,3,4,4,13,9,236,245
2016,3,4,4,14,27,181,208
2016,3,4,4,15,28,226,254
2016,3,4,4,16,31,389,420
2016,3,4,4,17,49,707,756
2016,3,4,4,18,15,506,521
2016,3,4,4,19,20,296,316
2016,3,4,4,20,8,191,199
2016,3,4,4,21,6,144,150
2016,3,4,4,22,7,107,114
2016,3,4,4,23,6,86,92
2016,3,5,5,0,5,61,66
2016,3,5,5,1,1,34,35
2016,3,5,5,2,3,40,43
2016,3,5,5,3,1,14,15
2016,3,5,5,4,0,3,3
2016,3,5,5,5,1,8,9
2016,3,5,5,6,2,17,19
2016,3,5,5,7,8,60,68
2016,3,5,5,8,14,141,155
2016,3,5,5,9,35,255,290
2016,3,5,5,10,75,290,365
2016,3,5,5,11,68,344,412
2016,3,5,5,12,101,370,471
2016,3,5,5,13,122,337,459
2016,3,5,5,14,138,291,429
2016,3,5,5,15,129,355,484
2016,3,5,5,16,108,366,474
2016,3,5,5,17,133,323,456
2016,3,5,5,18,49,276,325
2016,3,5,5,19,41,196,237
2016,3,5,5,20,27,147,174
2016,3,5,5,21,17,120,137
2016,3,5,5,22,7,87,94
2016,3,5,5,23,24,90,114
2016,3,6,6,0,13,64,77
2016,3,6,6,1,9,51,60
2016,3,6,6,2,15,45,60
2016,3,6,6,3,3,13,16
2016,3,6,6,4,0,2,2
2016,3,6,6,5,0,6,6
2016,3,6,6,6,2,14,16
2016,3,6,6,7,5,52,57
2016,3,6,6,8,22,133,155
2016,3,6,6,9,76,175,251
2016,3,6,6,10,108,265,373
2016,3,6,6,11,111,310,421
2016,3,6,6,12,145,424,569
2016,3,6,6,13,163,404,567
2016,3,6,6,14,170,395,565
2016,3,6,6,15,184,403,587
2016,3,6,6,16,190,425,615
2016,3,6,6,17,133,393,526
2016,3,6,6,18,86,279,365
2016,3,6,6,19,34,186,220
2016,3,6,6,20,15,137,152
2016,3,6,6,21,31,99,130
2016,3,6,6,22,19,53,72
2016,3,6,6,23,5,32,37
2016,3,7,0,0,4,12,16
2016,3,7,0,1,0,5,5
2016,3,7,0,2,0,4,4
2016,3,7,0,3,1,4,5
2016,3,7,0,5,2,56,58
2016,3,7,0,6,6,177,183
2016,3,7,0,7,15,566,581
2016,3,7,0,8,24,1022,1046
2016,3,7,0,9,57,425,482
2016,3,7,0,10,110,162,272
2016,3,7,0,11,117,202,319
2016,3,7,0,12,123,260,383
2016,3,7,0,13,127,249,376
2016,3,7,0,14,132,212,344
2016,3,7,0,15,150,323,473
2016,3,7,0,16,157,511,668
2016,3,7,0,17,168,1167,1335
2016,3,7,0,18,100,937,1037
2016,3,7,0,19,71,503,574
2016,3,7,0,20,30,339,369
2016,3,7,0,21,41,229,270
2016,3,7,0,22,16,120,136
2016,3,7,0,23,28,39,67
2016,3,8,1,0,4,22,26
2016,3,8,1,1,1,5,6
2016,3,8,1,2,3,3,6
2016,3,8,1,3,0,1,1
2016,3,8,1,4,0,2,2
2016,3,8,1,5,0,69,69
2016,3,8,1,6,4,273,277
2016,3,8,1,7,26,791,817
2016,3,8,1,8,59,1151,1210
2016,3,8,1,9,85,448,533
2016,3,8,1,10,75,220,295
2016,3,8,1,11,136,235,371
2016,3,8,1,12,148,334,482
2016,3,8,1,13,125,304,429
2016,3,8,1,14,183,274,457
2016,3,8,1,15,182,326,508
2016,3,8,1,16,133,637,770
2016,3,8,1,17,153,1196,1349
2016,3,8,1,18,109,1028,1137
2016,3,8,1,19,79,625,704
2016,3,8,1,20,64,404,468
2016,3,8,1,21,60,273,333
2016,3,8,1,22,22,179,201
2016,3,8,1,23,19,88,107
2016,3,9,2,0,19,24,43
2016,3,9,2,1,3,8,11
2016,3,9,2,2,3,8,11
2016,3,9,2,3,1,1,2
2016,3,9,2,4,1,7,8
2016,3,9,2,5,2,61,63
2016,3,9,2,6,4,288,292
2016,3,9,2,7,28,815,843
2016,3,9,2,8,65,1199,1264
2016,3,9,2,9,52,439,491
2016,3,9,2,10,100,223,323
2016,3,9,2,11,129,249,378
2016,3,9,2,12,109,354,463
2016,3,9,2,13,160,297,457
2016,3,9,2,14,181,278,459
2016,3,9,2,15,184,344,528
2016,3,9,2,16,190,675,865
2016,3,9,2,17,219,1288,1507
2016,3,9,2,18,188,1026,1214
2016,3,9,2,19,98,613,711
2016,3,9,2,20,56,448,504
2016,3,9,2,21,57,327,384
2016,3,9,2,22,57,201,258
2016,3,9,2,23,19,116,135
2016,3,10,3,0,19,61,80
2016,3,10,3,1,2,17,19
2016,3,10,3,2,2,2,4
2016,3,10,3,3,2,2,4
2016,3,10,3,4,1,4,5
2016,3,10,3,5,1,84,85
2016,3,10,3,6,13,280,293
2016,3,10,3,7,30,795,825
2016,3,10,3,8,55,1140,1195
2016,3,10,3,9,70,455,525
2016,3,10,3,10,118,220,338
2016,3,10,3,11,127,253,380
2016,3,10,3,12,123,349,472
2016,3,10,3,13,125,322,447
2016,3,10,3,14,164,281,445
2016,3,10,3,15,193,324,517
2016,3,10,3,16,220,611,831
2016,3,10,3,17,220,1167,1387
2016,3,10,3,18,121,1025,1146
2016,3,10,3,19,110,616,726
2016,3,10,3,20,71,382,453
2016,3,10,3,21,64,315,379
2016,3,10,3,22,36,185,221
2016,3,10,3,23,23,154,177
2016,3,11,4,0,25,57,82
2016,3,11,4,1,17,25,42
2016,3,11,4,2,4,9,13
2016,3,11,4,3,2,9,11
2016,3,11,4,4,1,4,5
2016,3,11,4,5,1,69,70
2016,3,11,4,6,5,220,225
2016,3,11,4,7,15,648,663
2016,3,11,4,8,31,1132,1163
2016,3,11,4,9,62,487,549
2016,3,11,4,10,86,233,319
2016,3,11,4,11,154,288,442
2016,3,11,4,12,162,390,552
2016,3,11,4,13,216,398,614
2016,3,11,4,14,259,313,572
2016,3,11,4,15,249,438,687
2016,3,11,4,16,262,715,977
2016,3,11,4,17,235,1198,1433
2016,3,11,4,18,172,896,1068
2016,3,11,4,19,101,496,597
2016,3,11,4,20,73,331,404
2016,3,11,4,21,69,217,286
2016,3,11,4,22,59,194,253
2016,3,11,4,23,30,163,193
2016,3,12,5,0,15,106,121
2016,3,12,5,1,10,69,79
2016,3,12,5,2,2,44,46
2016,3,12,5,3,3,24,27
2016,3,12,5,4,7,4,11
2016,3,12,5,5,5,17,22
2016,3,12,5,6,26,138,164
2016,3,12,5,7,57,149,206
2016,3,12,5,8,92,267,359
2016,3,12,5,9,171,439,610
2016,3,12,5,10,302,485,787
2016,3,12,5,11,347,564,911
2016,3,12,5,12,401,580,981
2016,3,12,5,13,431,514,945
2016,3,12,5,14,404,521,925
2016,3,12,5,15,349,435,784
2016,3,12,5,16,283,391,674
2016,3,12,5,17,357,396,753
2016,3,12,5,18,212,409,621
2016,3,12,5,19,137,268,405
2016,3,12,5,20,122,208,330
2016,3,12,5,21,83,161,244
2016,3,12,5,22,71,125,196
2016,3,12,5,23,75,151,226
2016,3,13,6,0,32,111,143
2016,3,13,6,1,17,104,121
2016,3,13,6,3,18,70,88
2016,3,13,6,4,4,14,18
2016,3,13,6,5,1,7,8
2016,3,13,6,6,2,18,20
2016,3,13,6,7,8,31,39
2016,3,13,6,8,35,101,136
2016,3,13,6,9,52,136,188
2016,3,13,6,10,99,288,387
2016,3,13,6,11,130,385,515
2016,3,13,6,12,227,410,637
2016,3,13,6,13,222,463,685
2016,3,13,6,14,271,467,738
2016,3,13,6,15,82,240,322
2016,3,13,6,16,44,141,185
2016,3,13,6,17,69,197,266
2016,3,13,6,18,56,204,260
2016,3,13,6,19,23,172,195
2016,3,13,6,20,24,93,117
2016,3,13,6,21,3,74,77
2016,3,13,6,22,6,28,34
2016,3,13,6,23,1,14,15
2016,3,14,0,0,1,5,6
2016,3,14,0,1,0,6,6
2016,3,14,0,2,0,2,2
2016,3,14,0,4,0,5,5
2016,3,14,0,5,3,36,39
2016,3,14,0,6,11,155,166
2016,3,14,0,7,8,389,397
2016,3,14,0,8,20,830,850
2016,3,14,0,9,34,540,574
2016,3,14,0,10,62,172,234
2016,3,14,0,11,70,189,259
2016,3,14,0,12,61,219,280
2016,3,14,0,13,72,228,300
2016,3,14,0,14,66,212,278
2016,3,14,0,15,101,241,342
2016,3,14,0,16,75,459,534
2016,3,14,0,17,97,1016,1113
2016,3,14,0,18,75,926,1001
2016,3,14,0,19,38,540,578
2016,3,14,0,20,19,267,286
2016,3,14,0,21,11,194,205
2016,3,14,0,22,33,109,142
2016,3,14,0,23,13,61,74
2016,3,15,1,0,7,15,22
2016,3,15,1,1,1,7,8
2016,3,15,1,2,0,2,2
2016,3,15,1,3,0,4,4
2016,3,15,1,4,0,5,5
2016,3,15,1,5,0,73,73
2016,3,15,1,6,4,209,213
2016,3,15,1,7,7,331,338
2016,3,15,1,8,15,775,790
2016,3,15,1,9,17,482,499
2016,3,15,1,10,45,192,237
2016,3,15,1,11,47,211,258
2016,3,15,1,12,59,272,331
2016,3,15,1,13,66,257,323
2016,3,15,1,14,80,218,298
2016,3,15,1,15,109,309,418
2016,3,15,1,16,123,536,659
2016,3,15,1,17,149,1088,1237
2016,3,15,1,18,105,977,1082
2016,3,15,1,19,68,615,683
2016,3,15,1,20,35,396,431
2016,3,15,1,21,31,272,303
2016,3,15,1,22,25,212,237
2016,3,15,1,23,22,85,107
2016,3,16,2,0,6,31,37
2016,3,16,2,1,3,15,18
2016,3,16,2,2,0,5,5
2016,3,16,2,3,2,8,10
2016,3,16,2,4,3,6,9
2016,3,16,2,5,10,72,82
2016,3,16,2,6,51,291,342
2016,3,16,2,7,138,809,947
2016,3,16,2,8,205,1126,1331
2016,3,16,2,9,175,524,699
2016,3,16,2,10,185,240,425
2016,3,16,2,11,156,262,418
2016,3,16,2,12,201,325,526
2016,3,16,2,13,258,343,601
2016,3,16,2,14,288,339,627
2016,3,16,2,15,291,419,710
2016,3,16,2,16,436,725,1161
2016,3,16,2,17,545,1229,1774
2016,3,16,2,18,415,1087,1502
2016,3,16,2,19,206,616,822
2016,3,16,2,20,134,370,504
2016,3,16,2,21,132,304,436
2016,3,16,2,22,81,170,251
2016,3,16,2,23,32,87,119
2016,3,17,3,0,9,26,35
2016,3,17,3,1,6,9,15
2016,3,17,3,2,4,9,13
2016,3,17,3,3,0,4,4
2016,3,17,3,4,0,4,4
2016,3,17,3,5,0,73,73
2016,3,17,3,6,14,219,233
2016,3,17,3,7,21,655,676
2016,3,17,3,8,53,1200,1253
2016,3,17,3,9,73,514,587
2016,3,17,3,10,121,229,350
2016,3,17,3,11,144,280,424
2016,3,17,3,12,162,343,505
2016,3,17,3,13,131,338,469
2016,3,17,3,14,154,238,392
2016,3,17,3,15,171,341,512
2016,3,17,3,16,168,612,780
2016,3,17,3,17,183,1088,1271
2016,3,17,3,18,136,1070,1206
2016,3,17,3,19,84,604,688
2016,3,17,3,20,60,368,428
2016,3,17,3,21,23,315,338
2016,3,17,3,22,46,229,275
2016,3,17,3,23,23,119,142
2016,3,18,4,0,16,59,75
2016,3,18,4,1,8,30,38
2016,3,18,4,2,7,14,21
2016,3,18,4,3,2,8,10
2016,3,18,4,4,0,6,6
2016,3,18,4,5,3,68,71
2016,3,18,4,6,7,199,206
2016,3,18,4,7,37,598,635
2016,3,18,4,8,56,1152,1208
2016,3,18,4,9,89,517,606
2016,3,18,4,10,115,227,342
2016,3,18,4,11,187,344,531
2016,3,18,4,12,221,411,632
2016,3,18,4,13,221,416,637
2016,3,18,4,14,206,316,522
2016,3,18,4,15,229,443,672
2016,3,18,4,16,269,637,906
2016,3,18,4,17,259,1086,1345
2016,3,18,4,18,177,876,1053
2016,3,18,4,19,130,548,678
2016,3,18,4,20,95,309,404
2016,3,18,4,21,104,253,357
2016,3,18,4,22,85,206,291
2016,3,18,4,23,38,145,183
2016,3,19,5,0,25,121,146
2016,3,19,5,1,10,65,75
2016,3,19,5,2,5,39,44
2016,3,19,5,3,3,12,15
2016,3,19,5,4,1,1,2
2016,3,19,5,5,0,8,8
2016,3,19,5,6,1,16,17
2016,3,19,5,7,9,73,82
2016,3,19,5,8,23,160,183
2016,3,19,5,9,64,296,360
2016,3,19,5,10,76,364,440
2016,3,19,5,11,93,316,409
2016,3,19,5,12,36,163,199
2016,3,19,5,13,38,174,212
2016,3,19,5,14,18,120,138
2016,3,19,5,15,15,98,113
2016,3,19,5,16,19,99,118
2016,3,19,5,17,22,138,160
2016,3,19,5,18,3,78,81
2016,3,19,5,19,7,91,98
2016,3,19,5,20,10,88,98
2016,3,19,5,21,11,74,85
2016,3,19,5,22,5,75,80
2016,3,19,5,23,2,62,64
2016,3,20,6,0,6,49,55
2016,3,20,6,1,3,54,57
2016,3,20,6,2,3,36,39
2016,3,20,6,3,1,25,26
2016,3,20,6,4,0,3,3
2016,3,20,6,5,0,4,4
2016,3,20,6,6,3,15,18
2016,3,20,6,7,9,42,51
2016,3,20,6,8,11,88,99
2016,3,20,6,9,13,160,173
2016,3,20,6,10,48,226,274
2016,3,20,6,11,50,339,389
2016,3,20,6,12,103,378,481
2016,3,20,6,13,112,323,435
2016,3,20,6,14,87,291,378
2016,3,20,6,15,66,339,405
2016,3,20,6,16,64,309,373
2016,3,20,6,17,43,304,347
2016,3,20,6,18,36,242,278
2016,3,20,6,19,37,204,241
2016,3,20,6,20,14,157,171
2016,3,20,6,21,17,107,124
2016,3,20,6,22,14,44,58
2016,3,20,6,23,23,30,53
2016,3,21,0,0,17,10,27
2016,3,21,0,1,14,2,16
2016,3,21,0,3,0,3,3
2016,3,21,0,4,0,1,1
2016,3,21,0,5,2,45,47
2016,3,21,0,6,2,161,163
2016,3,21,0,7,5,490,495
2016,3,21,0,8,13,876,889
2016,3,21,0,9,25,428,453
2016,3,21,0,10,52,156,208
2016,3,21,0,11,53,175,228
2016,3,21,0,12,55,236,291
2016,3,21,0,13,100,237,337
2016,3,21,0,14,103,176,279
2016,3,21,0,15,103,250,353
2016,3,21,0,16,70,479,549
2016,3,21,0,17,83,989,1072
2016,3,21,0,18,67,920,987
2016,3,21,0,19,34,470,504
2016,3,21,0,20,24,263,287
2016,3,21,0,21,7,188,195
2016,3,21,0,22,6,130,136
2016,3,21,0,23,3,57,60
2016,3,22,1,0,3,27,30
2016,3,22,1,1,4,13,17
2016,3,22,1,2,0,3,3
2016,3,22,1,3,0,4,4
2016,3,22,1,4,0,2,2
2016,3,22,1,5,1,69,70
2016,3,22,1,6,5,221,226
2016,3,22,1,7,16,598,614
2016,3,22,1,8,21,1060,1081
2016,3,22,1,9,42,439,481
2016,3,22,1,10,67,166,233
2016,3,22,1,11,81,191,272
2016,3,22,1,12,115,268,383
2016,3,22,1,13,120,268,388
2016,3,22,1,14,165,220,385
2016,3,22,1,15,139,321,460
2016,3,22,1,16,156,589,745
2016,3,22,1,17,142,1226,1368
2016,3,22,1,18,98,1072,1170
2016,3,22,1,19,92,635,727
2016,3,22,1,20,54,401,455
2016,3,22,1,21,39,315,354
2016,3,22,1,22,32,173,205
2016,3,22,1,23,18,72,90
2016,3,23,2,0,5,24,29
2016,3,23,2,1,1,15,16
2016,3,23,2,2,1,6,7
2016,3,23,2,3,0,4,4
2016,3,23,2,4,0,4,4
2016,3,23,2,5,1,81,82
2016,3,23,2,6,9,268,277
2016,3,23,2,7,33,728,761
2016,3,23,2,8,41,1171,1212
2016,3,23,2,9,92,517,609
2016,3,23,2,10,99,234,333
2016,3,23,2,11,144,270,414
2016,3,23,2,12,203,386,589
2016,3,23,2,13,211,338,549
2016,3,23,2,14,261,281,542
2016,3,23,2,15,230,390,620
2016,3,23,2,16,199,687,886
2016,3,23,2,17,219,1314,1533
2016,3,23,2,18,251,1223,1474
2016,3,23,2,19,129,813,942
2016,3,23,2,20,124,472,596
2016,3,23,2,21,64,398,462
2016,3,23,2,22,41,232,273
2016,3,23,2,23,22,104,126
2016,3,24,3,0,7,55,62
2016,3,24,3,1,4,17,21
2016,3,24,3,2,2,7,9
2016,3,24,3,3,2,4,6
2016,3,24,3,4,1,10,11
2016,3,24,3,5,13,70,83
2016,3,24,3,6,18,276,294
2016,3,24,3,7,37,741,778
2016,3,24,3,8,61,1236,1297
2016,3,24,3,9,80,533,613
2016,3,24,3,10,171,239,410
2016,3,24,3,11,206,278,484
2016,3,24,3,12,263,391,654
2016,3,24,3,13,224,417,641
2016,3,24,3,14,271,341,612
2016,3,24,3,15,323,390,713
2016,3,24,3,16,304,680,984
2016,3,24,3,17,364,1322,1686
2016,3,24,3,18,309,1173,1482
2016,3,24,3,19,146,812,958
2016,3,24,3,20,126,499,625
2016,3,24,3,21,99,349,448
2016,3,24,3,22,67,231,298
2016,3,24,3,23,41,153,194
2016,3,25,4,0,13,95,108
2016,3,25,4,1,5,29,34
2016,3,25,4,2,4,14,18
2016,3,25,4,3,1,8,9
2016,3,25,4,4,1,5,6
2016,3,25,4,5,3,66,69
2016,3,25,4,6,10,218,228
2016,3,25,4,7,38,591,629
2016,3,25,4,8,63,1072,1135
2016,3,25,4,9,109,575,684
2016,3,25,4,10,159,300,459
2016,3,25,4,11,128,232,360
2016,3,25,4,12,192,344,536
2016,3,25,4,13,296,378,674
2016,3,25,4,14,364,465,829
2016,3,25,4,15,369,523,892
2016,3,25,4,16,399,782,1181
2016,3,25,4,17,341,1109,1450
2016,3,25,4,18,298,854,1152
2016,3,25,4,19,229,525,754
2016,3,25,4,20,122,316,438
2016,3,25,4,21,76,206,282
2016,3,25,4,22,46,145,191
2016,3,25,4,23,8,86,94
2016,3,26,5,0,11,102,113
2016,3,26,5,1,9,55,64
2016,3,26,5,2,6,34,40
2016,3,26,5,3,1,15,16
2016,3,26,5,4,1,4,5
2016,3,26,5,5,4,10,14
2016,3,26,5,6,41,66,107
2016,3,26,5,7,61,109,170
2016,3,26,5,8,105,248,353
2016,3,26,5,9,253,391,644
2016,3,26,5,10,409,439,848
2016,3,26,5,11,566,517,1083
2016,3,26,5,12,639,589,1228
2016,3,26,5,13,799,596,1395
2016,3,26,5,14,796,567,1363
2016,3,26,5,15,757,636,1393
2016,3,26,5,16,753,595,1348
2016,3,26,5,17,591,526,1117
2016,3,26,5,18,484,477,961
2016,3,26,5,19,295,388,683
2016,3,26,5,20,172,251,423
2016,3,26,5,21,120,182,302
2016,3,26,5,22,112,142,254
2016,3,26,5,23,42,150,192
2016,3,27,6,0,23,90,113
2016,3,27,6,1,14,68,82
2016,3,27,6,2,3,47,50
2016,3,27,6,3,10,24,34
2016,3,27,6,4,6,6,12
2016,3,27,6,5,13,11,24
2016,3,27,6,6,40,54,94
2016,3,27,6,7,70,96,166
2016,3,27,6,8,115,182,297
2016,3,27,6,9,258,251,509
2016,3,27,6,10,372,326,698
2016,3,27,6,11,369,412,781
2016,3,27,6,12,396,453,849
2016,3,27,6,13,379,437,816
2016,3,27,6,14,455,455,910
2016,3,27,6,15,386,375,761
2016,3,27,6,16,316,351,667
2016,3,27,6,17,229,382,611
2016,3,27,6,18,158,317,475
2016,3,27,6,19,54,189,243
2016,3,27,6,20,34,124,158
2016,3,27,6,21,18,83,101
2016,3,27,6,22,11,51,62
2016,3,27,6,23,16,35,51
2016,3,28,0,0,2,13,15
2016,3,28,0,1,2,5,7
2016,3,28,0,2,1,1,2
2016,3,28,0,3,0,3,3
2016,3,28,0,4,0,8,8
2016,3,28,0,5,0,42,42
2016,3,28,0,6,1,80,81
2016,3,28,0,7,1,196,197
2016,3,28,0,8,11,576,587
2016,3,28,0,9,36,428,464
2016,3,28,0,10,76,175,251
2016,3,28,0,11,126,258,384
2016,3,28,0,12,167,319,486
2016,3,28,0,13,171,310,481
2016,3,28,0,14,172,309,481
2016,3,28,0,15,130,307,437
2016,3,28,0,16,155,541,696
2016,3,28,0,17,159,1173,1332
2016,3,28,0,18,126,987,1113
2016,3,28,0,19,89,531,620
2016,3,28,0,20,25,299,324
2016,3,28,0,21,12,214,226
2016,3,28,0,22,16,132,148
2016,3,28,0,23,7,38,45
2016,3,29,1,0,5,26,31
2016,3,29,1,1,4,7,11
2016,3,29,1,2,0,9,9
2016,3,29,1,3,1,2,3
2016,3,29,1,4,0,8,8
2016,3,29,1,5,2,77,79
2016,3,29,1,6,8,232,240
2016,3,29,1,7,28,699,727
2016,3,29,1,8,42,1169,1211
2016,3,29,1,9,73,491,564
2016,3,29,1,10,133,225,358
2016,3,29,1,11,152,241,393
2016,3,29,1,12,101,288,389
2016,3,29,1,13,147,297,444
2016,3,29,1,14,149,284,433
2016,3,29,1,15,168,305,473
2016,3,29,1,16,157,543,700
2016,3,29,1,17,154,1196,1350
2016,3,29,1,18,100,1059,1159
2016,3,29,1,19,76,624,700
2016,3,29,1,20,63,337,400
2016,3,29,1,21,56,223,279
2016,3,29,1,22,34,144,178
2016,3,29,1,23,5,77,82
2016,3,30,2,0,2,29,31
2016,3,30,2,1,4,14,18
2016,3,30,2,2,0,4,4
2016,3,30,2,3,0,6,6
2016,3,30,2,4,0,7,7
2016,3,30,2,5,1,78,79
2016,3,30,2,6,4,211,215
2016,3,30,2,7,28,675,703
2016,3,30,2,8,51,1125,1176
2016,3,30,2,9,87,506,593
2016,3,30,2,10,148,232,380
2016,3,30,2,11,172,229,401
2016,3,30,2,12,172,328,500
2016,3,30,2,13,205,336,541
2016,3,30,2,14,203,290,493
2016,3,30,2,15,218,327,545
2016,3,30,2,16,189,560,749
2016,3,30,2,17,189,1187,1376
2016,3,30,2,18,159,1056,1215
2016,3,30,2,19,97,625,722
2016,3,30,2,20,53,415,468
2016,3,30,2,21,33,279,312
2016,3,30,2,22,16,215,231
2016,3,30,2,23,19,89,108
2016,3,31,3,0,6,22,28
2016,3,31,3,1,2,14,16
2016,3,31,3,2,1,9,10
2016,3,31,3,3,0,2,2
2016,3,31,3,4,1,7,8
2016,3,31,3,5,3,77,80
2016,3,31,3,6,10,230,240
2016,3,31,3,7,37,713,750
2016,3,31,3,8,48,1127,1175
2016,3,31,3,9,82,507,589
2016,3,31,3,10,117,239,356
2016,3,31,3,11,160,255,415
2016,3,31,3,12,152,331,483
2016,3,31,3,13,198,368,566
2016,3,31,3,14,153,278,431
2016,3,31,3,15,159,345,504
2016,3,31,3,16,169,577,746
2016,3,31,3,17,192,1120,1312
2016,3,31,3,18,171,1070,1241
2016,3,31,3,19,126,680,806
2016,3,31,3,20,51,485,536
2016,3,31,3,21,47,298,345
2016,3,31,3,22,29,211,240
2016,3,31,3,23,36,114,150
2016,4,1,4,0,9,55,64
2016,4,1,4,1,14,27,41
2016,4,1,4,2,16,12,28
2016,4,1,4,3,3,6,9
2016,4,1,4,4,4,7,11
2016,4,1,4,5,0,53,53
2016,4,1,4,6,15,172,187
2016,4,1,4,7,25,603,628
2016,4,1,4,8,27,575,602
2016,4,1,4,9,30,358,388
2016,4,1,4,10,77,227,304
2016,4,1,4,11,120,303,423
2016,4,1,4,12,165,361,526
2016,4,1,4,13,225,385,610
2016,4,1,4,14,274,380,654
2016,4,1,4,15,247,472,719
2016,4,1,4,16,280,709,989
2016,4,1,4,17,277,1190,1467
2016,4,1,4,18,227,897,1124
2016,4,1,4,19,198,532,730
2016,4,1,4,20,95,341,436
2016,4,1,4,21,87,288,375
2016,4,1,4,22,70,233,303
2016,4,1,4,23,57,147,204
2016,4,2,5,0,38,111,149
2016,4,2,5,1,22,80,102
2016,4,2,5,2,9,66,75
2016,4,2,5,3,11,18,29
2016,4,2,5,4,4,8,12
2016,4,2,5,5,3,14,17
2016,4,2,5,6,7,18,25
2016,4,2,5,7,6,39,45
2016,4,2,5,8,20,96,116
2016,4,2,5,9,46,148,194
2016,4,2,5,10,55,189,244
2016,4,2,5,11,117,310,427
2016,4,2,5,12,280,495,775
2016,4,2,5,13,395,531,926
2016,4,2,5,14,435,518,953
2016,4,2,5,15,440,580,1020
2016,4,2,5,16,442,572,1014
2016,4,2,5,17,395,545,940
2016,4,2,5,18,333,478,811
2016,4,2,5,19,187,373,560
2016,4,2,5,20,134,239,373
2016,4,2,5,21,58,199,257
2016,4,2,5,22,31,128,159
2016,4,2,5,23,10,48,58
2016,4,3,6,0,3,57,60
2016,4,3,6,1,3,58,61
2016,4,3,6,2,5,31,36
2016,4,3,6,3,1,18,19
2016,4,3,6,4,0,6,6
2016,4,3,6,5,2,10,12
2016,4,3,6,6,5,109,114
2016,4,3,6,7,15,90,105
2016,4,3,6,8,25,110,135
2016,4,3,6,9,33,206,239
2016,4,3,6,10,88,271,359
2016,4,3,6,11,165,317,482
2016,4,3,6,12,167,388,555
2016,4,3,6,13,189,398,587
2016,4,3,6,14,169,438,607
2016,4,3,6,15,240,439,679
2016,4,3,6,16,219,397,616
2016,4,3,6,17,213,379,592
2016,4,3,6,18,152,376,528
2016,4,3,6,19,98,292,390
2016,4,3,6,20,54,216,270
2016,4,3,6,21,38,126,164
2016,4,3,6,22,32,99,131
2016,4,3,6,23,5,48,53
2016,4,4,0,0,14,25,39
2016,4,4,0,1,3,10,13
2016,4,4,0,2,3,1,4
2016,4,4,0,3,0,3,3
2016,4,4,0,4,1,7,8
2016,4,4,0,5,0,62,62
2016,4,4,0,6,5,213,218
2016,4,4,0,7,25,705,730
2016,4,4,0,8,38,1165,1203
2016,4,4,0,9,54,458,512
2016,4,4,0,10,82,203,285
2016,4,4,0,11,140,232,372
2016,4,4,0,12,117,315,432
2016,4,4,0,13,153,303,456
2016,4,4,0,14,110,239,349
2016,4,4,0,15,70,337,407
2016,4,4,0,16,44,282,326
2016,4,4,0,17,26,413,439
2016,4,4,0,18,17,314,331
2016,4,4,0,19,31,383,414
2016,4,4,0,20,15,340,355
2016,4,4,0,21,9,218,227
2016,4,4,0,22,13,116,129
2016,4,4,0,23,1,83,84
2016,4,5,1,0,3,22,25
2016,4,5,1,1,0,7,7
2016,4,5,1,2,0,2,2
2016,4,5,1,3,0,3,3
2016,4,5,1,4,0,6,6
2016,4,5,1,5,0,67,67
2016,4,5,1,6,7,182,189
2016,4,5,1,7,12,527,539
2016,4,5,1,8,19,867,886
2016,4,5,1,9,40,359,399
2016,4,5,1,10,35,157,192
2016,4,5,1,11,35,156,191
2016,4,5,1,12,41,245,286
2016,4,5,1,13,32,228,260
2016,4,5,1,14,48,199,247
2016,4,5,1,15,51,259,310
2016,4,5,1,16,69,473,542
2016,4,5,1,17,93,978,1071
2016,4,5,1,18,80,840,920
2016,4,5,1,19,31,530,561
2016,4,5,1,20,6,331,337
2016,4,5,1,21,20,240,260
2016,4,5,1,22,20,121,141
2016,4,5,1,23,3,68,71
2016,4,6,2,0,0,33,33
2016,4,6,2,1,1,4,5
2016,4,6,2,2,1,3,4
2016,4,6,2,3,0,1,1
2016,4,6,2,4,1,4,5
2016,4,6,2,5,0,49,49
2016,4,6,2,6,2,190,192
2016,4,6,2,7,16,570,586
2016,4,6,2,8,20,1029,1049
2016,4,6,2,9,40,469,509
2016,4,6,2,10,47,187,234
2016,4,6,2,11,79,227,306
2016,4,6,2,12,72,271,343
2016,4,6,2,13,101,255,356
2016,4,6,2,14,89,251,340
2016,4,6,2,15,98,273,371
2016,4,6,2,16,107,520,627
2016,4,6,2,17,120,1071,1191
2016,4,6,2,18,84,1023,1107
2016,4,6,2,19,60,630,690
2016,4,6,2,20,54,410,464
2016,4,6,2,21,30,304,334
2016,4,6,2,22,21,164,185
2016,4,6,2,23,12,75,87
2016,4,7,3,0,3,33,36
2016,4,7,3,1,4,14,18
2016,4,7,3,2,1,3,4
2016,4,7,3,3,0,1,1
2016,4,7,3,4,0,9,9
2016,4,7,3,5,1,59,60
2016,4,7,3,6,3,229,232
2016,4,7,3,7,7,259,266
2016,4,7,3,8,4,341,345
2016,4,7,3,9,3,95,98
2016,4,7,3,10,3,25,28
2016,4,7,3,11,12,142,154
2016,4,7,3,12,35,204,239
2016,4,7,3,13,46,248,294
2016,4,7,3,14,65,271,336
2016,4,7,3,15,72,336,408
2016,4,7,3,16,64,356,420
2016,4,7,3,17,27,320,347
2016,4,7,3,18,44,699,743
2016,4,7,3,19,45,429,474
2016,4,7,3,20,23,336,359
2016,4,7,3,21,17,246,263
2016,4,7,3,22,10,186,196
2016,4,7,3,23,1,102,103
2016,4,8,4,0,5,41,46
2016,4,8,4,1,7,13,20
2016,4,8,4,2,4,14,18
2016,4,8,4,3,0,2,2
2016,4,8,4,4,0,11,11
2016,4,8,4,5,1,48,49
2016,4,8,4,6,4,198,202
2016,4,8,4,7,15,591,606
2016,4,8,4,8,34,982,1016
2016,4,8,4,9,65,525,590
2016,4,8,4,10,79,224,303
2016,4,8,4,11,110,273,383
2016,4,8,4,12,115,285,400
2016,4,8,4,13,136,330,466
2016,4,8,4,14,138,288,426
2016,4,8,4,15,189,355,544
2016,4,8,4,16,163,578,741
2016,4,8,4,17,192,955,1147
2016,4,8,4,18,144,794,938
2016,4,8,4,19,115,528,643
2016,4,8,4,20,50,311,361
2016,4,8,4,21,34,233,267
2016,4,8,4,22,18,173,191
2016,4,8,4,23,33,126,159
2016,4,9,5,0,9,102,111
2016,4,9,5,1,12,47,59
2016,4,9,5,2,8,41,49
2016,4,9,5,3,5,20,25
2016,4,9,5,4,0,4,4
2016,4,9,5,5,0,3,3
2016,4,9,5,6,6,17,23
2016,4,9,5,7,8,37,45
2016,4,9,5,8,13,110,123
2016,4,9,5,9,33,187,220
2016,4,9,5,10,6,100,106
2016,4,9,5,11,20,126,146
2016,4,9,5,12,45,217,262
2016,4,9,5,13,60,270,330
2016,4,9,5,14,87,286,373
2016,4,9,5,15,153,345,498
2016,4,9,5,16,138,269,407
2016,4,9,5,17,66,270,336
2016,4,9,5,18,52,241,293
2016,4,9,5,19,36,189,225
2016,4,9,5,20,16,138,154
2016,4,9,5,21,13,118,131
2016,4,9,5,22,7,75,82
2016,4,9,5,23,2,62,64
2016,4,10,6,0,1,51,52
2016,4,10,6,1,7,51,58
2016,4,10,6,2,3,29,32
2016,4,10,6,3,4,19,23
2016,4,10,6,4,0,3,3
2016,4,10,6,5,1,2,3
2016,4,10,6,6,3,9,12
2016,4,10,6,7,11,37,48
2016,4,10,6,8,24,103,127
2016,4,10,6,9,76,178,254
2016,4,10,6,10,132,314,446
2016,4,10,6,11,205,375,580
2016,4,10,6,12,250,424,674
2016,4,10,6,13,283,433,716
2016,4,10,6,14,286,400,686
2016,4,10,6,15,287,419,706
2016,4,10,6,16,252,501,753
2016,4,10,6,17,263,432,695
2016,4,10,6,18,163,383,546
2016,4,10,6,19,98,313,411
2016,4,10,6,20,73,182,255
2016,4,10,6,21,46,122,168
2016,4,10,6,22,29,101,130
2016,4,10,6,23,10,33,43
2016,4,11,0,0,5,17,22
2016,4,11,0,1,2,5,7
2016,4,11,0,2,3,5,8
2016,4,11,0,3,0,1,1
2016,4,11,0,4,0,5,5
2016,4,11,0,5,1,60,61
2016,4,11,0,6,3,158,161
2016,4,11,0,7,13,458,471
2016,4,11,0,8,13,647,660
2016,4,11,0,9,32,443,475
2016,4,11,0,10,65,167,232
2016,4,11,0,11,108,215,323
2016,4,11,0,12,89,272,361
2016,4,11,0,13,114,299,413
2016,4,11,0,14,127,260,387
2016,4,11,0,15,145,311,456
2016,4,11,0,16,177,579,756
2016,4,11,0,17,134,1188,1322
2016,4,11,0,18,168,1151,1319
2016,4,11,0,19,113,685,798
2016,4,11,0,20,53,458,511
2016,4,11,0,21,50,318,368
2016,4,11,0,22,39,202,241
2016,4,11,0,23,25,73,98
2016,4,12,1,0,9,38,47
2016,4,12,1,1,1,8,9
2016,4,12,1,2,5,7,12
2016,4,12,1,3,0,4,4
2016,4,12,1,4,0,8,8
2016,4,12,1,5,0,81,81
2016,4,12,1,6,5,190,195
2016,4,12,1,7,3,423,426
2016,4,12,1,8,18,779,797
2016,4,12,1,9,7,180,187
2016,4,12,1,10,26,145,171
2016,4,12,1,11,47,229,276
2016,4,12,1,12,42,250,292
2016,4,12,1,13,56,299,355
2016,4,12,1,14,95,265,360
2016,4,12,1,15,92,367,459
2016,4,12,1,16,137,611,748
2016,4,12,1,17,122,1223,1345
2016,4,12,1,18,78,985,1063
2016,4,12,1,19,64,611,675
2016,4,12,1,20,59,382,441
2016,4,12,1,21,22,280,302
2016,4,12,1,22,29,212,241
2016,4,12,1,23,9,80,89
2016,4,13,2,0,7,23,30
2016,4,13,2,1,8,11,19
2016,4,13,2,2,4,3,7
2016,4,13,2,3,0,2,2
2016,4,13,2,4,1,11,12
2016,4,13,2,5,1,70,71
2016,4,13,2,6,3,252,255
2016,4,13,2,7,18,729,747
2016,4,13,2,8,30,1148,1178
2016,4,13,2,9,53,485,538
2016,4,13,2,10,60,214,274
2016,4,13,2,11,85,236,321
2016,4,13,2,12,92,314,406
2016,4,13,2,13,102,320,422
2016,4,13,2,14,115,223,338
2016,4,13,2,15,96,338,434
2016,4,13,2,16,88,610,698
2016,4,13,2,17,114,1296,1410
2016,4,13,2,18,103,1075,1178
2016,4,13,2,19,67,634,701
2016,4,13,2,20,28,396,424
2016,4,13,2,21,41,306,347
2016,4,13,2,22,24,199,223
2016,4,13,2,23,12,84,96
2016,4,14,3,0,3,22,25
2016,4,14,3,1,4,17,21
2016,4,14,3,2,0,10,10
2016,4,14,3,3,0,2,2
2016,4,14,3,4,3,5,8
2016,4,14,3,5,1,55,56
2016,4,14,3,6,5,232,237
2016,4,14,3,7,22,688,710
2016,4,14,3,8,39,1158,1197
2016,4,14,3,9,53,492,545
2016,4,14,3,10,62,230,292
2016,4,14,3,11,117,252,369
2016,4,14,3,12,80,343,423
2016,4,14,3,13,94,364,458
2016,4,14,3,14,149,304,453
2016,4,14,3,15,133,393,526
2016,4,14,3,16,128,597,725
2016,4,14,3,17,137,1256,1393
2016,4,14,3,18,102,1083,1185
2016,4,14,3,19,92,619,711
2016,4,14,3,20,43,442,485
2016,4,14,3,21,32,299,331
2016,4,14,3,22,19,222,241
2016,4,14,3,23,5,115,120
2016,4,15,4,0,5,44,49
2016,4,15,4,1,1,34,35
2016,4,15,4,2,0,13,13
2016,4,15,4,3,4,3,7
2016,4,15,4,4,2,4,6
2016,4,15,4,5,1,59,60
2016,4,15,4,6,2,193,195
2016,4,15,4,7,39,594,633
2016,4,15,4,8,57,1089,1146
2016,4,15,4,9,58,540,598
2016,4,15,4,10,90,254,344
2016,4,15,4,11,153,345,498
2016,4,15,4,12,212,415,627
2016,4,15,4,13,226,433,659
2016,4,15,4,14,243,359,602
2016,4,15,4,15,272,423,695
2016,4,15,4,16,246,702,948
2016,4,15,4,17,246,1135,1381
2016,4,15,4,18,161,885,1046
2016,4,15,4,19,113,617,730
2016,4,15,4,20,78,378,456
2016,4,15,4,21,40,209,249
2016,4,15,4,22,45,192,237
2016,4,15,4,23,35,146,181
2016,4,16,5,0,16,90,106
2016,4,16,5,1,4,71,75
2016,4,16,5,2,2,41,43
2016,4,16,5,3,1,17,18
2016,4,16,5,4,2,3,5
2016,4,16,5,5,0,13,13
2016,4,16,5,6,10,31,41
2016,4,16,5,7,27,95,122
2016,4,16,5,8,58,223,281
2016,4,16,5,9,141,432,573
2016,4,16,5,10,288,464,752
2016,4,16,5,11,420,549,969
2016,4,16,5,12,567,728,1295
2016,4,16,5,13,596,582,1178
2016,4,16,5,14,657,547,1204
2016,4,16,5,15,704,673,1377
2016,4,16,5,16,601,610,1211
2016,4,16,5,17,564,546,1110
2016,4,16,5,18,426,506,932
2016,4,16,5,19,319,454,773
2016,4,16,5,20,223,295,518
2016,4,16,5,21,148,257,405
2016,4,16,5,22,105,188,293
2016,4,16,5,23,90,121,211
2016,4,17,6,0,27,104,131
2016,4,17,6,1,22,77,99
2016,4,17,6,2,13,53,66
2016,4,17,6,3,3,30,33
2016,4,17,6,4,1,4,5
2016,4,17,6,5,3,9,12
2016,4,17,6,6,10,14,24
2016,4,17,6,7,17,55,72
2016,4,17,6,8,79,191,270
2016,4,17,6,9,179,300,479
2016,4,17,6,10,312,423,735
2016,4,17,6,11,451,532,983
2016,4,17,6,12,492,635,1127
2016,4,17,6,13,557,650,1207
2016,4,17,6,14,493,653,1146
2016,4,17,6,15,542,633,1175
2016,4,17,6,16,504,570,1074
2016,4,17,6,17,470,588,1058
2016,4,17,6,18,354,525,879
2016,4,17,6,19,288,432,720
2016,4,17,6,20,186,295,481
2016,4,17,6,21,137,200,337
2016,4,17,6,22,76,93,169
2016,4,17,6,23,36,49,85
2016,4,18,0,0,25,26,51
2016,4,18,0,1,9,12,21
2016,4,18,0,2,3,8,11
2016,4,18,0,3,0,5,5
2016,4,18,0,4,1,9,10
2016,4,18,0,5,0,58,58
2016,4,18,0,6,12,258,270
2016,4,18,0,7,25,754,779
2016,4,18,0,8,71,1111,1182
2016,4,18,0,9,101,497,598
2016,4,18,0,10,114,189,303
2016,4,18,0,11,141,262,403
2016,4,18,0,12,147,324,471
2016,4,18,0,13,235,348,583
2016,4,18,0,14,203,274,477
2016,4,18,0,15,178,344,522
2016,4,18,0,16,182,634,816
2016,4,18,0,17,212,1324,1536
2016,4,18,0,18,200,1154,1354
2016,4,18,0,19,169,752,921
2016,4,18,0,20,110,521,631
2016,4,18,0,21,119,357,476
2016,4,18,0,22,87,177,264
2016,4,18,0,23,65,75,140
2016,4,19,1,0,8,21,29
2016,4,19,1,1,14,9,23
2016,4,19,1,2,3,8,11
2016,4,19,1,3,4,1,5
2016,4,19,1,4,3,9,12
2016,4,19,1,5,4,85,89
2016,4,19,1,6,21,300,321
2016,4,19,1,7,41,860,901
2016,4,19,1,8,54,1250,1304
2016,4,19,1,9,61,504,565
2016,4,19,1,10,125,257,382
2016,4,19,1,11,110,287,397
2016,4,19,1,12,165,326,491
2016,4,19,1,13,140,319,459
2016,4,19,1,14,155,288,443
2016,4,19,1,15,177,384,561
2016,4,19,1,16,184,626,810
2016,4,19,1,17,226,1324,1550
2016,4,19,1,18,152,1233,1385
2016,4,19,1,19,136,775,911
2016,4,19,1,20,79,489,568
2016,4,19,1,21,41,336,377
2016,4,19,1,22,44,173,217
2016,4,19,1,23,15,101,116
2016,4,20,2,0,27,34,61
2016,4,20,2,1,10,12,22
2016,4,20,2,2,0,6,6
2016,4,20,2,3,0,4,4
2016,4,20,2,4,0,6,6
2016,4,20,2,5,1,89,90
2016,4,20,2,6,9,319,328
2016,4,20,2,7,21,833,854
2016,4,20,2,8,54,1241,1295
2016,4,20,2,9,69,554,623
2016,4,20,2,10,76,209,285
2016,4,20,2,11,104,279,383
2016,4,20,2,12,105,376,481
2016,4,20,2,13,85,372,457
2016,4,20,2,14,145,289,434
2016,4,20,2,15,146,348,494
2016,4,20,2,16,190,697,887
2016,4,20,2,17,176,1356,1532
2016,4,20,2,18,149,1088,1237
2016,4,20,2,19,119,744,863
2016,4,20,2,20,91,465,556
2016,4,20,2,21,83,318,401
2016,4,20,2,22,29,205,234
2016,4,20,2,23,23,94,117
2016,4,21,3,0,13,30,43
2016,4,21,3,1,3,16,19
2016,4,21,3,2,0,4,4
2016,4,21,3,3,0,3,3
2016,4,21,3,4,1,5,6
2016,4,21,3,5,1,82,83
2016,4,21,3,6,1,289,290
2016,4,21,3,7,23,818,841
2016,4,21,3,8,51,1240,1291
2016,4,21,3,9,56,499,555
2016,4,21,3,10,74,239,313
2016,4,21,3,11,113,280,393
2016,4,21,3,12,133,371,504
2016,4,21,3,13,139,346,485
2016,4,21,3,14,142,304,446
2016,4,21,3,15,144,360,504
2016,4,21,3,16,193,669,862
2016,4,21,3,17,187,1267,1454
2016,4,21,3,18,172,1123,1295
2016,4,21,3,19,107,655,762
2016,4,21,3,20,73,449,522
2016,4,21,3,21,71,333,404
2016,4,21,3,22,26,217,243
2016,4,21,3,23,15,110,125
2016,4,22,4,0,21,56,77
2016,4,22,4,1,9,28,37
2016,4,22,4,2,6,5,11
2016,4,22,4,3,1,13,14
2016,4,22,4,4,1,16,17
2016,4,22,4,5,1,86,87
2016,4,22,4,6,5,284,289
2016,4,22,4,7,13,698,711
2016,4,22,4,8,54,1192,1246
2016,4,22,4,9,96,492,588
2016,4,22,4,10,144,247,391
2016,4,22,4,11,177,267,444
2016,4,22,4,12,190,384,574
2016,4,22,4,13,160,322,482
2016,4,22,4,14,160,286,446
2016,4,22,4,15,176,384,560
2016,4,22,4,16,209,724,933
2016,4,22,4,17,179,1243,1422
2016,4,22,4,18,164,872,1036
2016,4,22,4,19,103,502,605
2016,4,22,4,20,44,296,340
2016,4,22,4,21,62,256,318
2016,4,22,4,22,70,223,293
2016,4,22,4,23,23,149,172
2016,4,23,5,0,21,94,115
2016,4,23,5,1,8,65,73
2016,4,23,5,2,13,38,51
2016,4,23,5,3,5,21,26
2016,4,23,5,4,1,5,6
2016,4,23,5,5,4,5,9
2016,4,23,5,6,6,27,33
2016,4,23,5,7,24,102,126
2016,4,23,5,8,47,186,233
2016,4,23,5,9,37,132,169
2016,4,23,5,10,38,134,172
2016,4,23,5,11,33,108,141
2016,4,23,5,12,151,308,459
2016,4,23,5,13,241,406,647
2016,4,23,5,14,340,467,807
2016,4,23,5,15,321,527,848
2016,4,23,5,16,359,542,901
2016,4,23,5,17,381,545,926
2016,4,23,5,18,339,514,853
2016,4,23,5,19,272,411,683
2016,4,23,5,20,170,286,456
2016,4,23,5,21,105,255,360
2016,4,23,5,22,51,152,203
2016,4,23,5,23,51,139,190
2016,4,24,6,0,35,97,132
2016,4,24,6,1,6,67,73
2016,4,24,6,2,4,42,46
2016,4,24,6,3,1,29,30
2016,4,24,6,4,0,7,7
2016,4,24,6,5,3,10,13
2016,4,24,6,6,9,16,25
2016,4,24,6,7,24,75,99
2016,4,24,6,8,41,154,195
2016,4,24,6,9,153,282,435
2016,4,24,6,10,302,494,796
2016,4,24,6,11,441,570,1011
2016,4,24,6,12,506,662,1168
2016,4,24,6,13,509,603,1112
2016,4,24,6,14,570,600,1170
2016,4,24,6,15,461,605,1066
2016,4,24,6,16,478,635,1113
2016,4,24,6,17,396,578,974
2016,4,24,6,18,341,539,880
2016,4,24,6,19,230,394,624
2016,4,24,6,20,149,291,440
2016,4,24,6,21,84,154,238
2016,4,24,6,22,50,156,206
2016,4,24,6,23,23,72,95
2016,4,25,0,0,24,26,50
2016,4,25,0,1,15,12,27
2016,4,25,0,2,2,8,10
2016,4,25,0,3,1,1,2
2016,4,25,0,4,0,5,5
2016,4,25,0,5,6,74,80
2016,4,25,0,6,4,264,268
2016,4,25,0,7,17,773,790
2016,4,25,0,8,28,1150,1178
2016,4,25,0,9,82,419,501
2016,4,25,0,10,178,205,383
2016,4,25,0,11,210,245,455
2016,4,25,0,12,168,351,519
2016,4,25,0,13,163,317,480
2016,4,25,0,14,190,268,458
2016,4,25,0,15,218,353,571
2016,4,25,0,16,201,645,846
2016,4,25,0,17,233,1349,1582
2016,4,25,0,18,189,1136,1325
2016,4,25,0,19,143,725,868
2016,4,25,0,20,121,496,617
2016,4,25,0,21,61,337,398
2016,4,25,0,22,28,166,194
2016,4,25,0,23,14,73,87
2016,4,26,1,0,5,32,37
2016,4,26,1,1,5,12,17
2016,4,26,1,2,0,3,3
2016,4,26,1,3,0,4,4
2016,4,26,1,4,1,10,11
2016,4,26,1,5,4,81,85
2016,4,26,1,6,7,333,340
2016,4,26,1,7,35,861,896
2016,4,26,1,8,55,1277,1332
2016,4,26,1,9,93,498,591
2016,4,26,1,10,124,213,337
2016,4,26,1,11,126,302,428
2016,4,26,1,12,111,345,456
2016,4,26,1,13,134,342,476
2016,4,26,1,14,132,277,409
2016,4,26,1,15,134,348,482
2016,4,26,1,16,151,614,765
2016,4,26,1,17,152,1321,1473
2016,4,26,1,18,133,1184,1317
2016,4,26,1,19,126,751,877
2016,4,26,1,20,80,481,561
2016,4,26,1,21,63,327,390
2016,4,26,1,22,63,233,296
2016,4,26,1,23,20,115,135
2016,4,27,2,0,15,42,57
2016,4,27,2,1,6,23,29
2016,4,27,2,2,1,6,7
2016,4,27,2,3,0,4,4
2016,4,27,2,4,1,11,12
2016,4,27,2,5,0,79,79
2016,4,27,2,6,4,236,240
2016,4,27,2,7,17,631,648
2016,4,27,2,8,24,661,685
2016,4,27,2,9,13,274,287
2016,4,27,2,10,44,165,209
2016,4,27,2,11,57,193,250
2016,4,27,2,12,65,261,326
2016,4,27,2,13,65,268,333
2016,4,27,2,14,76,221,297
2016,4,27,2,15,82,290,372
2016,4,27,2,16,91,567,658
2016,4,27,2,17,122,1134,1256
2016,4,27,2,18,64,889,953
2016,4,27,2,19,68,548,616
2016,4,27,2,20,44,365,409
2016,4,27,2,21,21,275,296
2016,4,27,2,22,26,198,224
2016,4,27,2,23,18,95,113
2016,4,28,3,0,16,35,51
2016,4,28,3,1,2,14,16
2016,4,28,3,2,4,6,10
2016,4,28,3,3,0,5,5
2016,4,28,3,4,1,7,8
2016,4,28,3,5,1,61,62
2016,4,28,3,6,3,194,197
2016,4,28,3,7,13,628,641
2016,4,28,3,8,25,694,719
2016,4,28,3,9,12,177,189
2016,4,28,3,10,5,46,51
2016,4,28,3,11,4,44,48
2016,4,28,3,12,9,82,91
2016,4,28,3,13,21,166,187
2016,4,28,3,14,48,184,232
2016,4,28,3,15,40,163,203
2016,4,28,3,16,23,198,221
2016,4,28,3,17,20,531,551
2016,4,28,3,18,42,625,667
2016,4,28,3,19,36,428,464
2016,4,28,3,20,15,264,279
2016,4,28,3,21,4,79,83
2016,4,28,3,22,4,112,116
2016,4,28,3,23,5,99,104
2016,4,29,4,0,2,46,48
2016,4,29,4,1,2,16,18
2016,4,29,4,2,0,4,4
2016,4,29,4,3,0,3,3
2016,4,29,4,4,0,9,9
2016,4,29,4,5,1,58,59
2016,4,29,4,6,5,177,182
2016,4,29,4,7,10,470,480
2016,4,29,4,8,31,987,1018
2016,4,29,4,9,26,508,534
2016,4,29,4,10,32,192,224
2016,4,29,4,11,69,184,253
2016,4,29,4,12,73,310,383
2016,4,29,4,13,84,292,376
2016,4,29,4,14,100,305,405
2016,4,29,4,15,124,331,455
2016,4,29,4,16,92,529,621
2016,4,29,4,17,118,948,1066
2016,4,29,4,18,92,743,835
2016,4,29,4,19,59,456,515
2016,4,29,4,20,36,213,249
2016,4,29,4,21,37,149,186
2016,4,29,4,22,34,151,185
2016,4,29,4,23,28,122,150
2016,4,30,5,0,17,81,98
2016,4,30,5,1,9,52,61
2016,4,30,5,2,8,54,62
2016,4,30,5,3,6,32,38
2016,4,30,5,4,6,6,12
2016,4,30,5,5,3,9,12
2016,4,30,5,6,13,36,49
2016,4,30,5,7,19,70,89
2016,4,30,5,8,51,205,256
2016,4,30,5,9,101,299,400
2016,4,30,5,10,167,398,565
2016,4,30,5,11,266,467,733
2016,4,30,5,12,226,509,735
2016,4,30,5,13,339,453,792
2016,4,30,5,14,317,465,782
2016,4,30,5,15,295,452,747
2016,4,30,5,16,347,446,793
2016,4,30,5,17,282,429,711
2016,4,30,5,18,149,382,531
2016,4,30,5,19,111,322,433
2016,4,30,5,20,69,205,274
2016,4,30,5,21,21,112,133
2016,4,30,5,22,10,69,79
2016,4,30,5,23,13,113,126
2016,5,1,6,0,11,69,80
2016,5,1,6,1,6,56,62
2016,5,1,6,2,3,30,33
2016,5,1,6,3,0,19,19
2016,5,1,6,4,0,8,8
2016,5,1,6,6,4,11,15
2016,5,1,6,7,3,19,22
2016,5,1,6,8,1,43,44
2016,5,1,6,9,8,73,81
2016,5,1,6,10,10,98,108
2016,5,1,6,11,11,102,113
2016,5,1,6,12,49,228,277
2016,5,1,6,13,92,278,370
2016,5,1,6,14,115,328,443
2016,5,1,6,15,150,372,522
2016,5,1,6,16,150,365,515
2016,5,1,6,17,134,340,474
2016,5,1,6,18,71,336,407
2016,5,1,6,19,54,238,292
2016,5,1,6,20,35,169,204
2016,5,1,6,21,18,100,118
2016,5,1,6,22,12,100,112
2016,5,1,6,23,10,47,57
2016,5,2,0,0,1,25,26
2016,5,2,0,1,2,2,4
2016,5,2,0,2,0,5,5
2016,5,2,0,3,1,1,2
2016,5,2,0,4,3,7,10
2016,5,2,0,5,2,56,58
2016,5,2,0,6,4,147,151
2016,5,2,0,7,9,526,535
2016,5,2,0,8,23,958,981
2016,5,2,0,9,45,456,501
2016,5,2,0,10,77,185,262
2016,5,2,0,11,110,211,321
2016,5,2,0,12,124,325,449
2016,5,2,0,13,155,323,478
2016,5,2,0,14,115,264,379
2016,5,2,0,15,144,339,483
2016,5,2,0,16,171,580,751
2016,5,2,0,17,168,1276,1444
2016,5,2,0,18,88,718,806
2016,5,2,0,19,9,128,137
2016,5,2,0,20,14,115,129
2016,5,2,0,21,1,91,92
2016,5,2,0,22,6,65,71
2016,5,2,0,23,3,61,64
2016,5,3,1,0,5,17,22
2016,5,3,1,1,4,8,12
2016,5,3,1,2,1,8,9
2016,5,3,1,3,0,6,6
2016,5,3,1,4,0,5,5
2016,5,3,1,5,1,63,64
2016,5,3,1,6,7,153,160
2016,5,3,1,7,4,513,517
2016,5,3,1,8,18,979,997
2016,5,3,1,9,36,481,517
2016,5,3,1,10,39,240,279
2016,5,3,1,11,68,252,320
2016,5,3,1,12,69,292,361
2016,5,3,1,13,65,318,383
2016,5,3,1,14,91,301,392
2016,5,3,1,15,93,361,454
2016,5,3,1,16,103,563,666
2016,5,3,1,17,31,450,481
2016,5,3,1,18,42,774,816
2016,5,3,1,19,32,630,662
2016,5,3,1,20,30,394,424
2016,5,3,1,21,21,283,304
2016,5,3,1,22,31,168,199
2016,5,3,1,23,12,70,82
2016,5,4,2,0,4,19,23
2016,5,4,2,1,2,3,5
2016,5,4,2,2,0,1,1
2016,5,4,2,3,0,3,3
2016,5,4,2,4,0,7,7
2016,5,4,2,5,1,86,87
2016,5,4,2,6,7,243,250
2016,5,4,2,7,17,706,723
2016,5,4,2,8,48,1122,1170
2016,5,4,2,9,39,497,536
2016,5,4,2,10,50,238,288
2016,5,4,2,11,78,287,365
2016,5,4,2,12,98,324,422
2016,5,4,2,13,104,327,431
2016,5,4,2,14,88,271,359
2016,5,4,2,15,69,313,382
2016,5,4,2,16,80,575,655
2016,5,4,2,17,111,1196,1307
2016,5,4,2,18,73,945,1018
2016,5,4,2,19,43,507,550
2016,5,4,2,20,42,366,408
2016,5,4,2,21,32,309,341
2016,5,4,2,22,22,159,181
2016,5,4,2,23,10,103,113
2016,5,5,3,0,7,43,50
2016,5,5,3,1,0,12,12
2016,5,5,3,2,0,2,2
2016,5,5,3,3,2,3,5
2016,5,5,3,4,0,7,7
2016,5,5,3,5,0,54,54
2016,5,5,3,6,8,219,227
2016,5,5,3,7,14,396,410
2016,5,5,3,8,25,891,916
2016,5,5,3,9,36,444,480
2016,5,5,3,10,36,165,201
2016,5,5,3,11,42,231,273
2016,5,5,3,12,50,243,293
2016,5,5,3,13,61,281,342
2016,5,5,3,14,68,235,303
2016,5,5,3,15,74,323,397
2016,5,5,3,16,105,553,658
2016,5,5,3,17,158,1266,1424
2016,5,5,3,18,86,964,1050
2016,5,5,3,19,52,558,610
2016,5,5,3,20,30,385,415
2016,5,5,3,21,15,276,291
2016,5,5,3,22,9,174,183
2016,5,5,3,23,15,108,123
2016,5,6,4,0,3,50,53
2016,5,6,4,1,3,32,35
2016,5,6,4,2,2,17,19
2016,5,6,4,3,2,7,9
2016,5,6,4,4,0,9,9
2016,5,6,4,5,3,53,56
2016,5,6,4,6,3,91,94
2016,5,6,4,7,8,194,202
2016,5,6,4,8,5,331,336
2016,5,6,4,9,3,150,153
2016,5,6,4,10,9,56,65
2016,5,6,4,11,3,47,50
2016,5,6,4,12,2,41,43
2016,5,6,4,13,3,44,47
2016,5,6,4,14,6,45,51
2016,5,6,4,15,17,108,125
2016,5,6,4,16,6,121,127
2016,5,6,4,17,7,262,269
2016,5,6,4,18,16,368,384
2016,5,6,4,19,19,339,358
2016,5,6,4,20,22,253,275
2016,5,6,4,21,18,149,167
2016,5,6,4,22,4,89,93
2016,5,6,4,23,5,77,82
2016,5,7,5,0,3,60,63
2016,5,7,5,1,0,38,38
2016,5,7,5,2,1,19,20
2016,5,7,5,3,0,11,11
2016,5,7,5,4,0,9,9
2016,5,7,5,5,0,4,4
2016,5,7,5,6,5,31,36
2016,5,7,5,7,9,116,125
2016,5,7,5,8,31,193,224
2016,5,7,5,9,102,346,448
2016,5,7,5,10,139,414,553
2016,5,7,5,11,188,429,617
2016,5,7,5,12,214,527,741
2016,5,7,5,13,269,550,819
2016,5,7,5,14,258,478,736
2016,5,7,5,15,328,480,808
2016,5,7,5,16,302,503,805
2016,5,7,5,17,292,485,777
2016,5,7,5,18,229,419,648
2016,5,7,5,19,189,416,605
2016,5,7,5,20,144,264,408
2016,5,7,5,21,90,222,312
2016,5,7,5,22,59,210,269
2016,5,7,5,23,27,122,149
2016,5,8,6,0,40,89,129
2016,5,8,6,1,18,72,90
2016,5,8,6,2,3,49,52
2016,5,8,6,3,0,12,12
2016,5,8,6,4,1,4,5
2016,5,8,6,5,2,9,11
2016,5,8,6,6,8,15,23
2016,5,8,6,7,16,61,77
2016,5,8,6,8,37,145,182
2016,5,8,6,9,120,270,390
2016,5,8,6,10,256,439,695
2016,5,8,6,11,341,516,857
2016,5,8,6,12,393,569,962
2016,5,8,6,13,465,650,1115
2016,5,8,6,14,452,592,1044
2016,5,8,6,15,488,598,1086
2016,5,8,6,16,442,553,995
2016,5,8,6,17,333,518,851
2016,5,8,6,18,218,513,731
2016,5,8,6,19,181,391,572
2016,5,8,6,20,110,311,421
2016,5,8,6,21,70,163,233
2016,5,8,6,22,37,142,179
2016,5,8,6,23,26,65,91
2016,5,9,0,0,10,30,40
2016,5,9,0,1,2,11,13
2016,5,9,0,2,0,7,7
2016,5,9,0,3,0,3,3
2016,5,9,0,4,2,7,9
2016,5,9,0,5,3,58,61
2016,5,9,0,6,10,240,250
2016,5,9,0,7,18,744,762
2016,5,9,0,8,42,1141,1183
2016,5,9,0,9,68,457,525
2016,5,9,0,10,71,198,269
2016,5,9,0,11,47,101,148
2016,5,9,0,12,28,109,137
2016,5,9,0,13,20,101,121
2016,5,9,0,14,54,154,208
2016,5,9,0,15,73,266,339
2016,5,9,0,16,100,523,623
2016,5,9,0,17,127,1216,1343
2016,5,9,0,18,119,1150,1269
2016,5,9,0,19,88,662,750
2016,5,9,0,20,48,435,483
2016,5,9,0,21,33,271,304
2016,5,9,0,22,31,188,219
2016,5,9,0,23,28,70,98
2016,5,10,1,0,4,34,38
2016,5,10,1,1,2,9,11
2016,5,10,1,2,0,9,9
2016,5,10,1,3,1,3,4
2016,5,10,1,4,0,11,11
2016,5,10,1,5,1,79,80
2016,5,10,1,6,9,248,257
2016,5,10,1,7,23,744,767
2016,5,10,1,8,22,974,996
2016,5,10,1,9,38,392,430
2016,5,10,1,10,63,211,274
2016,5,10,1,11,88,248,336
2016,5,10,1,12,81,333,414
2016,5,10,1,13,120,328,448
2016,5,10,1,14,119,241,360
2016,5,10,1,15,109,304,413
2016,5,10,1,16,130,619,749
2016,5,10,1,17,166,1290,1456
2016,5,10,1,18,118,1087,1205
2016,5,10,1,19,79,713,792
2016,5,10,1,20,64,431,495
2016,5,10,1,21,38,296,334
2016,5,10,1,22,18,207,225
2016,5,10,1,23,18,120,138
2016,5,11,2,0,5,32,37
2016,5,11,2,1,4,9,13
2016,5,11,2,2,5,9,14
2016,5,11,2,3,0,1,1
2016,5,11,2,4,0,6,6
2016,5,11,2,5,7,80,87
2016,5,11,2,6,7,279,286
2016,5,11,2,7,20,750,770
2016,5,11,2,8,35,1221,1256
2016,5,11,2,9,30,358,388
2016,5,11,2,10,29,138,167
2016,5,11,2,11,54,189,243
2016,5,11,2,12,33,126,159
2016,5,11,2,13,24,103,127
2016,5,11,2,14,30,93,123
2016,5,11,2,15,21,97,118
2016,5,11,2,16,35,317,352
2016,5,11,2,17,57,777,834
2016,5,11,2,18,55,915,970
2016,5,11,2,19,58,546,604
2016,5,11,2,20,42,363,405
2016,5,11,2,21,28,304,332
2016,5,11,2,22,26,219,245
2016,5,11,2,23,15,117,132
2016,5,12,3,0,5,38,43
2016,5,12,3,1,4,25,29
2016,5,12,3,2,12,7,19
2016,5,12,3,3,5,1,6
2016,5,12,3,4,2,6,8
2016,5,12,3,5,0,83,83
2016,5,12,3,6,3,247,250
2016,5,12,3,7,12,781,793
2016,5,12,3,8,42,1186,1228
2016,5,12,3,9,59,480,539
2016,5,12,3,10,69,220,289
2016,5,12,3,11,82,245,327
2016,5,12,3,12,107,320,427
2016,5,12,3,13,148,334,482
2016,5,12,3,14,111,275,386
2016,5,12,3,15,119,365,484
2016,5,12,3,16,139,589,728
2016,5,12,3,17,158,1224,1382
2016,5,12,3,18,112,1128,1240
2016,5,12,3,19,108,653,761
2016,5,12,3,20,69,477,546
2016,5,12,3,21,55,285,340
2016,5,12,3,22,35,215,250
2016,5,12,3,23,32,133,165
2016,5,13,4,0,33,54,87
2016,5,13,4,1,19,33,52
2016,5,13,4,2,6,19,25
2016,5,13,4,3,0,2,2
2016,5,13,4,4,0,10,10
2016,5,13,4,5,1,68,69
2016,5,13,4,6,17,232,249
2016,5,13,4,7,29,618,647
2016,5,13,4,8,43,1093,1136
2016,5,13,4,9,38,468,506
2016,5,13,4,10,61,179,240
2016,5,13,4,11,27,79,106
2016,5,13,4,12,25,164,189
2016,5,13,4,13,63,288,351
2016,5,13,4,14,114,304,418
2016,5,13,4,15,135,411,546
2016,5,13,4,16,145,712,857
2016,5,13,4,17,168,1202,1370
2016,5,13,4,18,133,956,1089
2016,5,13,4,19,144,539,683
2016,5,13,4,20,83,401,484
2016,5,13,4,21,73,295,368
2016,5,13,4,22,111,269,380
2016,5,13,4,23,75,167,242
2016,5,14,5,0,33,114,147
2016,5,14,5,1,26,76,102
2016,5,14,5,2,12,48,60
2016,5,14,5,3,9,24,33
2016,5,14,5,4,1,8,9
2016,5,14,5,5,1,9,10
2016,5,14,5,6,8,36,44
2016,5,14,5,7,13,106,119
2016,5,14,5,8,71,259,330
2016,5,14,5,9,191,435,626
2016,5,14,5,10,269,541,810
2016,5,14,5,11,443,595,1038
2016,5,14,5,12,454,701,1155
2016,5,14,5,13,514,570,1084
2016,5,14,5,14,390,529,919
2016,5,14,5,15,81,165,246
2016,5,14,5,16,51,102,153
2016,5,14,5,17,175,242,417
2016,5,14,5,18,232,411,643
2016,5,14,5,19,165,302,467
2016,5,14,5,20,110,264,374
2016,5,14,5,21,50,219,269
2016,5,14,5,22,38,147,185
2016,5,14,5,23,25,124,149
2016,5,15,6,0,18,93,111
2016,5,15,6,1,7,82,89
2016,5,15,6,2,8,31,39
2016,5,15,6,3,2,19,21
2016,5,15,6,4,1,8,9
2016,5,15,6,5,0,7,7
2016,5,15,6,6,8,39,47
2016,5,15,6,7,20,91,111
2016,5,15,6,8,61,170,231
2016,5,15,6,9,86,257,343
2016,5,15,6,10,157,391,548
2016,5,15,6,11,229,425,654
2016,5,15,6,12,253,580,833
2016,5,15,6,13,302,517,819
2016,5,15,6,14,242,524,766
2016,5,15,6,15,245,487,732
2016,5,15,6,16,239,472,711
2016,5,15,6,17,227,424,651
2016,5,15,6,18,182,355,537
2016,5,15,6,19,199,298,497
2016,5,15,6,20,97,240,337
2016,5,15,6,21,56,129,185
2016,5,15,6,22,23,124,147
2016,5,15,6,23,24,58,82
2016,5,16,0,0,4,24,28
2016,5,16,0,1,9,13,22
2016,5,16,0,2,0,3,3
2016,5,16,0,3,0,1,1
2016,5,16,0,4,0,4,4
2016,5,16,0,5,1,69,70
2016,5,16,0,6,3,233,236
2016,5,16,0,7,26,714,740
2016,5,16,0,8,39,1053,1092
2016,5,16,0,9,60,450,510
2016,5,16,0,10,110,195,305
2016,5,16,0,11,189,220,409
2016,5,16,0,12,196,300,496
2016,5,16,0,13,147,341,488
2016,5,16,0,14,262,273,535
2016,5,16,0,15,250,386,636
2016,5,16,0,16,208,656,864
2016,5,16,0,17,191,1308,1499
2016,5,16,0,18,172,1100,1272
2016,5,16,0,19,135,676,811
2016,5,16,0,20,107,490,597
2016,5,16,0,21,102,315,417
2016,5,16,0,22,35,180,215
2016,5,16,0,23,21,86,107
2016,5,17,1,0,11,24,35
2016,5,17,1,1,3,10,13
2016,5,17,1,2,5,4,9
2016,5,17,1,3,0,5,5
2016,5,17,1,4,1,4,5
2016,5,17,1,5,2,71,73
2016,5,17,1,6,6,284,290
2016,5,17,1,7,23,664,687
2016,5,17,1,8,13,563,576
2016,5,17,1,9,7,196,203
2016,5,17,1,10,9,76,85
2016,5,17,1,11,9,52,61
2016,5,17,1,12,17,55,72
2016,5,17,1,13,10,83,93
2016,5,17,1,14,12,54,66
2016,5,17,1,15,12,74,86
2016,5,17,1,16,13,215,228
2016,5,17,1,17,23,651,674
2016,5,17,1,18,27,737,764
2016,5,17,1,19,29,544,573
2016,5,17,1,20,30,286,316
2016,5,17,1,21,14,212,226
2016,5,17,1,22,10,137,147
2016,5,17,1,23,7,80,87
2016,5,18,2,0,6,27,33
2016,5,18,2,1,0,11,11
2016,5,18,2,2,2,6,8
2016,5,18,2,3,1,6,7
2016,5,18,2,4,2,7,9
2016,5,18,2,5,3,91,94
2016,5,18,2,6,5,270,275
2016,5,18,2,7,15,761,776
2016,5,18,2,8,30,1142,1172
2016,5,18,2,9,44,539,583
2016,5,18,2,10,58,259,317
2016,5,18,2,11,65,278,343
2016,5,18,2,12,83,333,416
2016,5,18,2,13,79,320,399
2016,5,18,2,14,89,274,363
2016,5,18,2,15,109,357,466
2016,5,18,2,16,134,641,775
2016,5,18,2,17,126,1177,1303
2016,5,18,2,18,86,1120,1206
2016,5,18,2,19,87,696,783
2016,5,18,2,20,43,462,505
2016,5,18,2,21,38,290,328
2016,5,18,2,22,34,239,273
2016,5,18,2,23,23,115,138
2016,5,19,3,0,6,31,37
2016,5,19,3,1,2,16,18
2016,5,19,3,2,2,12,14
2016,5,19,3,3,1,3,4
2016,5,19,3,4,1,6,7
2016,5,19,3,5,2,61,63
2016,5,19,3,6,6,271,277
2016,5,19,3,7,16,822,838
2016,5,19,3,8,41,1156,1197
2016,5,19,3,9,48,478,526
2016,5,19,3,10,58,201,259
2016,5,19,3,11,136,258,394
2016,5,19,3,12,121,362,483
2016,5,19,3,13,115,365,480
2016,5,19,3,14,158,280,438
2016,5,19,3,15,180,334,514
2016,5,19,3,16,179,648,827
2016,5,19,3,17,215,1340,1555
2016,5,19,3,18,247,1135,1382
2016,5,19,3,19,150,748,898
2016,5,19,3,20,98,517,615
2016,5,19,3,21,87,359,446
2016,5,19,3,22,50,265,315
2016,5,19,3,23,21,112,133
2016,5,20,4,0,13,54,67
2016,5,20,4,1,8,43,51
2016,5,20,4,2,2,11,13
2016,5,20,4,3,2,10,12
2016,5,20,4,4,1,8,9
2016,5,20,4,5,1,70,71
2016,5,20,4,6,24,311,335
2016,5,20,4,7,66,893,959
2016,5,20,4,8,62,1347,1409
2016,5,20,4,9,86,564,650
2016,5,20,4,10,184,242,426
2016,5,20,4,11,198,317,515
2016,5,20,4,12,244,465,709
2016,5,20,4,13,290,473,763
2016,5,20,4,14,303,389,692
2016,5,20,4,15,337,502,839
2016,5,20,4,16,294,824,1118
2016,5,20,4,17,307,1308,1615
2016,5,20,4,18,234,974,1208
2016,5,20,4,19,205,687,892
2016,5,20,4,20,113,409,522
2016,5,20,4,21,100,319,419
2016,5,20,4,22,97,224,321
2016,5,20,4,23,67,178,245
2016,5,21,5,0,45,135,180
2016,5,21,5,1,31,80,111
2016,5,21,5,2,7,46,53
2016,5,21,5,3,8,24,32
2016,5,21,5,4,4,12,16
2016,5,21,5,5,5,12,17
2016,5,21,5,6,3,14,17
2016,5,21,5,7,1,26,27
2016,5,21,5,8,0,26,26
2016,5,21,5,9,11,80,91
2016,5,21,5,10,47,223,270
2016,5,21,5,11,61,327,388
2016,5,21,5,12,155,362,517
2016,5,21,5,13,150,386,536
2016,5,21,5,14,118,313,431
2016,5,21,5,15,72,217,289
2016,5,21,5,16,55,224,279
2016,5,21,5,17,60,168,228
2016,5,21,5,18,51,153,204
2016,5,21,5,19,49,147,196
2016,5,21,5,20,38,123,161
2016,5,21,5,21,32,104,136
2016,5,21,5,22,36,99,135
2016,5,21,5,23,20,72,92
2016,5,22,6,0,5,43,48
2016,5,22,6,1,4,30,34
2016,5,22,6,2,1,37,38
2016,5,22,6,3,1,13,14
2016,5,22,6,4,1,10,11
2016,5,22,6,5,0,11,11
2016,5,22,6,6,2,11,13
2016,5,22,6,7,9,55,64
2016,5,22,6,8,4,85,89
2016,5,22,6,9,25,130,155
2016,5,22,6,10,44,224,268
2016,5,22,6,11,77,301,378
2016,5,22,6,12,35,166,201
2016,5,22,6,13,31,139,170
2016,5,22,6,14,37,198,235
2016,5,22,6,15,41,210,251
2016,5,22,6,16,29,190,219
2016,5,22,6,17,26,115,141
2016,5,22,6,18,18,111,129
2016,5,22,6,19,11,107,118
2016,5,22,6,20,5,87,92
2016,5,22,6,21,13,66,79
2016,5,22,6,22,7,52,59
2016,5,22,6,23,0,34,34
2016,5,23,0,0,0,16,16
2016,5,23,0,1,0,7,7
2016,5,23,0,3,0,2,2
2016,5,23,0,5,1,61,62
2016,5,23,0,6,6,209,215
2016,5,23,0,7,11,639,650
2016,5,23,0,8,42,1148,1190
2016,5,23,0,9,62,456,518
2016,5,23,0,10,103,201,304
2016,5,23,0,11,121,254,375
2016,5,23,0,12,132,356,488
2016,5,23,0,13,147,311,458
2016,5,23,0,14,168,268,436
2016,5,23,0,15,117,218,335
2016,5,23,0,16,88,439,527
2016,5,23,0,17,69,673,742
2016,5,23,0,18,36,336,372
2016,5,23,0,19,31,388,419
2016,5,23,0,20,34,350,384
2016,5,23,0,21,35,229,264
2016,5,23,0,22,27,146,173
2016,5,23,0,23,19,92,111
2016,5,24,1,0,11,16,27
2016,5,24,1,1,6,5,11
2016,5,24,1,2,8,6,14
2016,5,24,1,3,2,5,7
2016,5,24,1,4,4,5,9
2016,5,24,1,5,2,81,83
2016,5,24,1,6,11,318,329
2016,5,24,1,7,28,942,970
2016,5,24,1,8,51,1416,1467
2016,5,24,1,9,60,513,573
2016,5,24,1,10,106,221,327
2016,5,24,1,11,133,304,437
2016,5,24,1,12,188,389,577
2016,5,24,1,13,181,372,553
2016,5,24,1,14,235,307,542
2016,5,24,1,15,168,387,555
2016,5,24,1,16,173,689,862
2016,5,24,1,17,263,1435,1698
2016,5,24,1,18,236,1253,1489
2016,5,24,1,19,179,773,952
2016,5,24,1,20,141,570,711
2016,5,24,1,21,102,372,474
2016,5,24,1,22,79,326,405
2016,5,24,1,23,30,133,163
2016,5,25,2,0,22,48,70
2016,5,25,2,1,17,29,46
2016,5,25,2,2,2,4,6
2016,5,25,2,3,0,4,4
2016,5,25,2,4,0,4,4
2016,5,25,2,5,1,95,96
2016,5,25,2,6,16,326,342
2016,5,25,2,7,49,965,1014
2016,5,25,2,8,67,1278,1345
2016,5,25,2,9,98,508,606
2016,5,25,2,10,144,253,397
2016,5,25,2,11,152,322,474
2016,5,25,2,12,143,433,576
2016,5,25,2,13,147,333,480
2016,5,25,2,14,126,279,405
2016,5,25,2,15,160,371,531
2016,5,25,2,16,161,687,848
2016,5,25,2,17,222,1342,1564
2016,5,25,2,18,204,1175,1379
2016,5,25,2,19,182,758,940
2016,5,25,2,20,136,576,712
2016,5,25,2,21,89,379,468
2016,5,25,2,22,62,265,327
2016,5,25,2,23,20,132,152
2016,5,26,3,0,10,51,61
2016,5,26,3,1,14,22,36
2016,5,26,3,2,6,3,9
2016,5,26,3,3,2,3,5
2016,5,26,3,4,1,8,9
2016,5,26,3,5,3,80,83
2016,5,26,3,6,21,310,331
2016,5,26,3,7,36,857,893
2016,5,26,3,8,56,1231,1287
2016,5,26,3,9,78,518,596
2016,5,26,3,10,105,251,356
2016,5,26,3,11,126,303,429
2016,5,26,3,12,163,355,518
2016,5,26,3,13,129,371,500
2016,5,26,3,14,129,316,445
2016,5,26,3,15,92,360,452
2016,5,26,3,16,119,676,795
2016,5,26,3,17,148,1282,1430
2016,5,26,3,18,171,1194,1365
2016,5,26,3,19,163,728,891
2016,5,26,3,20,132,542,674
2016,5,26,3,21,101,395,496
2016,5,26,3,22,40,274,314
2016,5,26,3,23,36,177,213
2016,5,27,4,0,13,79,92
2016,5,27,4,1,4,39,43
2016,5,27,4,2,3,22,25
2016,5,27,4,3,0,6,6
2016,5,27,4,4,0,10,10
2016,5,27,4,5,1,76,77
2016,5,27,4,6,9,217,226
2016,5,27,4,7,26,668,694
2016,5,27,4,8,49,1087,1136
2016,5,27,4,9,85,534,619
2016,5,27,4,10,144,267,411
2016,5,27,4,11,200,306,506
2016,5,27,4,12,214,425,639
2016,5,27,4,13,223,482,705
2016,5,27,4,14,180,526,706
2016,5,27,4,15,198,677,875
2016,5,27,4,16,266,759,1025
2016,5,27,4,17,241,939,1180
2016,5,27,4,18,202,754,956
2016,5,27,4,19,174,496,670
2016,5,27,4,20,158,356,514
2016,5,27,4,21,177,278,455
2016,5,27,4,22,130,225,355
2016,5,27,4,23,70,144,214
2016,5,28,5,0,33,123,156
2016,5,28,5,1,15,52,67
2016,5,28,5,2,25,43,68
2016,5,28,5,3,4,13,17
2016,5,28,5,4,4,8,12
2016,5,28,5,5,7,11,18
2016,5,28,5,6,8,30,38
2016,5,28,5,7,35,84,119
2016,5,28,5,8,106,217,323
2016,5,28,5,9,254,345,599
2016,5,28,5,10,368,422,790
2016,5,28,5,11,412,456,868
2016,5,28,5,12,534,444,978
2016,5,28,5,13,561,451,1012
2016,5,28,5,14,473,420,893
2016,5,28,5,15,473,405,878
2016,5,28,5,16,540,348,888
2016,5,28,5,17,434,361,795
2016,5,28,5,18,402,401,803
2016,5,28,5,19,390,287,677
2016,5,28,5,20,305,282,587
2016,5,28,5,21,242,214,456
2016,5,28,5,22,136,167,303
2016,5,28,5,23,85,130,215
2016,5,29,6,0,51,97,148
2016,5,29,6,1,19,64,83
2016,5,29,6,2,14,36,50
2016,5,29,6,3,18,24,42
2016,5,29,6,4,12,18,30
2016,5,29,6,5,7,13,20
2016,5,29,6,6,33,25,58
2016,5,29,6,7,52,77,129
2016,5,29,6,8,107,149,256
2016,5,29,6,9,239,289,528
2016,5,29,6,10,457,396,853
2016,5,29,6,11,468,427,895
2016,5,29,6,12,649,506,1155
2016,5,29,6,13,578,453,1031
2016,5,29,6,14,669,427,1096
2016,5,29,6,15,663,396,1059
2016,5,29,6,16,482,356,838
2016,5,29,6,17,127,92,219
2016,5,29,6,18,45,48,93
2016,5,29,6,19,66,38,104
2016,5,29,6,20,44,73,117
2016,5,29,6,21,54,53,107
2016,5,29,6,22,18,48,66
2016,5,29,6,23,39,53,92
2016,5,30,0,0,55,37,92
2016,5,30,0,1,31,27,58
2016,5,30,0,2,25,18,43
2016,5,30,0,3,9,12,21
2016,5,30,0,4,0,4,4
2016,5,30,0,5,5,8,13
2016,5,30,0,6,16,19,35
2016,5,30,0,7,36,64,100
2016,5,30,0,8,96,151,247
2016,5,30,0,9,224,242,466
2016,5,30,0,10,318,367,685
2016,5,30,0,11,346,460,806
2016,5,30,0,12,449,492,941
2016,5,30,0,13,407,532,939
2016,5,30,0,14,361,499,860
2016,5,30,0,15,377,459,836
2016,5,30,0,16,359,436,795
2016,5,30,0,17,272,447,719
2016,5,30,0,18,236,370,606
2016,5,30,0,19,186,361,547
2016,5,30,0,20,198,275,473
2016,5,30,0,21,121,207,328
2016,5,30,0,22,77,113,190
2016,5,30,0,23,25,101,126
2016,5,31,1,0,30,38,68
2016,5,31,1,1,11,12,23
2016,5,31,1,2,0,7,7
2016,5,31,1,3,5,2,7
2016,5,31,1,4,0,5,5
2016,5,31,1,5,3,96,99
2016,5,31,1,6,14,290,304
2016,5,31,1,7,35,766,801
2016,5,31,1,8,59,1082,1141
2016,5,31,1,9,107,426,533
2016,5,31,1,10,132,207,339
2016,5,31,1,11,155,253,408
2016,5,31,1,12,146,313,459
2016,5,31,1,13,168,351,519
2016,5,31,1,14,175,274,449
2016,5,31,1,15,158,354,512
2016,5,31,1,16,156,636,792
2016,5,31,1,17,144,1328,1472
2016,5,31,1,18,151,1214,1365
2016,5,31,1,19,140,760,900
2016,5,31,1,20,113,508,621
2016,5,31,1,21,89,356,445
2016,5,31,1,22,48,173,221
2016,5,31,1,23,6,82,88
2016,6,1,2,0,3,25,28
2016,6,1,2,1,5,13,18
2016,6,1,2,2,4,3,7
2016,6,1,2,3,2,3,5
2016,6,1,2,4,3,8,11
2016,6,1,2,5,7,120,127
2016,6,1,2,6,12,338,350
2016,6,1,2,7,29,979,1008
2016,6,1,2,8,44,1288,1332
2016,6,1,2,9,84,500,584
2016,6,1,2,10,102,232,334
2016,6,1,2,11,103,266,369
2016,6,1,2,12,131,358,489
2016,6,1,2,13,94,308,402
2016,6,1,2,14,131,275,406
2016,6,1,2,15,114,340,454
2016,6,1,2,16,137,712,849
2016,6,1,2,17,151,1484,1635
2016,6,1,2,18,139,1289,1428
2016,6,1,2,19,130,780,910
2016,6,1,2,20,106,599,705
2016,6,1,2,21,60,415,475
2016,6,1,2,22,59,253,312
2016,6,1,2,23,19,98,117
2016,6,2,3,0,13,52,65
2016,6,2,3,1,3,20,23
2016,6,2,3,2,1,7,8
2016,6,2,3,3,0,6,6
2016,6,2,3,4,1,9,10
2016,6,2,3,5,3,103,106
2016,6,2,3,6,13,317,330
2016,6,2,3,7,33,909,942
2016,6,2,3,8,49,1283,1332
2016,6,2,3,9,71,531,602
2016,6,2,3,10,108,255,363
2016,6,2,3,11,91,298,389
2016,6,2,3,12,81,381,462
2016,6,2,3,13,115,340,455
2016,6,2,3,14,112,327,439
2016,6,2,3,15,164,401,565
2016,6,2,3,16,100,697,797
2016,6,2,3,17,175,1436,1611
2016,6,2,3,18,168,1198,1366
2016,6,2,3,19,122,821,943
2016,6,2,3,20,113,562,675
2016,6,2,3,21,69,352,421
2016,6,2,3,22,43,261,304
2016,6,2,3,23,23,129,152
2016,6,3,4,0,10,59,69
2016,6,3,4,1,4,26,30
2016,6,3,4,2,4,12,16
2016,6,3,4,3,3,10,13
2016,6,3,4,4,1,12,13
2016,6,3,4,5,2,102,104
2016,6,3,4,6,9,267,276
2016,6,3,4,7,36,736,772
2016,6,3,4,8,39,1219,1258
2016,6,3,4,9,74,485,559
2016,6,3,4,10,84,232,316
2016,6,3,4,11,112,324,436
2016,6,3,4,12,152,394,546
2016,6,3,4,13,188,400,588
2016,6,3,4,14,171,352,523
2016,6,3,4,15,92,226,318
2016,6,3,4,16,62,359,421
2016,6,3,4,17,47,231,278
2016,6,3,4,18,27,281,308
2016,6,3,4,19,63,405,468
2016,6,3,4,20,76,329,405
2016,6,3,4,21,102,260,362
2016,6,3,4,22,52,181,233
2016,6,3,4,23,38,167,205
2016,6,4,5,0,26,127,153
2016,6,4,5,1,19,113,132
2016,6,4,5,2,14,39,53
2016,6,4,5,3,12,25,37
2016,6,4,5,4,1,8,9
2016,6,4,5,5,8,18,26
2016,6,4,5,6,9,34,43
2016,6,4,5,7,31,125,156
2016,6,4,5,8,59,249,308
2016,6,4,5,9,134,434,568
2016,6,4,5,10,235,472,707
2016,6,4,5,11,306,539,845
2016,6,4,5,12,369,582,951
2016,6,4,5,13,404,570,974
2016,6,4,5,14,439,590,1029
2016,6,4,5,15,418,568,986
2016,6,4,5,16,340,554,894
2016,6,4,5,17,402,567,969
2016,6,4,5,18,302,543,845
2016,6,4,5,19,259,490,749
2016,6,4,5,20,218,363,581
2016,6,4,5,21,142,259,401
2016,6,4,5,22,85,245,330
2016,6,4,5,23,54,191,245
2016,6,5,6,0,39,163,202
2016,6,5,6,1,17,80,97
2016,6,5,6,2,7,32,39
2016,6,5,6,3,2,17,19
2016,6,5,6,4,0,8,8
2016,6,5,6,5,2,9,11
2016,6,5,6,6,11,32,43
2016,6,5,6,7,15,57,72
2016,6,5,6,8,53,157,210
2016,6,5,6,9,121,295,416
2016,6,5,6,10,182,462,644
2016,6,5,6,11,204,534,738
2016,6,5,6,12,300,559,859
2016,6,5,6,13,342,601,943
2016,6,5,6,14,305,543,848
2016,6,5,6,15,250,585,835
2016,6,5,6,16,263,538,801
2016,6,5,6,17,203,486,689
2016,6,5,6,18,169,353,522
2016,6,5,6,19,86,309,395
2016,6,5,6,20,111,269,380
2016,6,5,6,21,79,179,258
2016,6,5,6,22,54,180,234
2016,6,5,6,23,36,79,115
2016,6,6,0,0,11,27,38
2016,6,6,0,1,6,14,20
2016,6,6,0,2,1,10,11
2016,6,6,0,3,1,2,3
2016,6,6,0,4,1,5,6
2016,6,6,0,5,2,79,81
2016,6,6,0,6,11,321,332
2016,6,6,0,7,26,914,940
2016,6,6,0,8,67,1193,1260
2016,6,6,0,9,78,538,616
2016,6,6,0,10,128,222,350
2016,6,6,0,11,109,236,345
2016,6,6,0,12,120,333,453
2016,6,6,0,13,155,315,470
2016,6,6,0,14,157,283,440
2016,6,6,0,15,168,365,533
2016,6,6,0,16,176,705,881
2016,6,6,0,17,176,1489,1665
2016,6,6,0,18,200,1327,1527
2016,6,6,0,19,173,815,988
2016,6,6,0,20,125,574,699
2016,6,6,0,21,76,349,425
2016,6,6,0,22,58,200,258
2016,6,6,0,23,30,97,127
2016,6,7,1,0,17,46,63
2016,6,7,1,1,6,16,22
2016,6,7,1,2,5,9,14
2016,6,7,1,3,4,3,7
2016,6,7,1,4,4,11,15
2016,6,7,1,5,5,103,108
2016,6,7,1,6,13,395,408
2016,6,7,1,7,50,1119,1169
2016,6,7,1,8,64,1296,1360
2016,6,7,1,9,78,474,552
2016,6,7,1,10,88,248,336
2016,6,7,1,11,134,269,403
2016,6,7,1,12,139,388,527
2016,6,7,1,13,135,341,476
2016,6,7,1,14,163,300,463
2016,6,7,1,15,138,393,531
2016,6,7,1,16,190,728,918
2016,6,7,1,17,198,1514,1712
2016,6,7,1,18,204,1285,1489
2016,6,7,1,19,167,866,1033
2016,6,7,1,20,134,589,723
2016,6,7,1,21,100,408,508
2016,6,7,1,22,54,260,314
2016,6,7,1,23,28,92,120
2016,6,8,2,0,22,42,64
2016,6,8,2,1,10,23,33
2016,6,8,2,2,9,11,20
2016,6,8,2,3,1,6,7
2016,6,8,2,4,3,14,17
2016,6,8,2,5,8,110,118
2016,6,8,2,6,21,389,410
2016,6,8,2,7,68,1053,1121
2016,6,8,2,8,88,1328,1416
2016,6,8,2,9,81,554,635
2016,6,8,2,10,112,245,357
2016,6,8,2,11,109,279,388
2016,6,8,2,12,152,377,529
2016,6,8,2,13,143,354,497
2016,6,8,2,14,125,361,486
2016,6,8,2,15,168,412,580
2016,6,8,2,16,185,784,969
2016,6,8,2,17,194,1547,1741
2016,6,8,2,18,158,1305,1463
2016,6,8,2,19,170,883,1053
2016,6,8,2,20,128,670,798
2016,6,8,2,21,71,368,439
2016,6,8,2,22,48,248,296
2016,6,8,2,23,23,126,149
2016,6,9,3,0,12,52,64
2016,6,9,3,1,2,12,14
2016,6,9,3,2,1,14,15
2016,6,9,3,3,1,3,4
2016,6,9,3,4,2,10,12
2016,6,9,3,5,4,93,97
2016,6,9,3,6,15,340,355
2016,6,9,3,7,40,975,1015
2016,6,9,3,8,85,1323,1408
2016,6,9,3,9,75,484,559
2016,6,9,3,10,101,225,326
2016,6,9,3,11,85,318,403
2016,6,9,3,12,142,391,533
2016,6,9,3,13,160,381,541
2016,6,9,3,14,161,333,494
2016,6,9,3,15,160,445,605
2016,6,9,3,16,179,736,915
2016,6,9,3,17,232,1434,1666
2016,6,9,3,18,222,1222,1444
2016,6,9,3,19,180,874,1054
2016,6,9,3,20,150,634,784
2016,6,9,3,21,107,416,523
2016,6,9,3,22,68,304,372
2016,6,9,3,23,33,187,220
2016,6,10,4,0,24,65,89
2016,6,10,4,1,7,33,40
2016,6,10,4,2,1,24,25
2016,6,10,4,3,0,9,9
2016,6,10,4,4,4,11,15
2016,6,10,4,5,4,88,92
2016,6,10,4,6,15,319,334
2016,6,10,4,7,51,859,910
2016,6,10,4,8,75,1215,1290
2016,6,10,4,9,83,485,568
2016,6,10,4,10,136,281,417
2016,6,10,4,11,158,351,509
2016,6,10,4,12,195,444,639
2016,6,10,4,13,206,436,642
2016,6,10,4,14,231,453,684
2016,6,10,4,15,253,526,779
2016,6,10,4,16,250,892,1142
2016,6,10,4,17,295,1374,1669
2016,6,10,4,18,224,996,1220
2016,6,10,4,19,176,627,803
2016,6,10,4,20,180,514,694
2016,6,10,4,21,154,346,500
2016,6,10,4,22,110,291,401
2016,6,10,4,23,59,200,259
2016,6,11,5,0,36,144,180
2016,6,11,5,1,12,98,110
2016,6,11,5,2,16,46,62
2016,6,11,5,3,13,32,45
2016,6,11,5,4,6,9,15
2016,6,11,5,5,4,21,25
2016,6,11,5,6,26,117,143
2016,6,11,5,7,36,153,189
2016,6,11,5,8,80,322,402
2016,6,11,5,9,156,471,627
2016,6,11,5,10,297,518,815
2016,6,11,5,11,383,670,1053
2016,6,11,5,12,378,619,997
2016,6,11,5,13,356,558,914
2016,6,11,5,14,392,570,962
2016,6,11,5,15,352,576,928
2016,6,11,5,16,344,433,777
2016,6,11,5,17,309,400,709
2016,6,11,5,18,284,431,715
2016,6,11,5,19,262,421,683
2016,6,11,5,20,210,341,551
2016,6,11,5,21,173,305,478
2016,6,11,5,22,133,245,378
2016,6,11,5,23,70,165,235
2016,6,12,6,0,47,122,169
2016,6,12,6,1,39,107,146
2016,6,12,6,2,24,68,92
2016,6,12,6,3,10,40,50
2016,6,12,6,4,15,12,27
2016,6,12,6,5,13,13,26
2016,6,12,6,6,11,34,45
2016,6,12,6,7,60,89,149
2016,6,12,6,8,82,172,254
2016,6,12,6,9,216,349,565
2016,6,12,6,10,239,469,708
2016,6,12,6,11,313,518,831
2016,6,12,6,12,334,573,907
2016,6,12,6,13,370,487,857
2016,6,12,6,14,367,540,907
2016,6,12,6,15,346,478,824
2016,6,12,6,16,307,438,745
2016,6,12,6,17,296,437,733
2016,6,12,6,18,284,504,788
2016,6,12,6,19,287,445,732
2016,6,12,6,20,219,448,667
2016,6,12,6,21,149,221,370
2016,6,12,6,22,88,191,279
2016,6,12,6,23,37,115,152
2016,6,13,0,0,19,37,56
2016,6,13,0,1,3,15,18
2016,6,13,0,2,6,15,21
2016,6,13,0,3,2,10,12
2016,6,13,0,4,1,11,12
2016,6,13,0,5,10,88,98
2016,6,13,0,6,21,318,339
2016,6,13,0,7,50,947,997
2016,6,13,0,8,73,1247,1320
2016,6,13,0,9,106,494,600
2016,6,13,0,10,148,190,338
2016,6,13,0,11,175,268,443
2016,6,13,0,12,211,371,582
2016,6,13,0,13,190,347,537
2016,6,13,0,14,175,287,462
2016,6,13,0,15,224,415,639
2016,6,13,0,16,222,711,933
2016,6,13,0,17,254,1478,1732
2016,6,13,0,18,221,1308,1529
2016,6,13,0,19,175,761,936
2016,6,13,0,20,136,507,643
2016,6,13,0,21,77,361,438
2016,6,13,0,22,83,246,329
2016,6,13,0,23,25,122,147
2016,6,14,1,0,15,51,66
2016,6,14,1,1,2,10,12
2016,6,14,1,2,6,9,15
2016,6,14,1,3,1,6,7
2016,6,14,1,4,1,11,12
2016,6,14,1,5,1,105,106
2016,6,14,1,6,22,390,412
2016,6,14,1,7,49,980,1029
2016,6,14,1,8,66,1460,1526
2016,6,14,1,9,70,535,605
2016,6,14,1,10,127,258,385
2016,6,14,1,11,145,318,463
2016,6,14,1,12,142,425,567
2016,6,14,1,13,164,341,505
2016,6,14,1,14,147,325,472
2016,6,14,1,15,181,405,586
2016,6,14,1,16,205,775,980
2016,6,14,1,17,250,1588,1838
2016,6,14,1,18,237,1353,1590
2016,6,14,1,19,176,825,1001
2016,6,14,1,20,170,539,709
2016,6,14,1,21,115,354,469
2016,6,14,1,22,77,357,434
2016,6,14,1,23,40,120,160
2016,6,15,2,0,20,55,75
2016,6,15,2,1,12,12,24
2016,6,15,2,2,1,4,5
2016,6,15,2,3,0,4,4
2016,6,15,2,4,1,13,14
2016,6,15,2,5,10,106,116
2016,6,15,2,6,15,291,306
2016,6,15,2,7,50,825,875
2016,6,15,2,8,67,1392,1459
2016,6,15,2,9,89,551,640
2016,6,15,2,10,96,249,345
2016,6,15,2,11,140,288,428
2016,6,15,2,12,137,349,486
2016,6,15,2,13,169,381,550
2016,6,15,2,14,182,353,535
2016,6,15,2,15,182,395,577
2016,6,15,2,16,187,680,867
2016,6,15,2,17,213,1407,1620
2016,6,15,2,18,173,1207,1380
2016,6,15,2,19,171,800,971
2016,6,15,2,20,162,601,763
2016,6,15,2,21,74,389,463
2016,6,15,2,22,86,209,295
2016,6,15,2,23,40,116,156
2016,6,16,3,0,20,63,83
2016,6,16,3,1,20,12,32
2016,6,16,3,2,7,9,16
2016,6,16,3,3,0,3,3
2016,6,16,3,4,4,9,13
2016,6,16,3,5,4,86,90
2016,6,16,3,6,15,321,336
2016,6,16,3,7,35,855,890
2016,6,16,3,8,48,1104,1152
2016,6,16,3,9,60,552,612
2016,6,16,3,10,88,251,339
2016,6,16,3,11,131,252,383
2016,6,16,3,12,124,372,496
2016,6,16,3,13,125,334,459
2016,6,16,3,14,158,284,442
2016,6,16,3,15,154,359,513
2016,6,16,3,16,163,649,812
2016,6,16,3,17,217,1443,1660
2016,6,16,3,18,203,1125,1328
2016,6,16,3,19,111,665,776
2016,6,16,3,20,76,407,483
2016,6,16,3,21,8,44,52
2016,6,16,3,22,3,21,24
2016,6,16,3,23,4,58,62
2016,6,17,4,0,12,49,61
2016,6,17,4,1,7,22,29
2016,6,17,4,2,4,17,21
2016,6,17,4,3,3,5,8
2016,6,17,4,4,1,10,11
2016,6,17,4,5,2,76,78
2016,6,17,4,6,6,244,250
2016,6,17,4,7,30,747,777
2016,6,17,4,8,67,1224,1291
2016,6,17,4,9,95,512,607
2016,6,17,4,10,134,232,366
2016,6,17,4,11,168,295,463
2016,6,17,4,12,209,408,617
2016,6,17,4,13,212,394,606
2016,6,17,4,14,225,390,615
2016,6,17,4,15,246,517,763
2016,6,17,4,16,227,853,1080
2016,6,17,4,17,242,1364,1606
2016,6,17,4,18,198,1023,1221
2016,6,17,4,19,233,728,961
2016,6,17,4,20,201,489,690
2016,6,17,4,21,134,394,528
2016,6,17,4,22,116,257,373
2016,6,17,4,23,54,214,268
2016,6,18,5,0,73,174,247
2016,6,18,5,1,28,72,100
2016,6,18,5,2,22,56,78
2016,6,18,5,3,7,35,42
2016,6,18,5,4,2,21,23
2016,6,18,5,5,2,25,27
2016,6,18,5,6,21,47,68
2016,6,18,5,7,44,132,176
2016,6,18,5,8,87,268,355
2016,6,18,5,9,191,456,647
2016,6,18,5,10,325,558,883
2016,6,18,5,11,440,618,1058
2016,6,18,5,12,476,608,1084
2016,6,18,5,13,485,560,1045
2016,6,18,5,14,567,545,1112
2016,6,18,5,15,543,557,1100
2016,6,18,5,16,459,545,1004
2016,6,18,5,17,485,496,981
2016,6,18,5,18,413,498,911
2016,6,18,5,19,338,439,777
2016,6,18,5,20,317,362,679
2016,6,18,5,21,230,284,514
2016,6,18,5,22,151,191,342
2016,6,18,5,23,117,180,297
2016,6,19,6,0,84,156,240
2016,6,19,6,1,46,92,138
2016,6,19,6,2,55,71,126
2016,6,19,6,3,23,37,60
2016,6,19,6,4,17,12,29
2016,6,19,6,5,7,13,20
2016,6,19,6,6,13,29,42
2016,6,19,6,7,34,86,120
2016,6,19,6,8,100,203,303
2016,6,19,6,9,184,303,487
2016,6,19,6,10,287,474,761
2016,6,19,6,11,362,520,882
2016,6,19,6,12,369,541,910
2016,6,19,6,13,400,557,957
2016,6,19,6,14,465,514,979
2016,6,19,6,15,451,520,971
2016,6,19,6,16,369,505,874
2016,6,19,6,17,387,578,965
2016,6,19,6,18,353,460,813
2016,6,19,6,19,272,461,733
2016,6,19,6,20,213,371,584
2016,6,19,6,21,137,237,374
2016,6,19,6,22,94,180,274
2016,6,19,6,23,57,131,188
2016,6,20,0,0,22,33,55
2016,6,20,0,1,5,19,24
2016,6,20,0,2,10,11,21
2016,6,20,0,3,2,2,4
2016,6,20,0,4,3,9,12
2016,6,20,0,5,7,89,96
2016,6,20,0,6,29,282,311
2016,6,20,0,7,49,906,955
2016,6,20,0,8,89,1153,1242
2016,6,20,0,9,118,492,610
2016,6,20,0,10,154,246,400
2016,6,20,0,11,172,268,440
2016,6,20,0,12,175,327,502
2016,6,20,0,13,175,299,474
2016,6,20,0,14,160,296,456
2016,6,20,0,15,226,366,592
2016,6,20,0,16,224,659,883
2016,6,20,0,17,241,1463,1704
2016,6,20,0,18,265,1159,1424
2016,6,20,0,19,209,757,966
2016,6,20,0,20,194,569,763
2016,6,20,0,21,141,379,520
2016,6,20,0,22,112,222,334
2016,6,20,0,23,36,88,124
2016,6,21,1,0,16,46,62
2016,6,21,1,1,14,17,31
2016,6,21,1,2,3,4,7
2016,6,21,1,3,7,3,10
2016,6,21,1,4,4,15,19
2016,6,21,1,5,6,111,117
2016,6,21,1,6,32,371,403
2016,6,21,1,7,57,961,1018
2016,6,21,1,8,98,1276,1374
2016,6,21,1,9,106,511,617
2016,6,21,1,10,120,263,383
2016,6,21,1,11,167,283,450
2016,6,21,1,12,179,311,490
2016,6,21,1,13,139,336,475
2016,6,21,1,14,101,209,310
2016,6,21,1,15,54,131,185
2016,6,21,1,16,75,383,458
2016,6,21,1,17,90,710,800
2016,6,21,1,18,54,487,541
2016,6,21,1,19,78,332,410
2016,6,21,1,20,100,442,542
2016,6,21,1,21,76,291,367
2016,6,21,1,22,42,174,216
2016,6,21,1,23,54,174,228
2016,6,22,2,0,30,40,70
2016,6,22,2,1,24,10,34
2016,6,22,2,2,17,3,20
2016,6,22,2,3,8,6,14
2016,6,22,2,4,5,9,14
2016,6,22,2,5,9,118,127
2016,6,22,2,6,26,369,395
2016,6,22,2,7,52,975,1027
2016,6,22,2,8,89,1285,1374
2016,6,22,2,9,101,534,635
2016,6,22,2,10,158,257,415
2016,6,22,2,11,216,281,497
2016,6,22,2,12,202,346,548
2016,6,22,2,13,224,348,572
2016,6,22,2,14,159,318,477
2016,6,22,2,15,203,389,592
2016,6,22,2,16,213,693,906
2016,6,22,2,17,245,1513,1758
2016,6,22,2,18,256,1226,1482
2016,6,22,2,19,215,805,1020
2016,6,22,2,20,178,685,863
2016,6,22,2,21,110,401,511
2016,6,22,2,22,87,281,368
2016,6,22,2,23,49,134,183
2016,6,23,3,0,19,47,66
2016,6,23,3,1,26,26,52
2016,6,23,3,2,8,9,17
2016,6,23,3,3,4,6,10
2016,6,23,3,4,0,8,8
2016,6,23,3,5,2,56,58
2016,6,23,3,6,2,63,65
2016,6,23,3,7,5,137,142
2016,6,23,3,8,10,297,307
2016,6,23,3,9,33,531,564
2016,6,23,3,10,60,271,331
2016,6,23,3,11,107,293,400
2016,6,23,3,12,135,356,491
2016,6,23,3,13,119,347,466
2016,6,23,3,14,133,285,418
2016,6,23,3,15,131,398,529
2016,6,23,3,16,155,594,749
2016,6,23,3,17,163,1270,1433
2016,6,23,3,18,136,1010,1146
2016,6,23,3,19,100,669,769
2016,6,23,3,20,109,454,563
2016,6,23,3,21,63,331,394
2016,6,23,3,22,55,241,296
2016,6,23,3,23,23,138,161
2016,6,24,4,0,11,85,96
2016,6,24,4,1,8,30,38
2016,6,24,4,2,3,22,25
2016,6,24,4,3,0,8,8
2016,6,24,4,4,6,11,17
2016,6,24,4,5,13,85,98
2016,6,24,4,6,13,286,299
2016,6,24,4,7,35,812,847
2016,6,24,4,8,61,1138,1199
2016,6,24,4,9,99,546,645
2016,6,24,4,10,182,258,440
2016,6,24,4,11,180,333,513
2016,6,24,4,12,196,473,669
2016,6,24,4,13,192,432,624
2016,6,24,4,14,193,401,594
2016,6,24,4,15,220,427,647
2016,6,24,4,16,218,774,992
2016,6,24,4,17,222,1204,1426
2016,6,24,4,18,196,942,1138
2016,6,24,4,19,157,502,659
2016,6,24,4,20,140,362,502
2016,6,24,4,21,132,250,382
2016,6,24,4,22,77,225,302
2016,6,24,4,23,63,182,245
2016,6,25,5,0,48,153,201
2016,6,25,5,1,24,91,115
2016,6,25,5,2,21,68,89
2016,6,25,5,3,1,19,20
2016,6,25,5,4,0,11,11
2016,6,25,5,5,9,13,22
2016,6,25,5,6,22,52,74
2016,6,25,5,7,50,116,166
2016,6,25,5,8,100,250,350
2016,6,25,5,9,210,386,596
2016,6,25,5,10,301,530,831
2016,6,25,5,11,447,585,1032
2016,6,25,5,12,491,585,1076
2016,6,25,5,13,574,642,1216
2016,6,25,5,14,568,604,1172
2016,6,25,5,15,473,589,1062
2016,6,25,5,16,458,501,959
2016,6,25,5,17,467,547,1014
2016,6,25,5,18,382,477,859
2016,6,25,5,19,361,418,779
2016,6,25,5,20,338,415,753
2016,6,25,5,21,266,290,556
2016,6,25,5,22,166,232,398
2016,6,25,5,23,81,168,249
2016,6,26,6,0,57,146,203
2016,6,26,6,1,29,84,113
2016,6,26,6,2,21,66,87
2016,6,26,6,3,17,38,55
2016,6,26,6,4,14,23,37
2016,6,26,6,5,7,16,23
2016,6,26,6,6,15,25,40
2016,6,26,6,7,34,74,108
2016,6,26,6,8,83,191,274
2016,6,26,6,9,189,317,506
2016,6,26,6,10,287,472,759
2016,6,26,6,11,442,531,973
2016,6,26,6,12,498,551,1049
2016,6,26,6,13,504,526,1030
2016,6,26,6,14,465,557,1022
2016,6,26,6,15,479,519,998
2016,6,26,6,16,442,534,976
2016,6,26,6,17,377,540,917
2016,6,26,6,18,352,508,860
2016,6,26,6,19,283,450,733
2016,6,26,6,20,264,389,653
2016,6,26,6,21,193,200,393
2016,6,26,6,22,153,187,340
2016,6,26,6,23,69,138,207
2016,6,27,0,0,38,38,76
2016,6,27,0,1,18,15,33
2016,6,27,0,2,2,9,11
2016,6,27,0,3,0,4,4
2016,6,27,0,4,1,14,15
2016,6,27,0,5,9,90,99
2016,6,27,0,6,18,309,327
2016,6,27,0,7,50,872,922
2016,6,27,0,8,70,1155,1225
2016,6,27,0,9,80,471,551
2016,6,27,0,10,143,224,367
2016,6,27,0,11,169,268,437
2016,6,27,0,12,180,314,494
2016,6,27,0,13,189,374,563
2016,6,27,0,14,181,309,490
2016,6,27,0,15,224,338,562
2016,6,27,0,16,228,661,889
2016,6,27,0,17,212,1534,1746
2016,6,27,0,18,166,1031,1197
2016,6,27,0,19,110,544,654
2016,6,27,0,20,97,420,517
2016,6,27,0,21,68,312,380
2016,6,27,0,22,68,228,296
2016,6,27,0,23,11,56,67
2016,6,28,1,0,10,18,28
2016,6,28,1,1,3,10,13
2016,6,28,1,2,1,5,6
2016,6,28,1,3,3,2,5
2016,6,28,1,4,0,13,13
2016,6,28,1,5,8,101,109
2016,6,28,1,6,15,344,359
2016,6,28,1,7,33,944,977
2016,6,28,1,8,88,1268,1356
2016,6,28,1,9,68,498,566
2016,6,28,1,10,108,274,382
2016,6,28,1,11,152,302,454
2016,6,28,1,12,157,366,523
2016,6,28,1,13,116,322,438
2016,6,28,1,14,93,282,375
2016,6,28,1,15,147,341,488
2016,6,28,1,16,139,670,809
2016,6,28,1,17,186,1514,1700
2016,6,28,1,18,115,874,989
2016,6,28,1,19,48,500,548
2016,6,28,1,20,69,409,478
2016,6,28,1,21,17,108,125
2016,6,28,1,22,27,163,190
2016,6,28,1,23,21,112,133
2016,6,29,2,0,15,54,69
2016,6,29,2,1,4,15,19
2016,6,29,2,2,1,5,6
2016,6,29,2,3,3,5,8
2016,6,29,2,4,0,10,10
2016,6,29,2,5,4,93,97
2016,6,29,2,6,33,387,420
2016,6,29,2,7,68,953,1021
2016,6,29,2,8,79,1292,1371
2016,6,29,2,9,133,535,668
2016,6,29,2,10,122,289,411
2016,6,29,2,11,120,292,412
2016,6,29,2,12,156,383,539
2016,6,29,2,13,157,397,554
2016,6,29,2,14,198,337,535
2016,6,29,2,15,162,426,588
2016,6,29,2,16,207,712,919
2016,6,29,2,17,247,1498,1745
2016,6,29,2,18,195,1241,1436
2016,6,29,2,19,163,818,981
2016,6,29,2,20,181,650,831
2016,6,29,2,21,101,442,543
2016,6,29,2,22,60,328,388
2016,6,29,2,23,55,152,207
2016,6,30,3,0,19,46,65
2016,6,30,3,1,2,21,23
2016,6,30,3,2,10,14,24
2016,6,30,3,3,4,7,11
2016,6,30,3,4,0,10,10
2016,6,30,3,5,8,87,95
2016,6,30,3,6,21,324,345
2016,6,30,3,7,34,925,959
2016,6,30,3,8,56,1260,1316
2016,6,30,3,9,83,555,638
2016,6,30,3,10,144,284,428
2016,6,30,3,11,151,325,476
2016,6,30,3,12,162,389,551
2016,6,30,3,13,184,376,560
2016,6,30,3,14,160,319,479
2016,6,30,3,15,177,450,627
2016,6,30,3,16,183,689,872
2016,6,30,3,17,235,1346,1581
2016,6,30,3,18,204,1177,1381
2016,6,30,3,19,180,781,961
2016,6,30,3,20,153,600,753
2016,6,30,3,21,106,404,510
2016,6,30,3,22,85,359,444
2016,6,30,3,23,34,175,209
2016,7,1,4,0,26,84,110
2016,7,1,4,1,11,37,48
2016,7,1,4,2,3,15,18
2016,7,1,4,3,1,6,7
2016,7,1,4,4,1,16,17
2016,7,1,4,5,6,91,97
2016,7,1,4,6,18,237,255
2016,7,1,4,7,34,666,700
2016,7,1,4,8,76,1139,1215
2016,7,1,4,9,93,539,632
2016,7,1,4,10,182,273,455
2016,7,1,4,11,218,334,552
2016,7,1,4,12,189,452,641
2016,7,1,4,13,224,532,756
2016,7,1,4,14,279,565,844
2016,7,1,4,15,250,733,983
2016,7,1,4,16,251,822,1073
2016,7,1,4,17,237,811,1048
2016,7,1,4,18,220,629,849
2016,7,1,4,19,200,435,635
2016,7,1,4,20,238,387,625
2016,7,1,4,21,93,227,320
2016,7,1,4,22,109,173,282
2016,7,1,4,23,67,176,243
2016,7,2,5,0,47,117,164
2016,7,2,5,1,46,76,122
2016,7,2,5,2,30,47,77
2016,7,2,5,3,15,28,43
2016,7,2,5,4,10,14,24
2016,7,2,5,5,16,19,35
2016,7,2,5,6,16,45,61
2016,7,2,5,7,26,116,142
2016,7,2,5,8,106,210,316
2016,7,2,5,9,216,347,563
2016,7,2,5,10,333,429,762
2016,7,2,5,11,482,493,975
2016,7,2,5,12,592,551,1143
2016,7,2,5,13,656,543,1199
2016,7,2,5,14,666,540,1206
2016,7,2,5,15,675,509,1184
2016,7,2,5,16,637,451,1088
2016,7,2,5,17,640,447,1087
2016,7,2,5,18,568,488,1056
2016,7,2,5,19,446,360,806
2016,7,2,5,20,427,313,740
2016,7,2,5,21,346,226,572
2016,7,2,5,22,230,196,426
2016,7,2,5,23,134,147,281
2016,7,3,6,0,100,107,207
2016,7,3,6,1,90,83,173
2016,7,3,6,2,34,55,89
2016,7,3,6,3,11,37,48
2016,7,3,6,4,11,11,22
2016,7,3,6,5,11,17,28
2016,7,3,6,6,10,17,27
2016,7,3,6,7,33,46,79
2016,7,3,6,8,74,115,189
2016,7,3,6,9,163,210,373
2016,7,3,6,10,364,366,730
2016,7,3,6,11,536,429,965
2016,7,3,6,12,706,493,1199
2016,7,3,6,13,771,484,1255
2016,7,3,6,14,838,459,1297
2016,7,3,6,15,838,439,1277
2016,7,3,6,16,651,334,985
2016,7,3,6,17,479,303,782
2016,7,3,6,18,504,250,754
2016,7,3,6,19,428,251,679
2016,7,3,6,20,390,238,628
2016,7,3,6,21,323,217,540
2016,7,3,6,22,244,189,433
2016,7,3,6,23,150,127,277
2016,7,4,0,0,115,68,183
2016,7,4,0,1,57,57,114
2016,7,4,0,2,27,43,70
2016,7,4,0,3,10,26,36
2016,7,4,0,4,6,13,19
2016,7,4,0,5,6,19,25
2016,7,4,0,6,22,31,53
2016,7,4,0,7,26,58,84
2016,7,4,0,8,92,119,211
2016,7,4,0,9,218,256,474
2016,7,4,0,10,315,376,691
2016,7,4,0,11,453,399,852
2016,7,4,0,12,481,420,901
2016,7,4,0,13,387,319,706
2016,7,4,0,14,164,143,307
2016,7,4,0,15,116,91,207
2016,7,4,0,16,112,96,208
2016,7,4,0,17,183,152,335
2016,7,4,0,18,200,197,397
2016,7,4,0,19,130,112,242
2016,7,4,0,20,204,269,473
2016,7,4,0,21,207,343,550
2016,7,4,0,22,125,200,325
2016,7,4,0,23,52,85,137
2016,7,5,1,0,19,45,64
2016,7,5,1,1,14,10,24
2016,7,5,1,2,8,2,10
2016,7,5,1,3,4,7,11
2016,7,5,1,4,1,7,8
2016,7,5,1,5,0,21,21
2016,7,5,1,6,11,139,150
2016,7,5,1,7,33,546,579
2016,7,5,1,8,74,1043,1117
2016,7,5,1,9,145,424,569
2016,7,5,1,10,259,250,509
2016,7,5,1,11,249,268,517
2016,7,5,1,12,317,346,663
2016,7,5,1,13,206,313,519
2016,7,5,1,14,287,266,553
2016,7,5,1,15,256,340,596
2016,7,5,1,16,262,647,909
2016,7,5,1,17,249,1288,1537
2016,7,5,1,18,198,1065,1263
2016,7,5,1,19,173,687,860
2016,7,5,1,20,144,526,670
2016,7,5,1,21,87,316,403
2016,7,5,1,22,63,209,272
2016,7,5,1,23,48,98,146
2016,7,6,2,0,23,33,56
2016,7,6,2,1,13,11,24
2016,7,6,2,2,4,4,8
2016,7,6,2,3,2,5,7
2016,7,6,2,4,3,11,14
2016,7,6,2,5,7,117,124
2016,7,6,2,6,21,352,373
2016,7,6,2,7,38,886,924
2016,7,6,2,8,62,1222,1284
2016,7,6,2,9,127,498,625
2016,7,6,2,10,134,214,348
2016,7,6,2,11,172,260,432
2016,7,6,2,12,180,297,477
2016,7,6,2,13,199,289,488
2016,7,6,2,14,136,270,406
2016,7,6,2,15,168,362,530
2016,7,6,2,16,183,604,787
2016,7,6,2,17,209,1279,1488
2016,7,6,2,18,187,1095,1282
2016,7,6,2,19,216,801,1017
2016,7,6,2,20,185,594,779
2016,7,6,2,21,123,401,524
2016,7,6,2,22,90,201,291
2016,7,6,2,23,49,111,160
2016,7,7,3,0,25,58,83
2016,7,7,3,1,4,15,19
2016,7,7,3,2,3,8,11
2016,7,7,3,3,1,6,7
2016,7,7,3,4,0,11,11
2016,7,7,3,5,6,100,106
2016,7,7,3,6,24,355,379
2016,7,7,3,7,38,848,886
2016,7,7,3,8,62,1206,1268
2016,7,7,3,9,104,544,648
2016,7,7,3,10,157,211,368
2016,7,7,3,11,156,215,371
2016,7,7,3,12,173,283,456
2016,7,7,3,13,179,303,482
2016,7,7,3,14,132,260,392
2016,7,7,3,15,124,304,428
2016,7,7,3,16,160,602,762
2016,7,7,3,17,212,1305,1517
2016,7,7,3,18,198,1102,1300
2016,7,7,3,19,155,745,900
2016,7,7,3,20,164,627,791
2016,7,7,3,21,112,450,562
2016,7,7,3,22,52,263,315
2016,7,7,3,23,29,127,156
2016,7,8,4,0,15,50,65
2016,7,8,4,1,7,24,31
2016,7,8,4,2,1,13,14
2016,7,8,4,3,0,4,4
2016,7,8,4,4,2,15,17
2016,7,8,4,5,6,86,92
2016,7,8,4,6,17,269,286
2016,7,8,4,7,40,745,785
2016,7,8,4,8,60,1124,1184
2016,7,8,4,9,111,524,635
2016,7,8,4,10,136,248,384
2016,7,8,4,11,131,268,399
2016,7,8,4,12,168,341,509
2016,7,8,4,13,201,396,597
2016,7,8,4,14,149,343,492
2016,7,8,4,15,105,327,432
2016,7,8,4,16,170,604,774
2016,7,8,4,17,219,1140,1359
2016,7,8,4,18,170,856,1026
2016,7,8,4,19,156,588,744
2016,7,8,4,20,149,485,634
2016,7,8,4,21,142,369,511
2016,7,8,4,22,92,253,345
2016,7,8,4,23,62,200,262
2016,7,9,5,0,46,144,190
2016,7,9,5,1,32,86,118
2016,7,9,5,2,18,43,61
2016,7,9,5,3,7,27,34
2016,7,9,5,4,7,17,24
2016,7,9,5,5,11,21,32
2016,7,9,5,6,20,70,90
2016,7,9,5,7,26,139,165
2016,7,9,5,8,76,280,356
2016,7,9,5,9,168,444,612
2016,7,9,5,10,264,510,774
2016,7,9,5,11,320,545,865
2016,7,9,5,12,384,550,934
2016,7,9,5,13,417,579,996
2016,7,9,5,14,422,576,998
2016,7,9,5,15,468,481,949
2016,7,9,5,16,410,486,896
2016,7,9,5,17,400,471,871
2016,7,9,5,18,337,429,766
2016,7,9,5,19,322,473,795
2016,7,9,5,20,273,352,625
2016,7,9,5,21,180,270,450
2016,7,9,5,22,133,198,331
2016,7,9,5,23,77,189,266
2016,7,10,6,0,71,121,192
2016,7,10,6,1,34,99,133
2016,7,10,6,2,22,68,90
2016,7,10,6,3,11,37,48
2016,7,10,6,4,6,14,20
2016,7,10,6,5,4,12,16
2016,7,10,6,6,21,30,51
2016,7,10,6,7,32,79,111
2016,7,10,6,8,68,201,269
2016,7,10,6,9,155,288,443
2016,7,10,6,10,242,442,684
2016,7,10,6,11,305,532,837
2016,7,10,6,12,429,619,1048
2016,7,10,6,13,428,628,1056
2016,7,10,6,14,489,617,1106
2016,7,10,6,15,407,559,966
2016,7,10,6,16,426,511,937
2016,7,10,6,17,365,537,902
2016,7,10,6,18,355,548,903
2016,7,10,6,19,312,442,754
2016,7,10,6,20,223,408,631
2016,7,10,6,21,161,261,422
2016,7,10,6,22,84,165,249
2016,7,10,6,23,31,82,113
2016,7,11,0,0,19,48,67
2016,7,11,0,1,16,14,30
2016,7,11,0,2,1,7,8
2016,7,11,0,3,1,10,11
2016,7,11,0,4,6,14,20
2016,7,11,0,5,8,79,87
2016,7,11,0,6,23,318,341
2016,7,11,0,7,44,914,958
2016,7,11,0,8,80,1062,1142
2016,7,11,0,9,124,483,607
2016,7,11,0,10,176,195,371
2016,7,11,0,11,176,209,385
2016,7,11,0,12,156,311,467
2016,7,11,0,13,198,316,514
2016,7,11,0,14,239,299,538
2016,7,11,0,15,213,328,541
2016,7,11,0,16,178,665,843
2016,7,11,0,17,202,1353,1555
2016,7,11,0,18,234,1187,1421
2016,7,11,0,19,219,784,1003
2016,7,11,0,20,182,631,813
2016,7,11,0,21,129,416,545
2016,7,11,0,22,87,218,305
2016,7,11,0,23,40,98,138
2016,7,12,1,0,20,50,70
2016,7,12,1,1,12,14,26
2016,7,12,1,2,2,4,6
2016,7,12,1,3,3,3,6
2016,7,12,1,4,0,11,11
2016,7,12,1,5,11,103,114
2016,7,12,1,6,18,380,398
2016,7,12,1,7,44,927,971
2016,7,12,1,8,97,1246,1343
2016,7,12,1,9,107,501,608
2016,7,12,1,10,120,250,370
2016,7,12,1,11,109,272,381
2016,7,12,1,12,160,336,496
2016,7,12,1,13,175,335,510
2016,7,12,1,14,189,290,479
2016,7,12,1,15,168,344,512
2016,7,12,1,16,232,717,949
2016,7,12,1,17,287,1396,1683
2016,7,12,1,18,192,1163,1355
2016,7,12,1,19,226,852,1078
2016,7,12,1,20,167,637,804
2016,7,12,1,21,118,401,519
2016,7,12,1,22,59,270,329
2016,7,12,1,23,27,123,150
2016,7,13,2,0,24,42,66
2016,7,13,2,1,9,22,31
2016,7,13,2,2,4,5,9
2016,7,13,2,3,1,4,5
2016,7,13,2,4,1,13,14
2016,7,13,2,5,10,120,130
2016,7,13,2,6,25,380,405
2016,7,13,2,7,39,904,943
2016,7,13,2,8,78,1209,1287
2016,7,13,2,9,76,506,582
2016,7,13,2,10,108,238,346
2016,7,13,2,11,170,232,402
2016,7,13,2,12,148,300,448
2016,7,13,2,13,137,314,451
2016,7,13,2,14,150,240,390
2016,7,13,2,15,184,312,496
2016,7,13,2,16,187,671,858
2016,7,13,2,17,199,1366,1565
2016,7,13,2,18,188,1099,1287
2016,7,13,2,19,215,834,1049
2016,7,13,2,20,143,626,769
2016,7,13,2,21,100,362,462
2016,7,13,2,22,71,281,352
2016,7,13,2,23,44,129,173
2016,7,14,3,0,29,45,74
2016,7,14,3,1,20,19,39
2016,7,14,3,2,9,9,18
2016,7,14,3,3,2,2,4
2016,7,14,3,4,0,15,15
2016,7,14,3,5,4,93,97
2016,7,14,3,6,20,340,360
2016,7,14,3,7,43,883,926
2016,7,14,3,8,67,1107,1174
2016,7,14,3,9,90,504,594
2016,7,14,3,10,172,230,402
2016,7,14,3,11,158,238,396
2016,7,14,3,12,123,317,440
2016,7,14,3,13,159,279,438
2016,7,14,3,14,166,242,408
2016,7,14,3,15,156,332,488
2016,7,14,3,16,149,635,784
2016,7,14,3,17,213,1197,1410
2016,7,14,3,18,211,1055,1266
2016,7,14,3,19,183,708,891
2016,7,14,3,20,137,576,713
2016,7,14,3,21,149,387,536
2016,7,14,3,22,117,275,392
2016,7,14,3,23,56,165,221
2016,7,15,4,0,27,67,94
2016,7,15,4,1,26,26,52
2016,7,15,4,2,11,16,27
2016,7,15,4,3,8,9,17
2016,7,15,4,4,0,12,12
2016,7,15,4,5,10,82,92
2016,7,15,4,6,17,298,315
2016,7,15,4,7,38,770,808
2016,7,15,4,8,87,1095,1182
2016,7,15,4,9,103,497,600
2016,7,15,4,10,152,235,387
2016,7,15,4,11,207,288,495
2016,7,15,4,12,228,329,557
2016,7,15,4,13,206,392,598
2016,7,15,4,14,202,312,514
2016,7,15,4,15,249,454,703
2016,7,15,4,16,232,714,946
2016,7,15,4,17,256,1099,1355
2016,7,15,4,18,201,908,1109
2016,7,15,4,19,236,582,818
2016,7,15,4,20,190,448,638
2016,7,15,4,21,178,365,543
2016,7,15,4,22,148,307,455
2016,7,15,4,23,99,197,296
2016,7,16,5,0,56,164,220
2016,7,16,5,1,41,112,153
2016,7,16,5,2,24,66,90
2016,7,16,5,3,18,39,57
2016,7,16,5,4,5,21,26
2016,7,16,5,5,10,14,24
2016,7,16,5,6,21,60,81
2016,7,16,5,7,71,147,218
2016,7,16,5,8,127,326,453
2016,7,16,5,9,298,430,728
2016,7,16,5,10,529,441,970
2016,7,16,5,11,591,557,1148
2016,7,16,5,12,679,561,1240
2016,7,16,5,13,756,534,1290
2016,7,16,5,14,691,462,1153
2016,7,16,5,15,625,483,1108
2016,7,16,5,16,673,470,1143
2016,7,16,5,17,589,394,983
2016,7,16,5,18,205,174,379
2016,7,16,5,19,215,153,368
2016,7,16,5,20,333,278,611
2016,7,16,5,21,327,227,554
2016,7,16,5,22,256,185,441
2016,7,16,5,23,219,180,399
2016,7,17,6,0,131,120,251
2016,7,17,6,1,83,91,174
2016,7,17,6,2,43,62,105
2016,7,17,6,3,37,43,80
2016,7,17,6,4,8,17,25
2016,7,17,6,5,10,10,20
2016,7,17,6,6,38,27,65
2016,7,17,6,7,107,89,196
2016,7,17,6,8,163,208,371
2016,7,17,6,9,363,336,699
2016,7,17,6,10,466,446,912
2016,7,17,6,11,630,517,1147
2016,7,17,6,12,655,560,1215
2016,7,17,6,13,694,500,1194
2016,7,17,6,14,761,539,1300
2016,7,17,6,15,781,510,1291
2016,7,17,6,16,666,488,1154
2016,7,17,6,17,718,503,1221
2016,7,17,6,18,566,484,1050
2016,7,17,6,19,532,447,979
2016,7,17,6,20,512,351,863
2016,7,17,6,21,382,306,688
2016,7,17,6,22,198,146,344
2016,7,17,6,23,85,97,182
2016,7,18,0,0,44,53,97
2016,7,18,0,1,14,18,32
2016,7,18,0,2,9,7,16
2016,7,18,0,3,2,8,10
2016,7,18,0,4,0,7,7
2016,7,18,0,5,10,85,95
2016,7,18,0,6,14,330,344
2016,7,18,0,7,59,810,869
2016,7,18,0,8,107,1013,1120
2016,7,18,0,9,111,448,559
2016,7,18,0,10,133,184,317
2016,7,18,0,11,164,214,378
2016,7,18,0,12,137,271,408
2016,7,18,0,13,152,255,407
2016,7,18,0,14,166,190,356
2016,7,18,0,15,153,334,487
2016,7,18,0,16,80,314,394
2016,7,18,0,17,61,318,379
2016,7,18,0,18,114,884,998
2016,7,18,0,19,212,662,874
2016,7,18,0,20,209,485,694
2016,7,18,0,21,154,307,461
2016,7,18,0,22,79,195,274
2016,7,18,0,23,41,112,153
2016,7,19,1,0,15,31,46
2016,7,19,1,1,4,15,19
2016,7,19,1,2,3,2,5
2016,7,19,1,3,2,2,4
2016,7,19,1,4,2,14,16
2016,7,19,1,5,8,103,111
2016,7,19,1,6,19,381,400
2016,7,19,1,7,32,889,921
2016,7,19,1,8,61,1151,1212
2016,7,19,1,9,100,500,600
2016,7,19,1,10,158,220,378
2016,7,19,1,11,135,245,380
2016,7,19,1,12,185,333,518
2016,7,19,1,13,193,266,459
2016,7,19,1,14,145,282,427
2016,7,19,1,15,163,384,547
2016,7,19,1,16,189,589,778
2016,7,19,1,17,244,1369,1613
2016,7,19,1,18,207,1155,1362
2016,7,19,1,19,191,803,994
2016,7,19,1,20,148,551,699
2016,7,19,1,21,105,398,503
2016,7,19,1,22,66,231,297
2016,7,19,1,23,8,28,36
2016,7,20,2,0,11,30,41
2016,7,20,2,1,8,10,18
2016,7,20,2,2,1,11,12
2016,7,20,2,3,2,4,6
2016,7,20,2,4,1,14,15
2016,7,20,2,5,7,95,102
2016,7,20,2,6,18,358,376
2016,7,20,2,7,45,877,922
2016,7,20,2,8,67,1240,1307
2016,7,20,2,9,94,527,621
2016,7,20,2,10,131,259,390
2016,7,20,2,11,132,280,412
2016,7,20,2,12,151,362,513
2016,7,20,2,13,142,332,474
2016,7,20,2,14,193,300,493
2016,7,20,2,15,157,404,561
2016,7,20,2,16,211,704,915
2016,7,20,2,17,283,1386,1669
2016,7,20,2,18,233,1180,1413
2016,7,20,2,19,194,787,981
2016,7,20,2,20,201,594,795
2016,7,20,2,21,144,451,595
2016,7,20,2,22,90,349,439
2016,7,20,2,23,53,177,230
2016,7,21,3,0,15,77,92
2016,7,21,3,1,12,15,27
2016,7,21,3,2,5,6,11
2016,7,21,3,3,3,6,9
2016,7,21,3,4,4,9,13
2016,7,21,3,5,7,86,93
2016,7,21,3,6,16,316,332
2016,7,21,3,7,37,917,954
2016,7,21,3,8,85,1201,1286
2016,7,21,3,9,94,509,603
2016,7,21,3,10,148,252,400
2016,7,21,3,11,143,272,415
2016,7,21,3,12,166,330,496
2016,7,21,3,13,132,329,461
2016,7,21,3,14,155,297,452
2016,7,21,3,15,159,396,555
2016,7,21,3,16,219,684,903
2016,7,21,3,17,248,1322,1570
2016,7,21,3,18,210,1101,1311
2016,7,21,3,19,221,789,1010
2016,7,21,3,20,199,547,746
2016,7,21,3,21,135,428,563
2016,7,21,3,22,71,289,360
2016,7,21,3,23,44,156,200
2016,7,22,4,0,25,69,94
2016,7,22,4,1,15,38,53
2016,7,22,4,2,10,14,24
2016,7,22,4,3,6,6,12
2016,7,22,4,4,2,12,14
2016,7,22,4,5,8,80,88
2016,7,22,4,6,19,264,283
2016,7,22,4,7,48,721,769
2016,7,22,4,8,92,1069,1161
2016,7,22,4,9,133,505,638
2016,7,22,4,10,207,256,463
2016,7,22,4,11,214,241,455
2016,7,22,4,12,236,353,589
2016,7,22,4,13,230,346,576
2016,7,22,4,14,207,348,555
2016,7,22,4,15,193,426,619
2016,7,22,4,16,212,677,889
2016,7,22,4,17,176,1091,1267
2016,7,22,4,18,184,855,1039
2016,7,22,4,19,229,539,768
2016,7,22,4,20,215,415,630
2016,7,22,4,21,182,283,465
2016,7,22,4,22,123,262,385
2016,7,22,4,23,67,202,269
2016,7,23,5,0,52,128,180
2016,7,23,5,1,29,65,94
2016,7,23,5,2,28,53,81
2016,7,23,5,3,18,27,45
2016,7,23,5,4,6,14,20
2016,7,23,5,5,12,20,32
2016,7,23,5,6,17,54,71
2016,7,23,5,7,34,148,182
2016,7,23,5,8,84,292,376
2016,7,23,5,9,175,359,534
2016,7,23,5,10,252,449,701
2016,7,23,5,11,283,469,752
2016,7,23,5,12,310,474,784
2016,7,23,5,13,286,408,694
2016,7,23,5,14,320,342,662
2016,7,23,5,15,297,435,732
2016,7,23,5,16,333,377,710
2016,7,23,5,17,297,370,667
2016,7,23,5,18,274,345,619
2016,7,23,5,19,257,334,591
2016,7,23,5,20,313,299,612
2016,7,23,5,21,220,236,456
2016,7,23,5,22,162,252,414
2016,7,23,5,23,108,144,252
2016,7,24,6,0,52,118,170
2016,7,24,6,1,40,90,130
2016,7,24,6,2,18,69,87
2016,7,24,6,3,19,47,66
2016,7,24,6,4,4,10,14
2016,7,24,6,5,9,15,24
2016,7,24,6,6,23,34,57
2016,7,24,6,7,39,88,127
2016,7,24,6,8,85,189,274
2016,7,24,6,9,169,292,461
2016,7,24,6,10,305,361,666
2016,7,24,6,11,308,405,713
2016,7,24,6,12,314,427,741
2016,7,24,6,13,316,446,762
2016,7,24,6,14,327,401,728
2016,7,24,6,15,345,389,734
2016,7,24,6,16,274,378,652
2016,7,24,6,17,256,377,633
2016,7,24,6,18,306,407,713
2016,7,24,6,19,275,351,626
2016,7,24,6,20,223,284,507
2016,7,24,6,21,126,213,339
2016,7,24,6,22,101,169,270
2016,7,24,6,23,52,69,121
2016,7,25,0,0,16,30,46
2016,7,25,0,1,11,16,27
2016,7,25,0,2,8,11,19
2016,7,25,0,3,3,8,11
2016,7,25,0,4,4,14,18
2016,7,25,0,5,11,80,91
2016,7,25,0,6,20,310,330
2016,7,25,0,7,48,753,801
2016,7,25,0,8,83,950,1033
2016,7,25,0,9,85,378,463
2016,7,25,0,10,109,168,277
2016,7,25,0,11,144,206,350
2016,7,25,0,12,130,221,351
2016,7,25,0,13,121,208,329
2016,7,25,0,14,131,210,341
2016,7,25,0,15,141,297,438
2016,7,25,0,16,133,493,626
2016,7,25,0,17,182,1177,1359
2016,7,25,0,18,176,934,1110
2016,7,25,0,19,192,639,831
2016,7,25,0,20,178,440,618
2016,7,25,0,21,121,289,410
2016,7,25,0,22,112,160,272
2016,7,25,0,23,43,81,124
2016,7,26,1,0,13,33,46
2016,7,26,1,1,11,19,30
2016,7,26,1,2,3,6,9
2016,7,26,1,3,6,5,11
2016,7,26,1,4,6,6,12
2016,7,26,1,5,12,96,108
2016,7,26,1,6,20,344,364
2016,7,26,1,7,42,815,857
2016,7,26,1,8,66,1124,1190
2016,7,26,1,9,80,398,478
2016,7,26,1,10,131,194,325
2016,7,26,1,11,126,211,337
2016,7,26,1,12,147,274,421
2016,7,26,1,13,155,226,381
2016,7,26,1,14,143,194,337
2016,7,26,1,15,139,274,413
2016,7,26,1,16,129,558,687
2016,7,26,1,17,182,1211,1393
2016,7,26,1,18,151,1111,1262
2016,7,26,1,19,193,753,946
2016,7,26,1,20,134,499,633
2016,7,26,1,21,118,357,475
2016,7,26,1,22,75,199,274
2016,7,26,1,23,25,136,161
2016,7,27,2,0,16,35,51
2016,7,27,2,1,16,29,45
2016,7,27,2,2,6,11,17
2016,7,27,2,3,4,5,9
2016,7,27,2,4,5,10,15
2016,7,27,2,5,10,92,102
2016,7,27,2,6,35,346,381
2016,7,27,2,7,47,895,942
2016,7,27,2,8,71,1058,1129
2016,7,27,2,9,71,457,528
2016,7,27,2,10,131,217,348
2016,7,27,2,11,144,229,373
2016,7,27,2,12,102,278,380
2016,7,27,2,13,125,284,409
2016,7,27,2,14,126,274,400
2016,7,27,2,15,141,322,463
2016,7,27,2,16,120,614,734
2016,7,27,2,17,126,1283,1409
2016,7,27,2,18,172,1113,1285
2016,7,27,2,19,182,738,920
2016,7,27,2,20,170,532,702
2016,7,27,2,21,145,335,480
2016,7,27,2,22,67,229,296
2016,7,27,2,23,29,117,146
2016,7,28,3,0,22,59,81
2016,7,28,3,1,17,26,43
2016,7,28,3,2,26,10,36
2016,7,28,3,3,13,7,20
2016,7,28,3,4,2,7,9
2016,7,28,3,5,9,88,97
2016,7,28,3,6,14,298,312
2016,7,28,3,7,31,793,824
2016,7,28,3,8,69,1091,1160
2016,7,28,3,9,72,494,566
2016,7,28,3,10,112,211,323
2016,7,28,3,11,125,237,362
2016,7,28,3,12,134,292,426
2016,7,28,3,13,135,301,436
2016,7,28,3,14,164,242,406
2016,7,28,3,15,180,318,498
2016,7,28,3,16,188,570,758
2016,7,28,3,17,106,583,689
2016,7,28,3,18,125,756,881
2016,7,28,3,19,153,612,765
2016,7,28,3,20,78,356,434
2016,7,28,3,21,19,91,110
2016,7,28,3,22,15,76,91
2016,7,28,3,23,4,33,37
2016,7,29,4,0,3,31,34
2016,7,29,4,1,1,19,20
2016,7,29,4,2,8,7,15
2016,7,29,4,3,0,4,4
2016,7,29,4,4,3,9,12
2016,7,29,4,5,4,64,68
2016,7,29,4,6,7,212,219
2016,7,29,4,7,35,664,699
2016,7,29,4,8,63,1055,1118
2016,7,29,4,9,124,491,615
2016,7,29,4,10,184,298,482
2016,7,29,4,11,242,309,551
2016,7,29,4,12,271,374,645
2016,7,29,4,13,248,349,597
2016,7,29,4,14,260,350,610
2016,7,29,4,15,229,448,677
2016,7,29,4,16,238,714,952
2016,7,29,4,17,227,1098,1325
2016,7,29,4,18,224,861,1085
2016,7,29,4,19,218,595,813
2016,7,29,4,20,179,450,629
2016,7,29,4,21,141,305,446
2016,7,29,4,22,89,222,311
2016,7,29,4,23,62,159,221
2016,7,30,5,0,69,118,187
2016,7,30,5,1,51,87,138
2016,7,30,5,2,26,61,87
2016,7,30,5,3,15,27,42
2016,7,30,5,4,7,10,17
2016,7,30,5,5,9,17,26
2016,7,30,5,6,26,52,78
2016,7,30,5,7,33,99,132
2016,7,30,5,8,80,235,315
2016,7,30,5,9,156,411,567
2016,7,30,5,10,297,425,722
2016,7,30,5,11,383,517,900
2016,7,30,5,12,301,409,710
2016,7,30,5,13,257,360,617
2016,7,30,5,14,368,396,764
2016,7,30,5,15,425,437,862
2016,7,30,5,16,405,406,811
2016,7,30,5,17,333,393,726
2016,7,30,5,18,238,320,558
2016,7,30,5,19,81,130,211
2016,7,30,5,20,23,36,59
2016,7,30,5,21,25,52,77
2016,7,30,5,22,53,87,140
2016,7,30,5,23,44,140,184
2016,7,31,6,0,44,127,171
2016,7,31,6,1,25,71,96
2016,7,31,6,2,21,62,83
2016,7,31,6,3,8,27,35
2016,7,31,6,4,8,11,19
2016,7,31,6,5,7,9,16
2016,7,31,6,6,12,35,47
2016,7,31,6,7,41,90,131
2016,7,31,6,8,74,184,258
2016,7,31,6,9,224,324,548
2016,7,31,6,10,308,451,759
2016,7,31,6,11,382,558,940
2016,7,31,6,12,411,587,998
2016,7,31,6,13,383,499,882
2016,7,31,6,14,430,516,946
2016,7,31,6,15,466,506,972
2016,7,31,6,16,384,461,845
2016,7,31,6,17,284,422,706
2016,7,31,6,18,230,377,607
2016,7,31,6,19,196,336,532
2016,7,31,6,20,190,304,494
2016,7,31,6,21,136,225,361
2016,7,31,6,22,100,178,278
2016,7,31,6,23,31,83,114
2016,8,1,0,0,11,34,45
2016,8,1,0,1,17,21,38
2016,8,1,0,2,11,11,22
2016,8,1,0,3,4,4,8
2016,8,1,0,4,1,11,12
2016,8,1,0,5,18,82,100
2016,8,1,0,6,16,318,334
2016,8,1,0,7,60,822,882
2016,8,1,0,8,81,982,1063
2016,8,1,0,9,104,420,524
2016,8,1,0,10,140,184,324
2016,8,1,0,11,218,200,418
2016,8,1,0,12,226,286,512
2016,8,1,0,13,185,270,455
2016,8,1,0,14,181,289,470
2016,8,1,0,15,193,327,520
2016,8,1,0,16,196,571,767
2016,8,1,0,17,253,1384,1637
2016,8,1,0,18,186,1147,1333
2016,8,1,0,19,193,759,952
2016,8,1,0,20,153,515,668
2016,8,1,0,21,115,300,415
2016,8,1,0,22,91,195,286
2016,8,1,0,23,59,104,163
2016,8,2,1,0,19,50,69
2016,8,2,1,1,12,14,26
2016,8,2,1,2,8,6,14
2016,8,2,1,3,1,5,6
2016,8,2,1,4,3,15,18
2016,8,2,1,5,4,101,105
2016,8,2,1,6,16,429,445
2016,8,2,1,7,40,934,974
2016,8,2,1,8,95,1161,1256
2016,8,2,1,9,85,470,555
2016,8,2,1,10,141,241,382
2016,8,2,1,11,181,268,449
2016,8,2,1,12,165,333,498
2016,8,2,1,13,172,323,495
2016,8,2,1,14,192,263,455
2016,8,2,1,15,190,344,534
2016,8,2,1,16,212,661,873
2016,8,2,1,17,285,1450,1735
2016,8,2,1,18,260,1279,1539
2016,8,2,1,19,243,830,1073
2016,8,2,1,20,170,635,805
2016,8,2,1,21,154,403,557
2016,8,2,1,22,83,249,332
2016,8,2,1,23,38,136,174
2016,8,3,2,0,8,48,56
2016,8,3,2,1,11,22,33
2016,8,3,2,2,2,9,11
2016,8,3,2,3,1,7,8
2016,8,3,2,4,2,16,18
2016,8,3,2,5,11,122,133
2016,8,3,2,6,30,360,390
2016,8,3,2,7,52,954,1006
2016,8,3,2,8,81,1211,1292
2016,8,3,2,9,97,514,611
2016,8,3,2,10,164,247,411
2016,8,3,2,11,171,305,476
2016,8,3,2,12,197,375,572
2016,8,3,2,13,187,391,578
2016,8,3,2,14,224,286,510
2016,8,3,2,15,229,416,645
2016,8,3,2,16,246,692,938
2016,8,3,2,17,270,1364,1634
2016,8,3,2,18,258,1151,1409
2016,8,3,2,19,232,845,1077
2016,8,3,2,20,180,601,781
2016,8,3,2,21,128,348,476
2016,8,3,2,22,92,266,358
2016,8,3,2,23,36,128,164
2016,8,4,3,0,36,46,82
2016,8,4,3,1,34,13,47
2016,8,4,3,2,21,10,31
2016,8,4,3,3,20,8,28
2016,8,4,3,4,1,11,12
2016,8,4,3,5,9,103,112
2016,8,4,3,6,22,337,359
2016,8,4,3,7,40,840,880
2016,8,4,3,8,79,1188,1267
2016,8,4,3,9,109,503,612
2016,8,4,3,10,143,245,388
2016,8,4,3,11,142,262,404
2016,8,4,3,12,226,372,598
2016,8,4,3,13,215,363,578
2016,8,4,3,14,190,332,522
2016,8,4,3,15,236,386,622
2016,8,4,3,16,244,667,911
2016,8,4,3,17,314,1331,1645
2016,8,4,3,18,284,1158,1442
2016,8,4,3,19,258,809,1067
2016,8,4,3,20,251,624,875
2016,8,4,3,21,149,408,557
2016,8,4,3,22,87,240,327
2016,8,4,3,23,47,142,189
2016,8,5,4,0,21,51,72
2016,8,5,4,1,21,36,57
2016,8,5,4,2,5,20,25
2016,8,5,4,3,3,12,15
2016,8,5,4,4,0,9,9
2016,8,5,4,5,3,102,105
2016,8,5,4,6,23,262,285
2016,8,5,4,7,51,671,722
2016,8,5,4,8,88,1114,1202
2016,8,5,4,9,124,519,643
2016,8,5,4,10,189,283,472
2016,8,5,4,11,203,277,480
2016,8,5,4,12,314,419,733
2016,8,5,4,13,244,419,663
2016,8,5,4,14,290,392,682
2016,8,5,4,15,283,452,735
2016,8,5,4,16,269,737,1006
2016,8,5,4,17,297,1156,1453
2016,8,5,4,18,270,918,1188
2016,8,5,4,19,215,671,886
2016,8,5,4,20,203,420,623
2016,8,5,4,21,130,348,478
2016,8,5,4,22,130,268,398
2016,8,5,4,23,86,168,254
2016,8,6,5,0,67,138,205
2016,8,6,5,1,52,96,148
2016,8,6,5,2,21,42,63
2016,8,6,5,3,12,25,37
2016,8,6,5,4,16,13,29
2016,8,6,5,5,3,23,26
2016,8,6,5,6,20,44,64
2016,8,6,5,7,23,136,159
2016,8,6,5,8,93,241,334
2016,8,6,5,9,239,389,628
2016,8,6,5,10,291,515,806
2016,8,6,5,11,379,492,871
2016,8,6,5,12,377,504,881
2016,8,6,5,13,455,464,919
2016,8,6,5,14,364,407,771
2016,8,6,5,15,288,397,685
2016,8,6,5,16,415,425,840
2016,8,6,5,17,390,420,810
2016,8,6,5,18,309,401,710
2016,8,6,5,19,355,362,717
2016,8,6,5,20,251,289,540
2016,8,6,5,21,216,257,473
2016,8,6,5,22,188,209,397
2016,8,6,5,23,70,157,227
2016,8,7,6,0,55,115,170
2016,8,7,6,1,32,106,138
2016,8,7,6,2,31,62,93
2016,8,7,6,3,18,34,52
2016,8,7,6,4,3,11,14
2016,8,7,6,5,14,18,32
2016,8,7,6,6,12,33,45
2016,8,7,6,7,32,83,115
2016,8,7,6,8,98,165,263
2016,8,7,6,9,212,335,547
2016,8,7,6,10,355,451,806
2016,8,7,6,11,393,540,933
2016,8,7,6,12,439,534,973
2016,8,7,6,13,438,542,980
2016,8,7,6,14,439,538,977
2016,8,7,6,15,464,521,985
2016,8,7,6,16,450,554,1004
2016,8,7,6,17,397,503,900
2016,8,7,6,18,342,472,814
2016,8,7,6,19,343,415,758
2016,8,7,6,20,237,342,579
2016,8,7,6,21,171,235,406
2016,8,7,6,22,94,151,245
2016,8,7,6,23,53,80,133
2016,8,8,0,0,30,35,65
2016,8,8,0,1,11,11,22
2016,8,8,0,2,4,6,10
2016,8,8,0,3,3,3,6
2016,8,8,0,4,2,14,16
2016,8,8,0,5,4,85,89
2016,8,8,0,6,20,310,330
2016,8,8,0,7,44,824,868
2016,8,8,0,8,70,1061,1131
2016,8,8,0,9,121,433,554
2016,8,8,0,10,165,220,385
2016,8,8,0,11,199,221,420
2016,8,8,0,12,197,308,505
2016,8,8,0,13,179,272,451
2016,8,8,0,14,183,283,466
2016,8,8,0,15,192,314,506
2016,8,8,0,16,214,634,848
2016,8,8,0,17,262,1364,1626
2016,8,8,0,18,250,1060,1310
2016,8,8,0,19,203,714,917
2016,8,8,0,20,128,498,626
2016,8,8,0,21,112,299,411
2016,8,8,0,22,79,179,258
2016,8,8,0,23,36,70,106
2016,8,9,1,0,11,34,45
2016,8,9,1,1,10,20,30
2016,8,9,1,2,3,3,6
2016,8,9,1,3,2,0,2
2016,8,9,1,4,0,11,11
2016,8,9,1,5,6,97,103
2016,8,9,1,6,31,330,361
2016,8,9,1,7,48,918,966
2016,8,9,1,8,66,1236,1302
2016,8,9,1,9,114,491,605
2016,8,9,1,10,133,221,354
2016,8,9,1,11,184,254,438
2016,8,9,1,12,200,349,549
2016,8,9,1,13,170,362,532
2016,8,9,1,14,215,239,454
2016,8,9,1,15,198,365,563
2016,8,9,1,16,219,669,888
2016,8,9,1,17,238,1379,1617
2016,8,9,1,18,199,1102,1301
2016,8,9,1,19,164,656,820
2016,8,9,1,20,113,487,600
2016,8,9,1,21,104,304,408
2016,8,9,1,22,91,225,316
2016,8,9,1,23,43,110,153
2016,8,10,2,0,24,39,63
2016,8,10,2,1,14,17,31
2016,8,10,2,2,5,0,5
2016,8,10,2,3,0,4,4
2016,8,10,2,4,2,12,14
2016,8,10,2,5,16,109,125
2016,8,10,2,6,26,305,331
2016,8,10,2,7,42,903,945
2016,8,10,2,8,51,1185,1236
2016,8,10,2,9,78,479,557
2016,8,10,2,10,144,246,390
2016,8,10,2,11,167,233,400
2016,8,10,2,12,128,313,441
2016,8,10,2,13,128,346,474
2016,8,10,2,14,192,301,493
2016,8,10,2,15,194,387,581
2016,8,10,2,16,170,646,816
2016,8,10,2,17,205,1264,1469
2016,8,10,2,18,229,1123,1352
2016,8,10,2,19,213,739,952
2016,8,10,2,20,135,535,670
2016,8,10,2,21,111,323,434
2016,8,10,2,22,80,215,295
2016,8,10,2,23,38,142,180
2016,8,11,3,0,19,53,72
2016,8,11,3,1,7,16,23
2016,8,11,3,2,14,7,21
2016,8,11,3,3,4,4,8
2016,8,11,3,4,0,10,10
2016,8,11,3,5,3,92,95
2016,8,11,3,6,21,323,344
2016,8,11,3,7,47,814,861
2016,8,11,3,8,79,1097,1176
2016,8,11,3,9,123,489,612
2016,8,11,3,10,150,217,367
2016,8,11,3,11,180,241,421
2016,8,11,3,12,155,312,467
2016,8,11,3,13,135,289,424
2016,8,11,3,14,146,219,365
2016,8,11,3,15,144,322,466
2016,8,11,3,16,204,526,730
2016,8,11,3,17,186,1188,1374
2016,8,11,3,18,217,974,1191
2016,8,11,3,19,201,672,873
2016,8,11,3,20,171,454,625
2016,8,11,3,21,142,296,438
2016,8,11,3,22,105,220,325
2016,8,11,3,23,43,135,178
2016,8,12,4,0,20,58,78
2016,8,12,4,1,10,28,38
2016,8,12,4,2,4,21,25
2016,8,12,4,3,4,8,12
2016,8,12,4,4,2,10,12
2016,8,12,4,5,4,79,83
2016,8,12,4,6,28,286,314
2016,8,12,4,7,38,697,735
2016,8,12,4,8,76,1000,1076
2016,8,12,4,9,141,454,595
2016,8,12,4,10,137,227,364
2016,8,12,4,11,190,270,460
2016,8,12,4,12,176,301,477
2016,8,12,4,13,175,346,521
2016,8,12,4,14,177,301,478
2016,8,12,4,15,196,379,575
2016,8,12,4,16,186,583,769
2016,8,12,4,17,214,933,1147
2016,8,12,4,18,205,714,919
2016,8,12,4,19,180,542,722
2016,8,12,4,20,177,331,508
2016,8,12,4,21,115,257,372
2016,8,12,4,22,104,240,344
2016,8,12,4,23,68,161,229
2016,8,13,5,0,33,113,146
2016,8,13,5,1,21,57,78
2016,8,13,5,2,15,55,70
2016,8,13,5,3,11,23,34
2016,8,13,5,4,0,12,12
2016,8,13,5,5,0,17,17
2016,8,13,5,6,0,61,61
2016,8,13,5,7,32,118,150
2016,8,13,5,8,92,246,338
2016,8,13,5,9,148,344,492
2016,8,13,5,10,218,360,578
2016,8,13,5,11,252,421,673
2016,8,13,5,12,287,423,710
2016,8,13,5,13,281,371,652
2016,8,13,5,14,273,341,614
2016,8,13,5,15,237,333,570
2016,8,13,5,16,278,335,613
2016,8,13,5,17,261,277,538
2016,8,13,5,18,204,327,531
2016,8,13,5,19,235,299,534
2016,8,13,5,20,172,273,445
2016,8,13,5,21,141,188,329
2016,8,13,5,22,124,190,314
2016,8,13,5,23,85,133,218
2016,8,14,6,0,56,125,181
2016,8,14,6,1,17,82,99
2016,8,14,6,2,14,52,66
2016,8,14,6,3,11,28,39
2016,8,14,6,4,9,15,24
2016,8,14,6,5,5,4,9
2016,8,14,6,6,11,41,52
2016,8,14,6,7,27,75,102
2016,8,14,6,8,57,157,214
2016,8,14,6,9,111,254,365
2016,8,14,6,10,193,361,554
2016,8,14,6,11,269,411,680
2016,8,14,6,12,233,375,608
2016,8,14,6,13,221,409,630
2016,8,14,6,14,229,348,577
2016,8,14,6,15,229,349,578
2016,8,14,6,16,171,385,556
2016,8,14,6,17,191,334,525
2016,8,14,6,18,179,332,511
2016,8,14,6,19,154,289,443
2016,8,14,6,20,139,194,333
2016,8,14,6,21,92,153,245
2016,8,14,6,22,78,123,201
2016,8,14,6,23,36,80,116
2016,8,15,0,0,39,25,64
2016,8,15,0,1,14,9,23
2016,8,15,0,2,12,7,19
2016,8,15,0,3,9,8,17
2016,8,15,0,4,6,15,21
2016,8,15,0,5,4,75,79
2016,8,15,0,6,25,293,318
2016,8,15,0,7,43,759,802
2016,8,15,0,8,71,1037,1108
2016,8,15,0,9,94,433,527
2016,8,15,0,10,151,207,358
2016,8,15,0,11,154,170,324
2016,8,15,0,12,139,274,413
2016,8,15,0,13,123,263,386
2016,8,15,0,14,148,219,367
2016,8,15,0,15,131,283,414
2016,8,15,0,16,160,574,734
2016,8,15,0,17,203,1188,1391
2016,8,15,0,18,118,812,930
2016,8,15,0,19,80,526,606
2016,8,15,0,20,31,184,215
2016,8,15,0,21,3,47,50
2016,8,15,0,22,6,36,42
2016,8,15,0,23,2,30,32
2016,8,16,1,0,3,27,30
2016,8,16,1,1,4,11,15
2016,8,16,1,2,3,4,7
2016,8,16,1,3,0,6,6
2016,8,16,1,4,2,8,10
2016,8,16,1,5,7,91,98
2016,8,16,1,6,21,329,350
2016,8,16,1,7,43,870,913
2016,8,16,1,8,81,1105,1186
2016,8,16,1,9,91,428,519
2016,8,16,1,10,104,251,355
2016,8,16,1,11,128,254,382
2016,8,16,1,12,123,279,402
2016,8,16,1,13,129,258,387
2016,8,16,1,14,127,245,372
2016,8,16,1,15,122,294,416
2016,8,16,1,16,148,593,741
2016,8,16,1,17,184,1262,1446
2016,8,16,1,18,165,1093,1258
2016,8,16,1,19,199,738,937
2016,8,16,1,20,144,511,655
2016,8,16,1,21,117,312,429
2016,8,16,1,22,65,212,277
2016,8,16,1,23,49,76,125
2016,8,17,2,0,39,47,86
2016,8,17,2,1,13,16,29
2016,8,17,2,2,1,5,6
2016,8,17,2,3,3,3,6
2016,8,17,2,4,5,17,22
2016,8,17,2,5,5,89,94
2016,8,17,2,6,15,380,395
2016,8,17,2,7,27,832,859
2016,8,17,2,8,48,1178,1226
2016,8,17,2,9,75,467,542
2016,8,17,2,10,104,202,306
2016,8,17,2,11,144,223,367
2016,8,17,2,12,109,300,409
2016,8,17,2,13,124,253,377
2016,8,17,2,14,166,234,400
2016,8,17,2,15,133,310,443
2016,8,17,2,16,173,615,788
2016,8,17,2,17,245,1272,1517
2016,8,17,2,18,196,1111,1307
2016,8,17,2,19,185,751,936
2016,8,17,2,20,124,472,596
2016,8,17,2,21,22,118,140
2016,8,17,2,22,10,60,70
2016,8,17,2,23,11,56,67
2016,8,18,3,0,11,29,40
2016,8,18,3,1,2,12,14
2016,8,18,3,2,5,11,16
2016,8,18,3,3,6,3,9
2016,8,18,3,4,8,16,24
2016,8,18,3,5,4,79,83
2016,8,18,3,6,17,304,321
2016,8,18,3,7,42,817,859
2016,8,18,3,8,95,1131,1226
2016,8,18,3,9,93,534,627
2016,8,18,3,10,147,223,370
2016,8,18,3,11,167,253,420
2016,8,18,3,12,179,339,518
2016,8,18,3,13,115,313,428
2016,8,18,3,14,179,258,437
2016,8,18,3,15,149,354,503
2016,8,18,3,16,176,630,806
2016,8,18,3,17,206,1258,1464
2016,8,18,3,18,211,1087,1298
2016,8,18,3,19,178,641,819
2016,8,18,3,20,137,529,666
2016,8,18,3,21,113,287,400
2016,8,18,3,22,80,207,287
2016,8,18,3,23,60,126,186
2016,8,19,4,0,37,66,103
2016,8,19,4,1,12,23,35
2016,8,19,4,2,8,16,24
2016,8,19,4,3,2,7,9
2016,8,19,4,4,2,16,18
2016,8,19,4,5,2,89,91
2016,8,19,4,6,17,274,291
2016,8,19,4,7,30,716,746
2016,8,19,4,8,83,1037,1120
2016,8,19,4,9,94,498,592
2016,8,19,4,10,152,261,413
2016,8,19,4,11,191,325,516
2016,8,19,4,12,165,413,578
2016,8,19,4,13,180,400,580
2016,8,19,4,14,213,351,564
2016,8,19,4,15,178,456,634
2016,8,19,4,16,232,709,941
2016,8,19,4,17,207,1023,1230
2016,8,19,4,18,220,795,1015
2016,8,19,4,19,171,608,779
2016,8,19,4,20,157,426,583
2016,8,19,4,21,129,283,412
2016,8,19,4,22,113,268,381
2016,8,19,4,23,74,186,260
2016,8,20,5,0,49,110,159
2016,8,20,5,1,21,64,85
2016,8,20,5,2,8,55,63
2016,8,20,5,3,9,32,41
2016,8,20,5,4,2,16,18
2016,8,20,5,5,6,14,20
2016,8,20,5,6,14,64,78
2016,8,20,5,7,40,109,149
2016,8,20,5,8,102,274,376
2016,8,20,5,9,166,394,560
2016,8,20,5,10,306,474,780
2016,8,20,5,11,370,473,843
2016,8,20,5,12,387,536,923
2016,8,20,5,13,413,488,901
2016,8,20,5,14,466,460,926
2016,8,20,5,15,463,470,933
2016,8,20,5,16,421,470,891
2016,8,20,5,17,322,420,742
2016,8,20,5,18,314,461,775
2016,8,20,5,19,324,412,736
2016,8,20,5,20,219,297,516
2016,8,20,5,21,209,249,458
2016,8,20,5,22,157,160,317
2016,8,20,5,23,87,157,244
2016,8,21,6,0,69,122,191
2016,8,21,6,1,42,99,141
2016,8,21,6,2,27,72,99
2016,8,21,6,3,9,35,44
2016,8,21,6,4,9,16,25
2016,8,21,6,5,9,14,23
2016,8,21,6,6,11,33,44
2016,8,21,6,7,24,81,105
2016,8,21,6,8,85,146,231
2016,8,21,6,9,173,295,468
2016,8,21,6,10,251,380,631
2016,8,21,6,11,341,426,767
2016,8,21,6,12,311,473,784
2016,8,21,6,13,319,439,758
2016,8,21,6,14,199,330,529
2016,8,21,6,15,58,102,160
2016,8,21,6,16,68,125,193
2016,8,21,6,17,151,332,483
2016,8,21,6,18,171,347,518
2016,8,21,6,19,99,205,304
2016,8,21,6,20,68,202,270
2016,8,21,6,21,95,147,242
2016,8,21,6,22,57,99,156
2016,8,21,6,23,20,66,86
2016,8,22,0,0,23,33,56
2016,8,22,0,1,3,15,18
2016,8,22,0,2,4,5,9
2016,8,22,0,3,2,3,5
2016,8,22,0,4,3,15,18
2016,8,22,0,5,8,90,98
2016,8,22,0,6,14,311,325
2016,8,22,0,7,36,867,903
2016,8,22,0,8,88,1027,1115
2016,8,22,0,9,77,398,475
2016,8,22,0,10,136,211,347
2016,8,22,0,11,191,218,409
2016,8,22,0,12,172,311,483
2016,8,22,0,13,189,278,467
2016,8,22,0,14,178,258,436
2016,8,22,0,15,190,350,540
2016,8,22,0,16,216,681,897
2016,8,22,0,17,244,1394,1638
2016,8,22,0,18,246,1255,1501
2016,8,22,0,19,225,801,1026
2016,8,22,0,20,191,547,738
2016,8,22,0,21,91,346,437
2016,8,22,0,22,80,182,262
2016,8,22,0,23,57,89,146
2016,8,23,1,0,7,42,49
2016,8,23,1,1,5,13,18
2016,8,23,1,2,2,11,13
2016,8,23,1,3,2,2,4
2016,8,23,1,4,3,8,11
2016,8,23,1,5,7,113,120
2016,8,23,1,6,19,366,385
2016,8,23,1,7,42,972,1014
2016,8,23,1,8,86,1225,1311
2016,8,23,1,9,82,517,599
2016,8,23,1,10,128,230,358
2016,8,23,1,11,171,292,463
2016,8,23,1,12,204,342,546
2016,8,23,1,13,181,333,514
2016,8,23,1,14,166,303,469
2016,8,23,1,15,164,376,540
2016,8,23,1,16,199,740,939
2016,8,23,1,17,227,1456,1683
2016,8,23,1,18,209,1209,1418
2016,8,23,1,19,209,818,1027
2016,8,23,1,20,157,559,716
2016,8,23,1,21,86,350,436
2016,8,23,1,22,47,221,268
2016,8,23,1,23,30,111,141
2016,8,24,2,0,15,47,62
2016,8,24,2,1,11,20,31
2016,8,24,2,2,4,9,13
2016,8,24,2,3,7,2,9
2016,8,24,2,4,1,8,9
2016,8,24,2,5,9,119,128
2016,8,24,2,6,27,396,423
2016,8,24,2,7,52,954,1006
2016,8,24,2,8,70,1161,1231
2016,8,24,2,9,82,497,579
2016,8,24,2,10,151,249,400
2016,8,24,2,11,125,249,374
2016,8,24,2,12,194,403,597
2016,8,24,2,13,180,314,494
2016,8,24,2,14,178,313,491
2016,8,24,2,15,192,337,529
2016,8,24,2,16,184,666,850
2016,8,24,2,17,198,1440,1638
2016,8,24,2,18,195,1172,1367
2016,8,24,2,19,194,791,985
2016,8,24,2,20,100,475,575
2016,8,24,2,21,95,361,456
2016,8,24,2,22,55,286,341
2016,8,24,2,23,36,129,165
2016,8,25,3,0,21,48,69
2016,8,25,3,1,3,27,30
2016,8,25,3,2,9,10,19
2016,8,25,3,3,2,8,10
2016,8,25,3,4,3,7,10
2016,8,25,3,5,3,108,111
2016,8,25,3,6,18,333,351
2016,8,25,3,7,44,936,980
2016,8,25,3,8,59,1190,1249
2016,8,25,3,9,84,455,539
2016,8,25,3,10,143,276,419
2016,8,25,3,11,186,281,467
2016,8,25,3,12,176,333,509
2016,8,25,3,13,170,344,514
2016,8,25,3,14,183,295,478
2016,8,25,3,15,193,388,581
2016,8,25,3,16,207,662,869
2016,8,25,3,17,240,1282,1522
2016,8,25,3,18,181,1112,1293
2016,8,25,3,19,168,717,885
2016,8,25,3,20,148,506,654
2016,8,25,3,21,73,385,458
2016,8,25,3,22,79,260,339
2016,8,25,3,23,34,134,168
2016,8,26,4,0,22,56,78
2016,8,26,4,1,8,29,37
2016,8,26,4,2,7,19,26
2016,8,26,4,3,4,5,9
2016,8,26,4,4,1,15,16
2016,8,26,4,5,10,82,92
2016,8,26,4,6,16,266,282
2016,8,26,4,7,41,727,768
2016,8,26,4,8,60,1065,1125
2016,8,26,4,9,113,498,611
2016,8,26,4,10,154,262,416
2016,8,26,4,11,146,257,403
2016,8,26,4,12,161,374,535
2016,8,26,4,13,163,346,509
2016,8,26,4,14,173,319,492
2016,8,26,4,15,165,423,588
2016,8,26,4,16,188,734,922
2016,8,26,4,17,222,1049,1271
2016,8,26,4,18,189,809,998
2016,8,26,4,19,160,539,699
2016,8,26,4,20,134,364,498
2016,8,26,4,21,113,260,373
2016,8,26,4,22,84,220,304
2016,8,26,4,23,53,191,244
2016,8,27,5,0,54,145,199
2016,8,27,5,1,17,75,92
2016,8,27,5,2,12,57,69
2016,8,27,5,3,5,27,32
2016,8,27,5,4,5,14,19
2016,8,27,5,5,12,18,30
2016,8,27,5,6,12,58,70
2016,8,27,5,7,27,131,158
2016,8,27,5,8,76,277,353
2016,8,27,5,9,158,368,526
2016,8,27,5,10,296,509,805
2016,8,27,5,11,330,529,859
2016,8,27,5,12,361,506,867
2016,8,27,5,13,384,501,885
2016,8,27,5,14,327,461,788
2016,8,27,5,15,363,443,806
2016,8,27,5,16,369,458,827
2016,8,27,5,17,377,424,801
2016,8,27,5,18,370,443,813
2016,8,27,5,19,300,389,689
2016,8,27,5,20,238,280,518
2016,8,27,5,21,161,272,433
2016,8,27,5,22,112,206,318
2016,8,27,5,23,81,159,240
2016,8,28,6,0,39,106,145
2016,8,28,6,1,34,83,117
2016,8,28,6,2,28,59,87
2016,8,28,6,3,11,26,37
2016,8,28,6,4,11,9,20
2016,8,28,6,5,6,5,11
2016,8,28,6,6,9,34,43
2016,8,28,6,7,43,96,139
2016,8,28,6,8,92,182,274
2016,8,28,6,9,141,301,442
2016,8,28,6,10,308,400,708
2016,8,28,6,11,297,479,776
2016,8,28,6,12,358,558,916
2016,8,28,6,13,358,521,879
2016,8,28,6,14,363,482,845
2016,8,28,6,15,332,486,818
2016,8,28,6,16,291,540,831
2016,8,28,6,17,288,534,822
2016,8,28,6,18,274,574,848
2016,8,28,6,19,215,396,611
2016,8,28,6,20,170,312,482
2016,8,28,6,21,122,215,337
2016,8,28,6,22,75,154,229
2016,8,28,6,23,35,76,111
2016,8,29,0,0,23,48,71
2016,8,29,0,1,14,11,25
2016,8,29,0,2,5,8,13
2016,8,29,0,3,2,3,5
2016,8,29,0,4,1,12,13
2016,8,29,0,5,4,88,92
2016,8,29,0,6,13,336,349
2016,8,29,0,7,40,896,936
2016,8,29,0,8,70,1069,1139
2016,8,29,0,9,107,411,518
2016,8,29,0,10,114,213,327
2016,8,29,0,11,128,242,370
2016,8,29,0,12,181,305,486
2016,8,29,0,13,140,304,444
2016,8,29,0,14,158,247,405
2016,8,29,0,15,143,292,435
2016,8,29,0,16,158,636,794
2016,8,29,0,17,171,1384,1555
2016,8,29,0,18,153,1085,1238
2016,8,29,0,19,163,743,906
2016,8,29,0,20,98,469,567
2016,8,29,0,21,77,311,388
2016,8,29,0,22,63,178,241
2016,8,29,0,23,29,83,112
2016,8,30,1,0,13,37,50
2016,8,30,1,1,7,15,22
2016,8,30,1,2,4,1,5
2016,8,30,1,3,0,6,6
2016,8,30,1,4,0,20,20
2016,8,30,1,5,3,103,106
2016,8,30,1,6,17,376,393
2016,8,30,1,7,57,973,1030
2016,8,30,1,8,62,1240,1302
2016,8,30,1,9,74,509,583
2016,8,30,1,10,107,251,358
2016,8,30,1,11,136,273,409
2016,8,30,1,12,129,324,453
2016,8,30,1,13,134,311,445
2016,8,30,1,14,151,269,420
2016,8,30,1,15,112,355,467
2016,8,30,1,16,147,683,830
2016,8,30,1,17,190,1402,1592
2016,8,30,1,18,177,1202,1379
2016,8,30,1,19,156,813,969
2016,8,30,1,20,101,512,613
2016,8,30,1,21,77,348,425
2016,8,30,1,22,40,190,230
2016,8,30,1,23,20,87,107
2016,8,31,2,0,8,39,47
2016,8,31,2,1,4,16,20
2016,8,31,2,2,3,6,9
2016,8,31,2,3,1,5,6
2016,8,31,2,4,3,19,22
2016,8,31,2,5,9,113,122
2016,8,31,2,6,19,390,409
2016,8,31,2,7,53,984,1037
2016,8,31,2,8,54,1196,1250
2016,8,31,2,9,73,449,522
2016,8,31,2,10,85,237,322
2016,8,31,2,11,94,258,352
2016,8,31,2,12,110,348,458
2016,8,31,2,13,99,341,440
2016,8,31,2,14,93,273,366
2016,8,31,2,15,103,350,453
2016,8,31,2,16,128,621,749
2016,8,31,2,17,161,1401,1562
2016,8,31,2,18,132,1153,1285
2016,8,31,2,19,105,725,830
2016,8,31,2,20,79,527,606
2016,8,31,2,21,63,319,382
2016,8,31,2,22,54,188,242
2016,8,31,2,23,19,99,118
2016,9,1,3,0,13,38,51
2016,9,1,3,1,4,5,9
2016,9,1,3,2,1,5,6
2016,9,1,3,3,1,6,7
2016,9,1,3,4,2,10,12
2016,9,1,3,5,2,95,97
2016,9,1,3,6,24,371,395
2016,9,1,3,7,25,505,530
2016,9,1,3,8,40,962,1002
2016,9,1,3,9,55,312,367
2016,9,1,3,10,46,223,269
2016,9,1,3,11,90,241,331
2016,9,1,3,12,65,316,381
2016,9,1,3,13,117,309,426
2016,9,1,3,14,127,331,458
2016,9,1,3,15,190,406,596
2016,9,1,3,16,170,696,866
2016,9,1,3,17,193,1326,1519
2016,9,1,3,18,154,994,1148
2016,9,1,3,19,86,404,490
2016,9,1,3,20,39,377,416
2016,9,1,3,21,46,247,293
2016,9,1,3,22,32,166,198
2016,9,1,3,23,21,102,123
2016,9,2,4,0,38,149,187
2016,9,2,4,1,15,40,55
2016,9,2,4,2,3,26,29
2016,9,2,4,3,2,7,9
2016,9,2,4,4,2,13,15
2016,9,2,4,5,7,80,87
2016,9,2,4,6,16,217,233
2016,9,2,4,7,43,705,748
2016,9,2,4,8,77,1060,1137
2016,9,2,4,9,104,524,628
2016,9,2,4,10,165,242,407
2016,9,2,4,11,220,342,562
2016,9,2,4,12,199,474,673
2016,9,2,4,13,268,501,769
2016,9,2,4,14,245,571,816
2016,9,2,4,15,270,724,994
2016,9,2,4,16,276,757,1033
2016,9,2,4,17,326,929,1255
2016,9,2,4,18,243,728,971
2016,9,2,4,19,192,492,684
2016,9,2,4,20,166,375,541
2016,9,2,4,21,138,251,389
2016,9,2,4,22,91,187,278
2016,9,2,4,23,67,142,209
2016,9,3,5,0,34,88,122
2016,9,3,5,1,22,56,78
2016,9,3,5,2,29,45,74
2016,9,3,5,3,11,25,36
2016,9,3,5,4,3,15,18
2016,9,3,5,5,5,17,22
2016,9,3,5,6,14,39,53
2016,9,3,5,7,27,97,124
2016,9,3,5,8,37,205,242
2016,9,3,5,9,141,310,451
2016,9,3,5,10,219,367,586
2016,9,3,5,11,314,444,758
2016,9,3,5,12,450,461,911
2016,9,3,5,13,480,459,939
2016,9,3,5,14,576,386,962
2016,9,3,5,15,569,364,933
2016,9,3,5,16,543,395,938
2016,9,3,5,17,540,404,944
2016,9,3,5,18,425,369,794
2016,9,3,5,19,339,375,714
2016,9,3,5,20,265,269,534
2016,9,3,5,21,163,176,339
2016,9,3,5,22,128,141,269
2016,9,3,5,23,67,111,178
2016,9,4,6,0,67,64,131
2016,9,4,6,1,43,66,109
2016,9,4,6,2,31,32,63
2016,9,4,6,3,23,16,39
2016,9,4,6,4,6,13,19
2016,9,4,6,5,5,13,18
2016,9,4,6,6,10,28,38
2016,9,4,6,7,25,72,97
2016,9,4,6,8,73,138,211
2016,9,4,6,9,200,251,451
2016,9,4,6,10,373,332,705
2016,9,4,6,11,541,400,941
2016,9,4,6,12,641,454,1095
2016,9,4,6,13,685,435,1120
2016,9,4,6,14,762,419,1181
2016,9,4,6,15,678,416,1094
2016,9,4,6,16,712,419,1131
2016,9,4,6,17,689,406,1095
2016,9,4,6,18,575,369,944
2016,9,4,6,19,401,429,830
2016,9,4,6,20,259,244,503
2016,9,4,6,21,225,218,443
2016,9,4,6,22,164,132,296
2016,9,4,6,23,107,123,230
2016,9,5,0,0,99,70,169
2016,9,5,0,1,27,49,76
2016,9,5,0,2,25,32,57
2016,9,5,0,3,9,7,16
2016,9,5,0,4,0,6,6
2016,9,5,0,5,9,23,32
2016,9,5,0,6,15,28,43
2016,9,5,0,7,26,93,119
2016,9,5,0,8,104,166,270
2016,9,5,0,9,216,272,488
2016,9,5,0,10,355,375,730
2016,9,5,0,11,467,497,964
2016,9,5,0,12,471,551,1022
2016,9,5,0,13,501,549,1050
2016,9,5,0,14,490,577,1067
2016,9,5,0,15,390,518,908
2016,9,5,0,16,377,492,869
2016,9,5,0,17,381,473,854
2016,9,5,0,18,342,487,829
2016,9,5,0,19,262,405,667
2016,9,5,0,20,164,261,425
2016,9,5,0,21,102,172,274
2016,9,5,0,22,71,108,179
2016,9,5,0,23,38,59,97
2016,9,6,1,0,13,30,43
2016,9,6,1,1,9,11,20
2016,9,6,1,2,0,7,7
2016,9,6,1,3,2,3,5
2016,9,6,1,4,8,18,26
2016,9,6,1,5,9,110,119
2016,9,6,1,6,11,349,360
2016,9,6,1,7,46,886,932
2016,9,6,1,8,48,1022,1070
2016,9,6,1,9,62,413,475
2016,9,6,1,10,135,202,337
2016,9,6,1,11,136,218,354
2016,9,6,1,12,154,299,453
2016,9,6,1,13,187,327,514
2016,9,6,1,14,152,263,415
2016,9,6,1,15,151,358,509
2016,9,6,1,16,169,659,828
2016,9,6,1,17,208,1433,1641
2016,9,6,1,18,201,1215,1416
2016,9,6,1,19,164,770,934
2016,9,6,1,20,95,459,554
2016,9,6,1,21,67,315,382
2016,9,6,1,22,38,201,239
2016,9,6,1,23,20,96,116
2016,9,7,2,0,16,31,47
2016,9,7,2,1,6,18,24
2016,9,7,2,2,2,12,14
2016,9,7,2,3,1,7,8
2016,9,7,2,4,0,16,16
2016,9,7,2,5,8,132,140
2016,9,7,2,6,16,404,420
2016,9,7,2,7,47,1028,1075
2016,9,7,2,8,59,1199,1258
2016,9,7,2,9,89,478,567
2016,9,7,2,10,99,220,319
2016,9,7,2,11,136,265,401
2016,9,7,2,12,135,355,490
2016,9,7,2,13,115,325,440
2016,9,7,2,14,120,282,402
2016,9,7,2,15,113,358,471
2016,9,7,2,16,135,666,801
2016,9,7,2,17,130,938,1068
2016,9,7,2,18,140,1004,1144
2016,9,7,2,19,90,751,841
2016,9,7,2,20,54,346,400
2016,9,7,2,21,40,278,318
2016,9,7,2,22,27,218,245
2016,9,7,2,23,24,94,118
2016,9,8,3,0,10,56,66
2016,9,8,3,1,12,16,28
2016,9,8,3,2,3,9,12
2016,9,8,3,3,0,10,10
2016,9,8,3,4,1,9,10
2016,9,8,3,5,7,108,115
2016,9,8,3,6,18,382,400
2016,9,8,3,7,46,1012,1058
2016,9,8,3,8,59,1040,1099
2016,9,8,3,9,71,450,521
2016,9,8,3,10,106,220,326
2016,9,8,3,11,121,256,377
2016,9,8,3,12,110,338,448
2016,9,8,3,13,118,280,398
2016,9,8,3,14,101,223,324
2016,9,8,3,15,103,364,467
2016,9,8,3,16,116,634,750
2016,9,8,3,17,151,1253,1404
2016,9,8,3,18,147,1121,1268
2016,9,8,3,19,125,792,917
2016,9,8,3,20,94,476,570
2016,9,8,3,21,57,326,383
2016,9,8,3,22,57,250,307
2016,9,8,3,23,46,164,210
2016,9,9,4,0,17,92,109
2016,9,9,4,1,16,28,44
2016,9,9,4,2,8,12,20
2016,9,9,4,3,2,12,14
2016,9,9,4,4,0,13,13
2016,9,9,4,5,7,96,103
2016,9,9,4,6,16,299,315
2016,9,9,4,7,49,905,954
2016,9,9,4,8,94,1090,1184
2016,9,9,4,9,67,420,487
2016,9,9,4,10,111,236,347
2016,9,9,4,11,140,281,421
2016,9,9,4,12,114,334,448
2016,9,9,4,13,147,353,500
2016,9,9,4,14,150,299,449
2016,9,9,4,15,137,421,558
2016,9,9,4,16,151,691,842
2016,9,9,4,17,209,1180,1389
2016,9,9,4,18,156,936,1092
2016,9,9,4,19,120,586,706
2016,9,9,4,20,111,374,485
2016,9,9,4,21,85,296,381
2016,9,9,4,22,71,244,315
2016,9,9,4,23,48,185,233
2016,9,10,5,0,25,127,152
2016,9,10,5,1,20,97,117
2016,9,10,5,2,11,59,70
2016,9,10,5,3,5,20,25
2016,9,10,5,4,3,19,22
2016,9,10,5,5,2,18,20
2016,9,10,5,6,7,52,59
2016,9,10,5,7,24,141,165
2016,9,10,5,8,73,285,358
2016,9,10,5,9,155,433,588
2016,9,10,5,10,182,509,691
2016,9,10,5,11,257,568,825
2016,9,10,5,12,317,531,848
2016,9,10,5,13,321,502,823
2016,9,10,5,14,306,453,759
2016,9,10,5,15,297,458,755
2016,9,10,5,16,317,433,750
2016,9,10,5,17,298,447,745
2016,9,10,5,18,285,424,709
2016,9,10,5,19,190,376,566
2016,9,10,5,20,146,281,427
2016,9,10,5,21,109,249,358
2016,9,10,5,22,110,202,312
2016,9,10,5,23,68,160,228
2016,9,11,6,0,46,121,167
2016,9,11,6,1,41,64,105
2016,9,11,6,2,23,63,86
2016,9,11,6,3,22,31,53
2016,9,11,6,4,4,18,22
2016,9,11,6,5,13,32,45
2016,9,11,6,6,24,65,89
2016,9,11,6,7,42,94,136
2016,9,11,6,8,107,236,343
2016,9,11,6,9,152,372,524
2016,9,11,6,10,229,528,757
2016,9,11,6,11,330,527,857
2016,9,11,6,12,334,632,966
2016,9,11,6,13,344,565,909
2016,9,11,6,14,368,570,938
2016,9,11,6,15,351,585,936
2016,9,11,6,16,369,584,953
2016,9,11,6,17,411,566,977
2016,9,11,6,18,317,531,848
2016,9,11,6,19,260,494,754
2016,9,11,6,20,150,281,431
2016,9,11,6,21,147,193,340
2016,9,11,6,22,85,136,221
2016,9,11,6,23,44,72,116
2016,9,12,0,0,21,29,50
2016,9,12,0,1,6,20,26
2016,9,12,0,2,6,9,15
2016,9,12,0,3,1,7,8
2016,9,12,0,4,1,11,12
2016,9,12,0,5,5,104,109
2016,9,12,0,6,20,361,381
2016,9,12,0,7,63,949,1012
2016,9,12,0,8,87,997,1084
2016,9,12,0,9,91,461,552
2016,9,12,0,10,156,226,382
2016,9,12,0,11,128,253,381
2016,9,12,0,12,178,318,496
2016,9,12,0,13,155,320,475
2016,9,12,0,14,190,300,490
2016,9,12,0,15,153,407,560
2016,9,12,0,16,169,698,867
2016,9,12,0,17,214,1424,1638
2016,9,12,0,18,239,1264,1503
2016,9,12,0,19,125,763,888
2016,9,12,0,20,116,431,547
2016,9,12,0,21,76,323,399
2016,9,12,0,22,55,239,294
2016,9,12,0,23,29,109,138
2016,9,13,1,0,11,31,42
2016,9,13,1,1,5,10,15
2016,9,13,1,2,0,6,6
2016,9,13,1,3,0,3,3
2016,9,13,1,4,0,12,12
2016,9,13,1,5,3,124,127
2016,9,13,1,6,22,383,405
2016,9,13,1,7,62,1073,1135
2016,9,13,1,8,79,1172,1251
2016,9,13,1,9,84,453,537
2016,9,13,1,10,113,243,356
2016,9,13,1,11,120,244,364
2016,9,13,1,12,138,354,492
2016,9,13,1,13,141,344,485
2016,9,13,1,14,165,287,452
2016,9,13,1,15,131,418,549
2016,9,13,1,16,199,709,908
2016,9,13,1,17,262,1417,1679
2016,9,13,1,18,206,1283,1489
2016,9,13,1,19,123,791,914
2016,9,13,1,20,88,494,582
2016,9,13,1,21,81,416,497
2016,9,13,1,22,58,306,364
2016,9,13,1,23,19,119,138
2016,9,14,2,0,21,46,67
2016,9,14,2,1,5,18,23
2016,9,14,2,2,4,6,10
2016,9,14,2,3,4,5,9
2016,9,14,2,4,3,17,20
2016,9,14,2,5,8,105,113
2016,9,14,2,6,35,399,434
2016,9,14,2,7,69,1079,1148
2016,9,14,2,8,64,1184,1248
2016,9,14,2,9,80,426,506
2016,9,14,2,10,116,191,307
2016,9,14,2,11,99,266,365
2016,9,14,2,12,146,373,519
2016,9,14,2,13,96,336,432
2016,9,14,2,14,115,314,429
2016,9,14,2,15,124,418,542
2016,9,14,2,16,167,678,845
2016,9,14,2,17,177,1386,1563
2016,9,14,2,18,178,1224,1402
2016,9,14,2,19,159,858,1017
2016,9,14,2,20,92,540,632
2016,9,14,2,21,82,364,446
2016,9,14,2,22,46,251,297
2016,9,14,2,23,21,125,146
2016,9,15,3,0,12,45,57
2016,9,15,3,1,12,22,34
2016,9,15,3,2,9,5,14
2016,9,15,3,3,2,5,7
2016,9,15,3,4,1,15,16
2016,9,15,3,5,6,115,121
2016,9,15,3,6,26,359,385
2016,9,15,3,7,56,1016,1072
2016,9,15,3,8,75,1327,1402
2016,9,15,3,9,92,514,606
2016,9,15,3,10,96,272,368
2016,9,15,3,11,133,291,424
2016,9,15,3,12,121,412,533
2016,9,15,3,13,132,343,475
2016,9,15,3,14,162,344,506
2016,9,15,3,15,182,457,639
2016,9,15,3,16,248,790,1038
2016,9,15,3,17,237,1406,1643
2016,9,15,3,18,237,1237,1474
2016,9,15,3,19,135,782,917
2016,9,15,3,20,99,534,633
2016,9,15,3,21,77,378,455
2016,9,15,3,22,53,218,271
2016,9,15,3,23,29,146,175
2016,9,16,4,0,24,58,82
2016,9,16,4,1,10,28,38
2016,9,16,4,2,18,20,38
2016,9,16,4,3,10,7,17
2016,9,16,4,4,3,13,16
2016,9,16,4,5,6,100,106
2016,9,16,4,6,16,302,318
2016,9,16,4,7,47,916,963
2016,9,16,4,8,80,1177,1257
2016,9,16,4,9,68,491,559
2016,9,16,4,10,109,315,424
2016,9,16,4,11,200,344,544
2016,9,16,4,12,208,420,628
2016,9,16,4,13,227,408,635
2016,9,16,4,14,234,405,639
2016,9,16,4,15,268,494,762
2016,9,16,4,16,256,817,1073
2016,9,16,4,17,308,1365,1673
2016,9,16,4,18,241,980,1221
2016,9,16,4,19,165,622,787
2016,9,16,4,20,97,408,505
2016,9,16,4,21,85,290,375
2016,9,16,4,22,101,199,300
2016,9,16,4,23,61,184,245
2016,9,17,5,0,56,131,187
2016,9,17,5,1,47,77,124
2016,9,17,5,2,29,66,95
2016,9,17,5,3,27,28,55
2016,9,17,5,4,2,18,20
2016,9,17,5,5,4,21,25
2016,9,17,5,6,8,40,48
2016,9,17,5,7,46,143,189
2016,9,17,5,8,71,281,352
2016,9,17,5,9,184,455,639
2016,9,17,5,10,277,591,868
2016,9,17,5,11,385,656,1041
2016,9,17,5,12,452,652,1104
2016,9,17,5,13,461,639,1100
2016,9,17,5,14,437,570,1007
2016,9,17,5,15,473,570,1043
2016,9,17,5,16,500,504,1004
2016,9,17,5,17,463,525,988
2016,9,17,5,18,348,529,877
2016,9,17,5,19,235,497,732
2016,9,17,5,20,202,298,500
2016,9,17,5,21,151,244,395
2016,9,17,5,22,93,164,257
2016,9,17,5,23,89,156,245
2016,9,18,6,0,58,148,206
2016,9,18,6,1,59,94,153
2016,9,18,6,2,44,61,105
2016,9,18,6,3,10,43,53
2016,9,18,6,4,5,12,17
2016,9,18,6,5,13,28,41
2016,9,18,6,6,41,80,121
2016,9,18,6,7,32,103,135
2016,9,18,6,8,104,217,321
2016,9,18,6,9,160,362,522
2016,9,18,6,10,322,520,842
2016,9,18,6,11,379,561,940
2016,9,18,6,12,375,611,986
2016,9,18,6,13,415,590,1005
2016,9,18,6,14,409,556,965
2016,9,18,6,15,396,527,923
2016,9,18,6,16,316,499,815
2016,9,18,6,17,312,494,806
2016,9,18,6,18,316,531,847
2016,9,18,6,19,180,418,598
2016,9,18,6,20,113,267,380
2016,9,18,6,21,85,163,248
2016,9,18,6,22,72,125,197
2016,9,18,6,23,30,82,112
2016,9,19,0,0,14,34,48
2016,9,19,0,1,7,18,25
2016,9,19,0,2,7,1,8
2016,9,19,0,3,1,7,8
2016,9,19,0,4,1,13,14
2016,9,19,0,5,1,88,89
2016,9,19,0,6,8,256,264
2016,9,19,0,7,27,811,838
2016,9,19,0,8,64,1112,1176
2016,9,19,0,9,54,290,344
2016,9,19,0,10,24,58,82
2016,9,19,0,11,22,44,66
2016,9,19,0,12,13,50,63
2016,9,19,0,13,20,93,113
2016,9,19,0,14,18,76,94
2016,9,19,0,15,50,196,246
2016,9,19,0,16,99,527,626
2016,9,19,0,17,117,1190,1307
2016,9,19,0,18,117,1121,1238
2016,9,19,0,19,86,647,733
2016,9,19,0,20,78,388,466
2016,9,19,0,21,51,262,313
2016,9,19,0,22,51,150,201
2016,9,19,0,23,22,75,97
2016,9,20,1,0,6,44,50
2016,9,20,1,1,7,14,21
2016,9,20,1,2,2,6,8
2016,9,20,1,3,0,5,5
2016,9,20,1,4,0,12,12
2016,9,20,1,5,4,100,104
2016,9,20,1,6,16,376,392
2016,9,20,1,7,29,1014,1043
2016,9,20,1,8,69,1296,1365
2016,9,20,1,9,101,491,592
2016,9,20,1,10,124,247,371
2016,9,20,1,11,108,274,382
2016,9,20,1,12,165,374,539
2016,9,20,1,13,163,375,538
2016,9,20,1,14,151,300,451
2016,9,20,1,15,162,399,561
2016,9,20,1,16,140,734,874
2016,9,20,1,17,202,1445,1647
2016,9,20,1,18,182,1257,1439
2016,9,20,1,19,111,771,882
2016,9,20,1,20,72,507,579
2016,9,20,1,21,56,366,422
2016,9,20,1,22,41,214,255
2016,9,20,1,23,15,78,93
2016,9,21,2,0,8,34,42
2016,9,21,2,1,6,12,18
2016,9,21,2,2,3,5,8
2016,9,21,2,3,0,4,4
2016,9,21,2,4,2,13,15
2016,9,21,2,5,13,139,152
2016,9,21,2,6,27,377,404
2016,9,21,2,7,49,1012,1061
2016,9,21,2,8,56,1281,1337
2016,9,21,2,9,85,484,569
2016,9,21,2,10,80,262,342
2016,9,21,2,11,115,289,404
2016,9,21,2,12,132,384,516
2016,9,21,2,13,116,285,401
2016,9,21,2,14,137,338,475
2016,9,21,2,15,145,391,536
2016,9,21,2,16,142,731,873
2016,9,21,2,17,193,1406,1599
2016,9,21,2,18,189,1168,1357
2016,9,21,2,19,138,739,877
2016,9,21,2,20,106,535,641
2016,9,21,2,21,66,393,459
2016,9,21,2,22,37,215,252
2016,9,21,2,23,14,130,144
2016,9,22,3,0,7,36,43
2016,9,22,3,1,8,13,21
2016,9,22,3,2,2,14,16
2016,9,22,3,3,1,7,8
2016,9,22,3,4,0,13,13
2016,9,22,3,5,6,95,101
2016,9,22,3,6,9,367,376
2016,9,22,3,7,39,951,990
2016,9,22,3,8,78,1261,1339
2016,9,22,3,9,83,520,603
2016,9,22,3,10,101,273,374
2016,9,22,3,11,113,313,426
2016,9,22,3,12,145,379,524
2016,9,22,3,13,131,352,483
2016,9,22,3,14,154,318,472
2016,9,22,3,15,146,408,554
2016,9,22,3,16,174,741,915
2016,9,22,3,17,240,1411,1651
2016,9,22,3,18,245,1211,1456
2016,9,22,3,19,144,773,917
2016,9,22,3,20,96,473,569
2016,9,22,3,21,57,352,409
2016,9,22,3,22,35,245,280
2016,9,22,3,23,31,154,185
2016,9,23,4,0,21,59,80
2016,9,23,4,1,8,37,45
2016,9,23,4,2,6,17,23
2016,9,23,4,3,2,7,9
2016,9,23,4,4,2,18,20
2016,9,23,4,5,7,101,108
2016,9,23,4,6,20,323,343
2016,9,23,4,7,63,835,898
2016,9,23,4,8,87,1124,1211
2016,9,23,4,9,105,495,600
2016,9,23,4,10,128,272,400
2016,9,23,4,11,196,326,522
2016,9,23,4,12,170,414,584
2016,9,23,4,13,206,388,594
2016,9,23,4,14,214,373,587
2016,9,23,4,15,224,460,684
2016,9,23,4,16,249,804,1053
2016,9,23,4,17,357,1467,1824
2016,9,23,4,18,259,1087,1346
2016,9,23,4,19,159,650,809
2016,9,23,4,20,147,401,548
2016,9,23,4,21,140,283,423
2016,9,23,4,22,116,218,334
2016,9,23,4,23,101,190,291
2016,9,24,5,0,95,98,193
2016,9,24,5,1,24,79,103
2016,9,24,5,2,13,48,61
2016,9,24,5,3,6,31,37
2016,9,24,5,4,1,11,12
2016,9,24,5,5,5,17,22
2016,9,24,5,6,9,46,55
2016,9,24,5,7,37,155,192
2016,9,24,5,8,101,305,406
2016,9,24,5,9,217,485,702
2016,9,24,5,10,319,544,863
2016,9,24,5,11,346,609,955
2016,9,24,5,12,429,629,1058
2016,9,24,5,13,475,617,1092
2016,9,24,5,14,455,561,1016
2016,9,24,5,15,498,565,1063
2016,9,24,5,16,457,540,997
2016,9,24,5,17,446,564,1010
2016,9,24,5,18,411,549,960
2016,9,24,5,19,233,414,647
2016,9,24,5,20,211,314,525
2016,9,24,5,21,164,278,442
2016,9,24,5,22,139,259,398
2016,9,24,5,23,94,189,283
2016,9,25,6,0,60,146,206
2016,9,25,6,1,55,128,183
2016,9,25,6,2,33,67,100
2016,9,25,6,3,7,28,35
2016,9,25,6,4,13,9,22
2016,9,25,6,5,6,18,24
2016,9,25,6,6,13,20,33
2016,9,25,6,7,31,71,102
2016,9,25,6,8,96,179,275
2016,9,25,6,9,169,323,492
2016,9,25,6,10,289,475,764
2016,9,25,6,11,428,612,1040
2016,9,25,6,12,408,661,1069
2016,9,25,6,13,476,568,1044
2016,9,25,6,14,478,617,1095
2016,9,25,6,15,433,578,1011
2016,9,25,6,16,418,649,1067
2016,9,25,6,17,364,551,915
2016,9,25,6,18,346,512,858
2016,9,25,6,19,204,439,643
2016,9,25,6,20,136,243,379
2016,9,25,6,21,104,201,305
2016,9,25,6,22,70,113,183
2016,9,25,6,23,33,65,98
2016,9,26,0,0,20,24,44
2016,9,26,0,1,7,13,20
2016,9,26,0,2,2,11,13
2016,9,26,0,3,2,3,5
2016,9,26,0,4,5,15,20
2016,9,26,0,5,5,97,102
2016,9,26,0,6,16,358,374
2016,9,26,0,7,40,903,943
2016,9,26,0,8,68,999,1067
2016,9,26,0,9,94,450,544
2016,9,26,0,10,101,222,323
2016,9,26,0,11,126,256,382
2016,9,26,0,12,151,317,468
2016,9,26,0,13,152,308,460
2016,9,26,0,14,140,274,414
2016,9,26,0,15,169,373,542
2016,9,26,0,16,153,717,870
2016,9,26,0,17,217,1470,1687
2016,9,26,0,18,132,1085,1217
2016,9,26,0,19,104,660,764
2016,9,26,0,20,73,537,610
2016,9,26,0,21,24,114,138
2016,9,26,0,22,25,169,194
2016,9,26,0,23,18,232,250
2016,9,27,1,0,11,45,56
2016,9,27,1,1,5,16,21
2016,9,27,1,2,2,4,6
2016,9,27,1,3,0,1,1
2016,9,27,1,4,1,13,14
2016,9,27,1,5,1,54,55
2016,9,27,1,6,10,275,285
2016,9,27,1,7,34,800,834
2016,9,27,1,8,67,1243,1310
2016,9,27,1,9,51,512,563
2016,9,27,1,10,74,244,318
2016,9,27,1,11,87,284,371
2016,9,27,1,12,110,368,478
2016,9,27,1,13,124,351,475
2016,9,27,1,14,125,316,441
2016,9,27,1,15,162,422,584
2016,9,27,1,16,167,748,915
2016,9,27,1,17,227,1478,1705
2016,9,27,1,18,215,1266,1481
2016,9,27,1,19,127,808,935
2016,9,27,1,20,101,517,618
2016,9,27,1,21,82,369,451
2016,9,27,1,22,80,242,322
2016,9,27,1,23,20,92,112
2016,9,28,2,0,15,28,43
2016,9,28,2,1,6,13,19
2016,9,28,2,2,1,4,5
2016,9,28,2,3,1,4,5
2016,9,28,2,4,1,13,14
2016,9,28,2,5,5,107,112
2016,9,28,2,6,18,317,335
2016,9,28,2,7,26,679,705
2016,9,28,2,8,22,633,655
2016,9,28,2,9,45,464,509
2016,9,28,2,10,53,201,254
2016,9,28,2,11,78,178,256
2016,9,28,2,12,69,230,299
2016,9,28,2,13,59,199,258
2016,9,28,2,14,72,244,316
2016,9,28,2,15,74,285,359
2016,9,28,2,16,98,538,636
2016,9,28,2,17,90,795,885
2016,9,28,2,18,74,700,774
2016,9,28,2,19,60,494,554
2016,9,28,2,20,39,368,407
2016,9,28,2,21,24,140,164
2016,9,28,2,22,14,95,109
2016,9,28,2,23,2,48,50
2016,9,29,3,0,7,26,33
2016,9,29,3,1,8,7,15
2016,9,29,3,2,0,6,6
2016,9,29,3,3,0,1,1
2016,9,29,3,4,0,2,2
2016,9,29,3,5,0,27,27
2016,9,29,3,6,4,150,154
2016,9,29,3,7,7,214,221
2016,9,29,3,8,25,687,712
2016,9,29,3,9,32,434,466
2016,9,29,3,10,33,132,165
2016,9,29,3,11,28,157,185
2016,9,29,3,12,37,196,233
2016,9,29,3,13,38,147,185
2016,9,29,3,14,29,159,188
2016,9,29,3,15,36,199,235
2016,9,29,3,16,43,413,456
2016,9,29,3,17,58,904,962
2016,9,29,3,18,61,782,843
2016,9,29,3,19,28,310,338
2016,9,29,3,20,6,179,185
2016,9,29,3,21,6,112,118
2016,9,29,3,22,7,89,96
2016,9,29,3,23,2,58,60
2016,9,30,4,0,9,25,34
2016,9,30,4,1,0,10,10
2016,9,30,4,2,1,5,6
2016,9,30,4,3,0,6,6
2016,9,30,4,4,0,10,10
2016,9,30,4,5,8,81,89
2016,9,30,4,6,10,208,218
2016,9,30,4,7,24,617,641
2016,9,30,4,8,40,1006,1046
2016,9,30,4,9,49,482,531
2016,9,30,4,10,83,258,341
2016,9,30,4,11,65,304,369
2016,9,30,4,12,101,377,478
2016,9,30,4,13,95,372,467
2016,9,30,4,14,167,350,517
2016,9,30,4,15,118,417,535
2016,9,30,4,16,111,561,672
2016,9,30,4,17,112,802,914
2016,9,30,4,18,76,599,675
2016,9,30,4,19,22,223,245
2016,9,30,4,20,27,181,208
2016,9,30,4,21,33,155,188
2016,9,30,4,22,28,146,174
2016,9,30,4,23,37,115,152
2016,10,1,5,0,23,80,103
2016,10,1,5,1,10,53,63
2016,10,1,5,2,6,27,33
2016,10,1,5,3,3,20,23
2016,10,1,5,4,0,11,11
2016,10,1,5,5,1,14,15
2016,10,1,5,6,4,38,42
2016,10,1,5,7,11,104,115
2016,10,1,5,8,13,133,146
2016,10,1,5,9,29,145,174
2016,10,1,5,10,44,228,272
2016,10,1,5,11,124,353,477
2016,10,1,5,12,180,382,562
2016,10,1,5,13,130,286,416
2016,10,1,5,14,137,326,463
2016,10,1,5,15,201,424,625
2016,10,1,5,16,183,368,551
2016,10,1,5,17,201,431,632
2016,10,1,5,18,172,364,536
2016,10,1,5,19,98,351,449
2016,10,1,5,20,66,238,304
2016,10,1,5,21,54,194,248
2016,10,1,5,22,46,162,208
2016,10,1,5,23,46,115,161
2016,10,2,6,0,49,142,191
2016,10,2,6,1,25,77,102
2016,10,2,6,2,24,47,71
2016,10,2,6,3,13,23,36
2016,10,2,6,4,0,9,9
2016,10,2,6,5,1,4,5
2016,10,2,6,6,11,34,45
2016,10,2,6,7,25,68,93
2016,10,2,6,8,57,152,209
2016,10,2,6,9,109,297,406
2016,10,2,6,10,252,418,670
2016,10,2,6,11,302,490,792
2016,10,2,6,12,346,580,926
2016,10,2,6,13,331,560,891
2016,10,2,6,14,411,511,922
2016,10,2,6,15,417,531,948
2016,10,2,6,16,410,564,974
2016,10,2,6,17,341,556,897
2016,10,2,6,18,322,531,853
2016,10,2,6,19,192,396,588
2016,10,2,6,20,120,228,348
2016,10,2,6,21,64,145,209
2016,10,2,6,22,54,121,175
2016,10,2,6,23,34,50,84
2016,10,3,0,0,12,31,43
2016,10,3,0,1,2,14,16
2016,10,3,0,2,9,10,19
2016,10,3,0,3,0,7,7
2016,10,3,0,4,2,14,16
2016,10,3,0,5,3,89,92
2016,10,3,0,6,14,295,309
2016,10,3,0,7,43,812,855
2016,10,3,0,8,71,1080,1151
2016,10,3,0,9,95,505,600
2016,10,3,0,10,109,230,339
2016,10,3,0,11,174,270,444
2016,10,3,0,12,233,348,581
2016,10,3,0,13,206,350,556
2016,10,3,0,14,221,298,519
2016,10,3,0,15,202,405,607
2016,10,3,0,16,197,732,929
2016,10,3,0,17,261,1443,1704
2016,10,3,0,18,233,1215,1448
2016,10,3,0,19,120,749,869
2016,10,3,0,20,94,403,497
2016,10,3,0,21,44,306,350
2016,10,3,0,22,61,162,223
2016,10,3,0,23,39,88,127
2016,10,4,1,0,4,34,38
2016,10,4,1,1,5,12,17
2016,10,4,1,2,7,4,11
2016,10,4,1,3,1,5,6
2016,10,4,1,4,2,16,18
2016,10,4,1,5,5,95,100
2016,10,4,1,6,10,342,352
2016,10,4,1,7,43,976,1019
2016,10,4,1,8,82,1324,1406
2016,10,4,1,9,103,577,680
2016,10,4,1,10,147,235,382
2016,10,4,1,11,141,276,417
2016,10,4,1,12,170,390,560
2016,10,4,1,13,171,345,516
2016,10,4,1,14,209,320,529
2016,10,4,1,15,162,438,600
2016,10,4,1,16,194,748,942
2016,10,4,1,17,229,1486,1715
2016,10,4,1,18,202,1197,1399
2016,10,4,1,19,124,676,800
2016,10,4,1,20,79,484,563
2016,10,4,1,21,72,284,356
2016,10,4,1,22,46,196,242
2016,10,4,1,23,29,97,126
2016,10,5,2,0,9,35,44
2016,10,5,2,1,0,9,9
2016,10,5,2,2,3,10,13
2016,10,5,2,3,0,2,2
2016,10,5,2,4,0,16,16
2016,10,5,2,5,7,93,100
2016,10,5,2,6,18,349,367
2016,10,5,2,7,43,1035,1078
2016,10,5,2,8,71,1231,1302
2016,10,5,2,9,66,558,624
2016,10,5,2,10,106,253,359
2016,10,5,2,11,131,294,425
2016,10,5,2,12,109,384,493
2016,10,5,2,13,127,385,512
2016,10,5,2,14,136,333,469
2016,10,5,2,15,160,426,586
2016,10,5,2,16,170,809,979
2016,10,5,2,17,230,1451,1681
2016,10,5,2,18,172,1184,1356
2016,10,5,2,19,91,754,845
2016,10,5,2,20,73,477,550
2016,10,5,2,21,43,350,393
2016,10,5,2,22,55,180,235
2016,10,5,2,23,35,117,152
2016,10,6,3,0,20,29,49
2016,10,6,3,1,1,18,19
2016,10,6,3,2,2,6,8
2016,10,6,3,3,0,2,2
2016,10,6,3,4,4,10,14
2016,10,6,3,5,3,87,90
2016,10,6,3,6,6,303,309
2016,10,6,3,7,29,907,936
2016,10,6,3,8,86,1235,1321
2016,10,6,3,9,45,515,560
2016,10,6,3,10,104,252,356
2016,10,6,3,11,139,267,406
2016,10,6,3,12,149,381,530
2016,10,6,3,13,156,362,518
2016,10,6,3,14,158,304,462
2016,10,6,3,15,207,405,612
2016,10,6,3,16,212,734,946
2016,10,6,3,17,225,1346,1571
2016,10,6,3,18,221,1179,1400
2016,10,6,3,19,138,707,845
2016,10,6,3,20,112,457,569
2016,10,6,3,21,60,330,390
2016,10,6,3,22,72,227,299
2016,10,6,3,23,29,121,150
2016,10,7,4,0,19,64,83
2016,10,7,4,1,9,26,35
2016,10,7,4,2,9,8,17
2016,10,7,4,3,1,8,9
2016,10,7,4,4,2,18,20
2016,10,7,4,5,2,73,75
2016,10,7,4,6,9,255,264
2016,10,7,4,7,62,789,851
2016,10,7,4,8,96,1113,1209
2016,10,7,4,9,121,525,646
2016,10,7,4,10,131,261,392
2016,10,7,4,11,202,320,522
2016,10,7,4,12,225,443,668
2016,10,7,4,13,276,450,726
2016,10,7,4,14,296,442,738
2016,10,7,4,15,338,583,921
2016,10,7,4,16,330,894,1224
2016,10,7,4,17,334,1173,1507
2016,10,7,4,18,270,822,1092
2016,10,7,4,19,171,511,682
2016,10,7,4,20,129,338,467
2016,10,7,4,21,145,354,499
2016,10,7,4,22,119,229,348
2016,10,7,4,23,62,138,200
2016,10,8,5,0,46,125,171
2016,10,8,5,1,39,75,114
2016,10,8,5,2,25,51,76
2016,10,8,5,3,8,19,27
2016,10,8,5,4,3,14,17
2016,10,8,5,5,4,17,21
2016,10,8,5,6,9,40,49
2016,10,8,5,7,27,109,136
2016,10,8,5,8,47,230,277
2016,10,8,5,9,123,367,490
2016,10,8,5,10,121,342,463
2016,10,8,5,11,87,236,323
2016,10,8,5,12,82,152,234
2016,10,8,5,13,62,125,187
2016,10,8,5,14,32,99,131
2016,10,8,5,15,49,122,171
2016,10,8,5,16,121,192,313
2016,10,8,5,17,130,213,343
2016,10,8,5,18,107,262,369
2016,10,8,5,19,101,197,298
2016,10,8,5,20,70,186,256
2016,10,8,5,21,83,169,252
2016,10,8,5,22,57,149,206
2016,10,8,5,23,65,136,201
2016,10,9,6,0,44,85,129
2016,10,9,6,1,16,65,81
2016,10,9,6,2,21,58,79
2016,10,9,6,3,7,17,24
2016,10,9,6,4,10,5,15
2016,10,9,6,5,6,5,11
2016,10,9,6,6,4,26,30
2016,10,9,6,7,14,84,98
2016,10,9,6,8,47,152,199
2016,10,9,6,9,122,270,392
2016,10,9,6,10,200,379,579
2016,10,9,6,11,282,448,730
2016,10,9,6,12,383,607,990
2016,10,9,6,13,334,411,745
2016,10,9,6,14,450,425,875
2016,10,9,6,15,464,462,926
2016,10,9,6,16,489,521,1010
2016,10,9,6,17,439,574,1013
2016,10,9,6,18,289,467,756
2016,10,9,6,19,143,347,490
2016,10,9,6,20,113,257,370
2016,10,9,6,21,30,102,132
2016,10,9,6,22,52,126,178
2016,10,9,6,23,45,129,174
2016,10,10,0,0,14,55,69
2016,10,10,0,1,13,27,40
2016,10,10,0,2,5,16,21
2016,10,10,0,3,1,9,10
2016,10,10,0,4,1,11,12
2016,10,10,0,5,4,31,35
2016,10,10,0,6,6,117,123
2016,10,10,0,7,16,276,292
2016,10,10,0,8,46,525,571
2016,10,10,0,9,87,368,455
2016,10,10,0,10,173,298,471
2016,10,10,0,11,220,358,578
2016,10,10,0,12,310,411,721
2016,10,10,0,13,318,462,780
2016,10,10,0,14,390,501,891
2016,10,10,0,15,351,481,832
2016,10,10,0,16,350,562,912
2016,10,10,0,17,313,821,1134
2016,10,10,0,18,211,683,894
2016,10,10,0,19,152,513,665
2016,10,10,0,20,71,300,371
2016,10,10,0,21,59,208,267
2016,10,10,0,22,38,163,201
2016,10,10,0,23,18,52,70
2016,10,11,1,0,5,22,27
2016,10,11,1,1,4,11,15
2016,10,11,1,2,1,5,6
2016,10,11,1,3,3,5,8
2016,10,11,1,4,4,12,16
2016,10,11,1,5,4,78,82
2016,10,11,1,6,10,265,275
2016,10,11,1,7,25,812,837
2016,10,11,1,8,48,1060,1108
2016,10,11,1,9,61,467,528
2016,10,11,1,10,106,227,333
2016,10,11,1,11,118,275,393
2016,10,11,1,12,149,355,504
2016,10,11,1,13,117,355,472
2016,10,11,1,14,170,311,481
2016,10,11,1,15,167,392,559
2016,10,11,1,16,202,798,1000
2016,10,11,1,17,247,1533,1780
2016,10,11,1,18,177,1145,1322
2016,10,11,1,19,104,590,694
2016,10,11,1,20,53,373,426
2016,10,11,1,21,43,281,324
2016,10,11,1,22,33,218,251
2016,10,11,1,23,19,69,88
2016,10,12,2,0,2,26,28
2016,10,12,2,1,4,9,13
2016,10,12,2,2,3,3,6
2016,10,12,2,3,2,4,6
2016,10,12,2,4,0,9,9
2016,10,12,2,5,4,77,81
2016,10,12,2,6,13,313,326
2016,10,12,2,7,35,830,865
2016,10,12,2,8,85,1202,1287
2016,10,12,2,9,69,478,547
2016,10,12,2,10,112,233,345
2016,10,12,2,11,139,267,406
2016,10,12,2,12,108,340,448
2016,10,12,2,13,146,365,511
2016,10,12,2,14,160,304,464
2016,10,12,2,15,173,392,565
2016,10,12,2,16,179,726,905
2016,10,12,2,17,223,1449,1672
2016,10,12,2,18,179,1184,1363
2016,10,12,2,19,119,640,759
2016,10,12,2,20,65,427,492
2016,10,12,2,21,46,313,359
2016,10,12,2,22,36,200,236
2016,10,12,2,23,17,87,104
2016,10,13,3,0,10,40,50
2016,10,13,3,1,6,11,17
2016,10,13,3,2,4,5,9
2016,10,13,3,3,3,8,11
2016,10,13,3,4,3,9,12
2016,10,13,3,5,4,75,79
2016,10,13,3,6,10,283,293
2016,10,13,3,7,20,913,933
2016,10,13,3,8,70,1236,1306
2016,10,13,3,9,92,488,580
2016,10,13,3,10,114,230,344
2016,10,13,3,11,131,273,404
2016,10,13,3,12,154,405,559
2016,10,13,3,13,144,333,477
2016,10,13,3,14,162,315,477
2016,10,13,3,15,196,389,585
2016,10,13,3,16,219,742,961
2016,10,13,3,17,257,1416,1673
2016,10,13,3,18,216,1244,1460
2016,10,13,3,19,122,672,794
2016,10,13,3,20,69,417,486
2016,10,13,3,21,31,325,356
2016,10,13,3,22,34,207,241
2016,10,13,3,23,19,113,132
2016,10,14,4,0,32,188,220
2016,10,14,4,1,58,107,165
2016,10,14,4,2,6,20,26
2016,10,14,4,3,2,14,16
2016,10,14,4,4,8,11,19
2016,10,14,4,5,4,53,57
2016,10,14,4,6,5,229,234
2016,10,14,4,7,30,716,746
2016,10,14,4,8,59,1128,1187
2016,10,14,4,9,88,586,674
2016,10,14,4,10,158,273,431
2016,10,14,4,11,210,331,541
2016,10,14,4,12,152,392,544
2016,10,14,4,13,273,389,662
2016,10,14,4,14,321,360,681
2016,10,14,4,15,271,473,744
2016,10,14,4,16,310,805,1115
2016,10,14,4,17,312,1192,1504
2016,10,14,4,18,231,908,1139
2016,10,14,4,19,84,536,620
2016,10,14,4,20,136,299,435
2016,10,14,4,21,88,231,319
2016,10,14,4,22,72,154,226
2016,10,14,4,23,46,120,166
2016,10,15,5,0,29,120,149
2016,10,15,5,1,15,62,77
2016,10,15,5,2,13,47,60
2016,10,15,5,3,9,17,26
2016,10,15,5,4,4,6,10
2016,10,15,5,5,2,19,21
2016,10,15,5,6,3,36,39
2016,10,15,5,7,19,114,133
2016,10,15,5,8,60,237,297
2016,10,15,5,9,153,375,528
2016,10,15,5,10,254,443,697
2016,10,15,5,11,454,559,1013
2016,10,15,5,12,502,555,1057
2016,10,15,5,13,597,592,1189
2016,10,15,5,14,675,532,1207
2016,10,15,5,15,686,521,1207
2016,10,15,5,16,605,509,1114
2016,10,15,5,17,441,562,1003
2016,10,15,5,18,352,483,835
2016,10,15,5,19,169,353,522
2016,10,15,5,20,132,239,371
2016,10,15,5,21,97,175,272
2016,10,15,5,22,102,150,252
2016,10,15,5,23,69,171,240
2016,10,16,6,0,48,101,149
2016,10,16,6,1,44,72,116
2016,10,16,6,2,18,51,69
2016,10,16,6,3,7,34,41
2016,10,16,6,4,2,17,19
2016,10,16,6,5,3,9,12
2016,10,16,6,6,9,20,29
2016,10,16,6,7,28,74,102
2016,10,16,6,8,55,141,196
2016,10,16,6,9,172,265,437
2016,10,16,6,10,326,426,752
2016,10,16,6,11,423,543,966
2016,10,16,6,12,438,582,1020
2016,10,16,6,13,439,600,1039
2016,10,16,6,14,466,603,1069
2016,10,16,6,15,424,536,960
2016,10,16,6,16,471,615,1086
2016,10,16,6,17,375,578,953
2016,10,16,6,18,322,509,831
2016,10,16,6,19,175,354,529
2016,10,16,6,20,141,220,361
2016,10,16,6,21,80,182,262
2016,10,16,6,22,59,116,175
2016,10,16,6,23,22,58,80
2016,10,17,0,0,5,25,30
2016,10,17,0,1,0,16,16
2016,10,17,0,2,5,5,10
2016,10,17,0,3,1,4,5
2016,10,17,0,4,2,15,17
2016,10,17,0,5,5,82,87
2016,10,17,0,6,10,292,302
2016,10,17,0,7,36,754,790
2016,10,17,0,8,87,1036,1123
2016,10,17,0,9,115,411,526
2016,10,17,0,10,161,222,383
2016,10,17,0,11,189,264,453
2016,10,17,0,12,198,367,565
2016,10,17,0,13,212,343,555
2016,10,17,0,14,215,327,542
2016,10,17,0,15,180,377,557
2016,10,17,0,16,229,737,966
2016,10,17,0,17,231,1411,1642
2016,10,17,0,18,200,1160,1360
2016,10,17,0,19,100,623,723
2016,10,17,0,20,114,424,538
2016,10,17,0,21,93,280,373
2016,10,17,0,22,50,167,217
2016,10,17,0,23,24,101,125
2016,10,18,1,0,16,33,49
2016,10,18,1,1,6,15,21
2016,10,18,1,2,5,7,12
2016,10,18,1,3,0,6,6
2016,10,18,1,4,2,8,10
2016,10,18,1,5,5,102,107
2016,10,18,1,6,14,354,368
2016,10,18,1,7,53,990,1043
2016,10,18,1,8,83,1242,1325
2016,10,18,1,9,88,531,619
2016,10,18,1,10,111,260,371
2016,10,18,1,11,104,314,418
2016,10,18,1,12,149,400,549
2016,10,18,1,13,167,382,549
2016,10,18,1,14,166,327,493
2016,10,18,1,15,217,434,651
2016,10,18,1,16,176,715,891
2016,10,18,1,17,290,1523,1813
2016,10,18,1,18,214,1289,1503
2016,10,18,1,19,117,728,845
2016,10,18,1,20,87,479,566
2016,10,18,1,21,58,352,410
2016,10,18,1,22,35,197,232
2016,10,18,1,23,29,106,135
2016,10,19,2,0,15,35,50
2016,10,19,2,1,9,16,25
2016,10,19,2,2,1,8,9
2016,10,19,2,3,0,6,6
2016,10,19,2,4,2,9,11
2016,10,19,2,5,9,110,119
2016,10,19,2,6,17,339,356
2016,10,19,2,7,77,1004,1081
2016,10,19,2,8,92,1260,1352
2016,10,19,2,9,99,545,644
2016,10,19,2,10,101,248,349
2016,10,19,2,11,147,306,453
2016,10,19,2,12,116,421,537
2016,10,19,2,13,160,366,526
2016,10,19,2,14,152,329,481
2016,10,19,2,15,165,404,569
2016,10,19,2,16,183,741,924
2016,10,19,2,17,247,1457,1704
2016,10,19,2,18,190,1183,1373
2016,10,19,2,19,119,708,827
2016,10,19,2,20,75,566,641
2016,10,19,2,21,48,250,298
2016,10,19,2,22,54,248,302
2016,10,19,2,23,43,242,285
2016,10,20,3,0,21,49,70
2016,10,20,3,1,15,15,30
2016,10,20,3,2,1,11,12
2016,10,20,3,3,7,7,14
2016,10,20,3,4,1,10,11
2016,10,20,3,5,4,86,90
2016,10,20,3,6,10,290,300
2016,10,20,3,7,39,938,977
2016,10,20,3,8,88,1289,1377
2016,10,20,3,9,74,536,610
2016,10,20,3,10,113,263,376
2016,10,20,3,11,158,283,441
2016,10,20,3,12,203,369,572
2016,10,20,3,13,178,382,560
2016,10,20,3,14,190,333,523
2016,10,20,3,15,203,402,605
2016,10,20,3,16,189,795,984
2016,10,20,3,17,298,1433,1731
2016,10,20,3,18,221,1209,1430
2016,10,20,3,19,145,682,827
2016,10,20,3,20,94,495,589
2016,10,20,3,21,77,331,408
2016,10,20,3,22,61,246,307
2016,10,20,3,23,36,139,175
2016,10,21,4,0,23,77,100
2016,10,21,4,1,15,27,42
2016,10,21,4,2,5,16,21
2016,10,21,4,3,1,8,9
2016,10,21,4,4,1,15,16
2016,10,21,4,5,4,83,87
2016,10,21,4,6,21,273,294
2016,10,21,4,7,32,788,820
2016,10,21,4,8,80,1232,1312
2016,10,21,4,9,81,545,626
2016,10,21,4,10,155,279,434
2016,10,21,4,11,205,349,554
2016,10,21,4,12,220,450,670
2016,10,21,4,13,256,426,682
2016,10,21,4,14,48,132,180
2016,10,21,4,15,107,258,365
2016,10,21,4,16,125,656,781
2016,10,21,4,17,192,1132,1324
2016,10,21,4,18,95,808,903
2016,10,21,4,19,71,467,538
2016,10,21,4,20,44,227,271
2016,10,21,4,21,41,179,220
2016,10,21,4,22,42,143,185
2016,10,21,4,23,41,110,151
2016,10,22,5,0,21,100,121
2016,10,22,5,1,8,60,68
2016,10,22,5,2,8,26,34
2016,10,22,5,3,6,13,19
2016,10,22,5,4,0,8,8
2016,10,22,5,5,0,13,13
2016,10,22,5,6,6,28,34
2016,10,22,5,7,12,106,118
2016,10,22,5,8,36,262,298
2016,10,22,5,9,114,392,506
2016,10,22,5,10,211,454,665
2016,10,22,5,11,256,493,749
2016,10,22,5,12,294,515,809
2016,10,22,5,13,318,489,807
2016,10,22,5,14,371,502,873
2016,10,22,5,15,283,462,745
2016,10,22,5,16,291,453,744
2016,10,22,5,17,218,440,658
2016,10,22,5,18,132,380,512
2016,10,22,5,19,75,242,317
2016,10,22,5,20,58,212,270
2016,10,22,5,21,52,167,219
2016,10,22,5,22,24,121,145
2016,10,22,5,23,35,137,172
2016,10,23,6,0,20,95,115
2016,10,23,6,1,12,49,61
2016,10,23,6,2,9,44,53
2016,10,23,6,3,7,23,30
2016,10,23,6,4,5,7,12
2016,10,23,6,5,2,3,5
2016,10,23,6,6,3,21,24
2016,10,23,6,7,18,59,77
2016,10,23,6,8,33,149,182
2016,10,23,6,9,119,298,417
2016,10,23,6,10,204,425,629
2016,10,23,6,11,309,461,770
2016,10,23,6,12,388,541,929
2016,10,23,6,13,416,532,948
2016,10,23,6,14,404,506,910
2016,10,23,6,15,413,506,919
2016,10,23,6,16,363,529,892
2016,10,23,6,17,368,493,861
2016,10,23,6,18,219,475,694
2016,10,23,6,19,107,268,375
2016,10,23,6,20,65,216,281
2016,10,23,6,21,67,141,208
2016,10,23,6,22,52,83,135
2016,10,23,6,23,22,56,78
2016,10,24,0,0,13,21,34
2016,10,24,0,1,11,8,19
2016,10,24,0,2,2,11,13
2016,10,24,0,3,0,3,3
2016,10,24,0,4,0,10,10
2016,10,24,0,5,3,84,87
2016,10,24,0,6,11,278,289
2016,10,24,0,7,34,783,817
2016,10,24,0,8,46,976,1022
2016,10,24,0,9,61,462,523
2016,10,24,0,10,103,263,366
2016,10,24,0,11,140,276,416
2016,10,24,0,12,130,332,462
2016,10,24,0,13,170,321,491
2016,10,24,0,14,149,308,457
2016,10,24,0,15,186,383,569
2016,10,24,0,16,165,717,882
2016,10,24,0,17,195,1399,1594
2016,10,24,0,18,109,1096,1205
2016,10,24,0,19,78,592,670
2016,10,24,0,20,47,349,396
2016,10,24,0,21,33,208,241
2016,10,24,0,22,23,133,156
2016,10,24,0,23,15,63,78
2016,10,25,1,0,8,18,26
2016,10,25,1,1,1,1,2
2016,10,25,1,2,1,7,8
2016,10,25,1,3,1,4,5
2016,10,25,1,4,0,11,11
2016,10,25,1,5,3,93,96
2016,10,25,1,6,11,316,327
2016,10,25,1,7,25,867,892
2016,10,25,1,8,65,1231,1296
2016,10,25,1,9,47,482,529
2016,10,25,1,10,100,241,341
2016,10,25,1,11,127,249,376
2016,10,25,1,12,126,379,505
2016,10,25,1,13,115,336,451
2016,10,25,1,14,133,312,445
2016,10,25,1,15,144,373,517
2016,10,25,1,16,115,691,806
2016,10,25,1,17,173,1392,1565
2016,10,25,1,18,127,1061,1188
2016,10,25,1,19,71,631,702
2016,10,25,1,20,39,395,434
2016,10,25,1,21,44,314,358
2016,10,25,1,22,23,172,195
2016,10,25,1,23,20,86,106
2016,10,26,2,0,17,47,64
2016,10,26,2,1,4,12,16
2016,10,26,2,2,0,5,5
2016,10,26,2,3,1,4,5
2016,10,26,2,4,1,11,12
2016,10,26,2,5,2,89,91
2016,10,26,2,6,11,280,291
2016,10,26,2,7,24,801,825
2016,10,26,2,8,48,1155,1203
2016,10,26,2,9,47,494,541
2016,10,26,2,10,79,250,329
2016,10,26,2,11,83,278,361
2016,10,26,2,12,99,347,446
2016,10,26,2,13,119,384,503
2016,10,26,2,14,107,314,421
2016,10,26,2,15,108,398,506
2016,10,26,2,16,126,694,820
2016,10,26,2,17,169,1318,1487
2016,10,26,2,18,118,1020,1138
2016,10,26,2,19,64,618,682
2016,10,26,2,20,29,356,385
2016,10,26,2,21,32,242,274
2016,10,26,2,22,27,163,190
2016,10,26,2,23,20,82,102
2016,10,27,3,0,1,28,29
2016,10,27,3,1,8,15,23
2016,10,27,3,2,2,6,8
2016,10,27,3,3,3,7,10
2016,10,27,3,4,3,12,15
2016,10,27,3,5,1,82,83
2016,10,27,3,6,8,274,282
2016,10,27,3,7,17,796,813
2016,10,27,3,8,40,1236,1276
2016,10,27,3,9,58,520,578
2016,10,27,3,10,82,260,342
2016,10,27,3,11,85,264,349
2016,10,27,3,12,29,278,307
2016,10,27,3,13,48,159,207
2016,10,27,3,14,26,142,168
2016,10,27,3,15,47,237,284
2016,10,27,3,16,65,544,609
2016,10,27,3,17,102,1099,1201
2016,10,27,3,18,70,926,996
2016,10,27,3,19,51,557,608
2016,10,27,3,20,40,353,393
2016,10,27,3,21,40,322,362
2016,10,27,3,22,24,181,205
2016,10,27,3,23,10,122,132
2016,10,28,4,0,6,44,50
2016,10,28,4,1,9,17,26
2016,10,28,4,2,5,8,13
2016,10,28,4,3,4,11,15
2016,10,28,4,4,1,10,11
2016,10,28,4,5,3,63,66
2016,10,28,4,6,10,216,226
2016,10,28,4,7,36,671,707
2016,10,28,4,8,62,1077,1139
2016,10,28,4,9,58,500,558
2016,10,28,4,10,84,280,364
2016,10,28,4,11,101,336,437
2016,10,28,4,12,141,399,540
2016,10,28,4,13,126,425,551
2016,10,28,4,14,164,384,548
2016,10,28,4,15,172,483,655
2016,10,28,4,16,211,808,1019
2016,10,28,4,17,216,1145,1361
2016,10,28,4,18,97,810,907
2016,10,28,4,19,48,473,521
2016,10,28,4,20,52,294,346
2016,10,28,4,21,39,189,228
2016,10,28,4,22,50,154,204
2016,10,28,4,23,25,110,135
2016,10,29,5,0,20,82,102
2016,10,29,5,1,18,67,85
2016,10,29,5,2,19,47,66
2016,10,29,5,3,3,26,29
2016,10,29,5,4,3,9,12
2016,10,29,5,5,3,18,21
2016,10,29,5,6,6,29,35
2016,10,29,5,7,24,84,108
2016,10,29,5,8,48,197,245
2016,10,29,5,9,109,332,441
2016,10,29,5,10,174,463,637
2016,10,29,5,11,336,538,874
2016,10,29,5,12,408,653,1061
2016,10,29,5,13,550,568,1118
2016,10,29,5,14,563,557,1120
2016,10,29,5,15,563,634,1197
2016,10,29,5,16,517,583,1100
2016,10,29,5,17,437,540,977
2016,10,29,5,18,262,504,766
2016,10,29,5,19,173,326,499
2016,10,29,5,20,129,227,356
2016,10,29,5,21,115,209,324
2016,10,29,5,22,87,171,258
2016,10,29,5,23,56,128,184
2016,10,30,6,0,36,122,158
2016,10,30,6,1,41,109,150
2016,10,30,6,2,32,109,141
2016,10,30,6,3,19,57,76
2016,10,30,6,4,6,24,30
2016,10,30,6,5,13,23,36
2016,10,30,6,6,27,50,77
2016,10,30,6,7,61,90,151
2016,10,30,6,8,153,197,350
2016,10,30,6,9,305,319,624
2016,10,30,6,10,358,454,812
2016,10,30,6,11,443,509,952
2016,10,30,6,12,324,572,896
2016,10,30,6,13,440,559,999
2016,10,30,6,14,504,576,1080
2016,10,30,6,15,502,546,1048
2016,10,30,6,16,488,561,1049
2016,10,30,6,17,447,578,1025
2016,10,30,6,18,135,332,467
2016,10,30,6,19,57,174,231
2016,10,30,6,20,55,130,185
2016,10,30,6,21,28,115,143
2016,10,30,6,22,32,94,126
2016,10,30,6,23,30,66,96
2016,10,31,0,0,18,34,52
2016,10,31,0,1,6,11,17
2016,10,31,0,2,1,3,4
2016,10,31,0,3,1,5,6
2016,10,31,0,4,0,16,16
2016,10,31,0,5,3,78,81
2016,10,31,0,6,16,261,277
2016,10,31,0,7,36,781,817
2016,10,31,0,8,58,945,1003
2016,10,31,0,9,93,488,581
2016,10,31,0,10,121,232,353
2016,10,31,0,11,138,283,421
2016,10,31,0,12,181,363,544
2016,10,31,0,13,155,332,487
2016,10,31,0,14,217,317,534
2016,10,31,0,15,193,459,652
2016,10,31,0,16,190,796,986
2016,10,31,0,17,165,1361,1526
2016,10,31,0,18,102,930,1032
2016,10,31,0,19,66,468,534
2016,10,31,0,20,42,282,324
2016,10,31,0,21,33,200,233
2016,10,31,0,22,31,128,159
2016,10,31,0,23,20,67,87
2016,11,1,1,0,18,20,38
2016,11,1,1,1,9,7,16
2016,11,1,1,2,0,5,5
2016,11,1,1,3,6,6,12
2016,11,1,1,4,2,7,9
2016,11,1,1,5,2,89,91
2016,11,1,1,6,13,309,322
2016,11,1,1,7,44,906,950
2016,11,1,1,8,62,1282,1344
2016,11,1,1,9,74,548,622
2016,11,1,1,10,81,251,332
2016,11,1,1,11,114,282,396
2016,11,1,1,12,102,385,487
2016,11,1,1,13,102,334,436
2016,11,1,1,14,111,279,390
2016,11,1,1,15,134,384,518
2016,11,1,1,16,126,701,827
2016,11,1,1,17,164,1445,1609
2016,11,1,1,18,101,1065,1166
2016,11,1,1,19,61,622,683
2016,11,1,1,20,67,399,466
2016,11,1,1,21,41,275,316
2016,11,1,1,22,30,179,209
2016,11,1,1,23,24,101,125
2016,11,2,2,0,16,43,59
2016,11,2,2,1,3,6,9
2016,11,2,2,2,1,2,3
2016,11,2,2,3,0,3,3
2016,11,2,2,4,1,9,10
2016,11,2,2,5,4,100,104
2016,11,2,2,6,16,332,348
2016,11,2,2,7,38,953,991
2016,11,2,2,8,61,1241,1302
2016,11,2,2,9,54,521,575
2016,11,2,2,10,87,221,308
2016,11,2,2,11,143,321,464
2016,11,2,2,12,122,395,517
2016,11,2,2,13,111,383,494
2016,11,2,2,14,113,348,461
2016,11,2,2,15,144,454,598
2016,11,2,2,16,127,813,940
2016,11,2,2,17,199,1488,1687
2016,11,2,2,18,163,1154,1317
2016,11,2,2,19,79,711,790
2016,11,2,2,20,58,415,473
2016,11,2,2,21,53,297,350
2016,11,2,2,22,36,194,230
2016,11,2,2,23,0,90,90
2016,11,3,3,0,12,70,82
2016,11,3,3,1,11,57,68
2016,11,3,3,2,2,6,8
2016,11,3,3,3,2,6,8
2016,11,3,3,4,1,14,15
2016,11,3,3,5,3,74,77
2016,11,3,3,6,10,294,304
2016,11,3,3,7,38,806,844
2016,11,3,3,8,55,1330,1385
2016,11,3,3,9,56,558,614
2016,11,3,3,10,107,266,373
2016,11,3,3,11,102,305,407
2016,11,3,3,12,132,398,530
2016,11,3,3,13,85,408,493
2016,11,3,3,14,108,255,363
2016,11,3,3,15,130,383,513
2016,11,3,3,16,161,764,925
2016,11,3,3,17,226,1387,1613
2016,11,3,3,18,127,1124,1251
2016,11,3,3,19,93,660,753
2016,11,3,3,20,68,477,545
2016,11,3,3,21,61,327,388
2016,11,3,3,22,50,215,265
2016,11,3,3,23,21,113,134
2016,11,4,4,0,20,46,66
2016,11,4,4,1,11,30,41
2016,11,4,4,2,16,23,39
2016,11,4,4,3,1,7,8
2016,11,4,4,4,1,13,14
2016,11,4,4,5,6,92,98
2016,11,4,4,6,11,260,271
2016,11,4,4,7,35,738,773
2016,11,4,4,8,59,1175,1234
2016,11,4,4,9,86,539,625
2016,11,4,4,10,110,272,382
2016,11,4,4,11,155,307,462
2016,11,4,4,12,175,415,590
2016,11,4,4,13,218,402,620
2016,11,4,4,14,238,420,658
2016,11,4,4,15,199,524,723
2016,11,4,4,16,260,800,1060
2016,11,4,4,17,290,1259,1549
2016,11,4,4,18,153,888,1041
2016,11,4,4,19,111,524,635
2016,11,4,4,20,89,291,380
2016,11,4,4,21,82,235,317
2016,11,4,4,22,33,194,227
2016,11,4,4,23,39,128,167
2016,11,5,5,0,26,76,102
2016,11,5,5,1,34,54,88
2016,11,5,5,2,8,55,63
2016,11,5,5,3,11,5,16
2016,11,5,5,4,10,11,21
2016,11,5,5,5,3,16,19
2016,11,5,5,6,2,39,41
2016,11,5,5,7,12,115,127
2016,11,5,5,8,40,255,295
2016,11,5,5,9,115,344,459
2016,11,5,5,10,207,466,673
2016,11,5,5,11,295,517,812
2016,11,5,5,12,388,576,964
2016,11,5,5,13,524,582,1106
2016,11,5,5,14,525,565,1090
2016,11,5,5,15,548,559,1107
2016,11,5,5,16,523,584,1107
2016,11,5,5,17,463,537,1000
2016,11,5,5,18,252,468,720
2016,11,5,5,19,160,307,467
2016,11,5,5,20,124,188,312
2016,11,5,5,21,85,163,248
2016,11,5,5,22,98,156,254
2016,11,5,5,23,74,138,212
2016,11,6,6,0,60,85,145
2016,11,6,6,1,36,102,138
2016,11,6,6,2,6,17,23
2016,11,6,6,3,6,5,11
2016,11,6,6,4,0,9,9
2016,11,6,6,5,4,6,10
2016,11,6,6,6,15,40,55
2016,11,6,6,7,26,95,121
2016,11,6,6,8,80,220,300
2016,11,6,6,9,197,366,563
2016,11,6,6,10,284,533,817
2016,11,6,6,11,387,512,899
2016,11,6,6,12,438,609,1047
2016,11,6,6,13,409,566,975
2016,11,6,6,14,395,528,923
2016,11,6,6,15,400,539,939
2016,11,6,6,16,383,568,951
2016,11,6,6,17,179,423,602
2016,11,6,6,18,120,307,427
2016,11,6,6,19,74,224,298
2016,11,6,6,20,64,196,260
2016,11,6,6,21,48,122,170
2016,11,6,6,22,26,73,99
2016,11,6,6,23,9,49,58
2016,11,7,0,0,6,14,20
2016,11,7,0,1,3,5,8
2016,11,7,0,2,4,9,13
2016,11,7,0,3,0,10,10
2016,11,7,0,4,0,12,12
2016,11,7,0,5,3,73,76
2016,11,7,0,6,14,340,354
2016,11,7,0,7,36,891,927
2016,11,7,0,8,62,1074,1136
2016,11,7,0,9,71,476,547
2016,11,7,0,10,120,216,336
2016,11,7,0,11,115,257,372
2016,11,7,0,12,132,303,435
2016,11,7,0,13,129,336,465
2016,11,7,0,14,172,293,465
2016,11,7,0,15,142,369,511
2016,11,7,0,16,132,696,828
2016,11,7,0,17,114,1253,1367
2016,11,7,0,18,75,877,952
2016,11,7,0,19,45,499,544
2016,11,7,0,20,32,302,334
2016,11,7,0,21,22,233,255
2016,11,7,0,22,18,101,119
2016,11,7,0,23,5,64,69
2016,11,8,1,0,3,23,26
2016,11,8,1,1,4,11,15
2016,11,8,1,2,2,7,9
2016,11,8,1,3,0,4,4
2016,11,8,1,4,3,13,16
2016,11,8,1,5,4,90,94
2016,11,8,1,6,9,321,330
2016,11,8,1,7,37,875,912
2016,11,8,1,8,58,1159,1217
2016,11,8,1,9,54,574,628
2016,11,8,1,10,107,309,416
2016,11,8,1,11,132,354,486
2016,11,8,1,12,164,424,588
2016,11,8,1,13,150,424,574
2016,11,8,1,14,177,385,562
2016,11,8,1,15,233,540,773
2016,11,8,1,16,202,822,1024
2016,11,8,1,17,136,1231,1367
2016,11,8,1,18,114,965,1079
2016,11,8,1,19,69,619,688
2016,11,8,1,20,59,320,379
2016,11,8,1,21,63,205,268
2016,11,8,1,22,41,243,284
2016,11,8,1,23,43,244,287
2016,11,9,2,0,40,154,194
2016,11,9,2,1,36,99,135
2016,11,9,2,2,16,33,49
2016,11,9,2,3,14,23,37
2016,11,9,2,4,3,14,17
2016,11,9,2,5,1,46,47
2016,11,9,2,6,7,109,116
2016,11,9,2,7,8,251,259
2016,11,9,2,8,12,375,387
2016,11,9,2,9,19,423,442
2016,11,9,2,10,52,273,325
2016,11,9,2,11,82,255,337
2016,11,9,2,12,96,338,434
2016,11,9,2,13,82,308,390
2016,11,9,2,14,93,315,408
2016,11,9,2,15,79,265,344
2016,11,9,2,16,42,398,440
2016,11,9,2,17,71,899,970
2016,11,9,2,18,54,715,769
2016,11,9,2,19,39,446,485
2016,11,9,2,20,25,295,320
2016,11,9,2,21,38,242,280
2016,11,9,2,22,23,109,132
2016,11,9,2,23,14,68,82
2016,11,10,3,0,5,25,30
2016,11,10,3,1,6,8,14
2016,11,10,3,2,1,8,9
2016,11,10,3,3,0,4,4
2016,11,10,3,4,0,12,12
2016,11,10,3,5,3,64,67
2016,11,10,3,6,8,265,273
2016,11,10,3,7,30,766,796
2016,11,10,3,8,62,1123,1185
2016,11,10,3,9,52,486,538
2016,11,10,3,10,102,243,345
2016,11,10,3,11,82,248,330
2016,11,10,3,12,78,361,439
2016,11,10,3,13,108,322,430
2016,11,10,3,14,120,346,466
2016,11,10,3,15,162,450,612
2016,11,10,3,16,152,693,845
2016,11,10,3,17,102,1090,1192
2016,11,10,3,18,105,883,988
2016,11,10,3,19,64,491,555
2016,11,10,3,20,33,423,456
2016,11,10,3,21,34,262,296
2016,11,10,3,22,44,203,247
2016,11,10,3,23,24,98,122
2016,11,11,4,0,22,63,85
2016,11,11,4,1,6,39,45
2016,11,11,4,2,3,20,23
2016,11,11,4,3,3,11,14
2016,11,11,4,4,2,11,13
2016,11,11,4,5,2,39,41
2016,11,11,4,6,12,126,138
2016,11,11,4,7,30,389,419
2016,11,11,4,8,49,700,749
2016,11,11,4,9,128,474,602
2016,11,11,4,10,169,308,477
2016,11,11,4,11,224,364,588
2016,11,11,4,12,251,415,666
2016,11,11,4,13,316,383,699
2016,11,11,4,14,326,458,784
2016,11,11,4,15,294,482,776
2016,11,11,4,16,235,589,824
2016,11,11,4,17,187,747,934
2016,11,11,4,18,120,559,679
2016,11,11,4,19,71,378,449
2016,11,11,4,20,48,225,273
2016,11,11,4,21,32,205,237
2016,11,11,4,22,43,172,215
2016,11,11,4,23,22,96,118
2016,11,12,5,0,13,75,88
2016,11,12,5,1,6,41,47
2016,11,12,5,2,5,39,44
2016,11,12,5,3,5,9,14
2016,11,12,5,4,2,10,12
2016,11,12,5,5,4,14,18
2016,11,12,5,6,9,29,38
2016,11,12,5,7,22,91,113
2016,11,12,5,8,55,197,252
2016,11,12,5,9,105,261,366
2016,11,12,5,10,228,354,582
2016,11,12,5,11,296,391,687
2016,11,12,5,12,295,435,730
2016,11,12,5,13,384,449,833
2016,11,12,5,14,500,458,958
2016,11,12,5,15,401,434,835
2016,11,12,5,16,369,422,791
2016,11,12,5,17,186,380,566
2016,11,12,5,18,100,275,375
2016,11,12,5,19,76,228,304
2016,11,12,5,20,32,178,210
2016,11,12,5,21,33,149,182
2016,11,12,5,22,44,133,177
2016,11,12,5,23,22,83,105
2016,11,13,6,0,13,58,71
2016,11,13,6,1,23,48,71
2016,11,13,6,2,11,36,47
2016,11,13,6,3,6,15,21
2016,11,13,6,4,4,8,12
2016,11,13,6,5,2,3,5
2016,11,13,6,6,7,18,25
2016,11,13,6,7,30,83,113
2016,11,13,6,8,45,119,164
2016,11,13,6,9,125,240,365
2016,11,13,6,10,189,357,546
2016,11,13,6,11,277,370,647
2016,11,13,6,12,333,464,797
2016,11,13,6,13,356,522,878
2016,11,13,6,14,367,514,881
2016,11,13,6,15,446,537,983
2016,11,13,6,16,303,492,795
2016,11,13,6,17,159,417,576
2016,11,13,6,18,114,283,397
2016,11,13,6,19,68,214,282
2016,11,13,6,20,45,165,210
2016,11,13,6,21,24,117,141
2016,11,13,6,22,16,68,84
2016,11,13,6,23,7,37,44
2016,11,14,0,0,0,16,16
2016,11,14,0,1,2,6,8
2016,11,14,0,2,2,5,7
2016,11,14,0,4,3,6,9
2016,11,14,0,5,4,76,80
2016,11,14,0,6,11,247,258
2016,11,14,0,7,37,768,805
2016,11,14,0,8,59,1018,1077
2016,11,14,0,9,48,423,471
2016,11,14,0,10,101,215,316
2016,11,14,0,11,134,234,368
2016,11,14,0,12,114,294,408
2016,11,14,0,13,114,268,382
2016,11,14,0,14,110,266,376
2016,11,14,0,15,124,350,474
2016,11,14,0,16,109,611,720
2016,11,14,0,17,93,1053,1146
2016,11,14,0,18,68,837,905
2016,11,14,0,19,47,491,538
2016,11,14,0,20,34,351,385
2016,11,14,0,21,37,229,266
2016,11,14,0,22,17,117,134
2016,11,14,0,23,7,54,61
2016,11,15,1,0,4,22,26
2016,11,15,1,1,2,7,9
2016,11,15,1,2,1,2,3
2016,11,15,1,3,0,2,2
2016,11,15,1,4,0,6,6
2016,11,15,1,5,5,75,80
2016,11,15,1,6,11,308,319
2016,11,15,1,7,32,874,906
2016,11,15,1,8,54,1173,1227
2016,11,15,1,9,47,515,562
2016,11,15,1,10,51,250,301
2016,11,15,1,11,82,263,345
2016,11,15,1,12,102,362,464
2016,11,15,1,13,109,310,419
2016,11,15,1,14,95,307,402
2016,11,15,1,15,109,419,528
2016,11,15,1,16,134,751,885
2016,11,15,1,17,94,1208,1302
2016,11,15,1,18,82,922,1004
2016,11,15,1,19,65,521,586
2016,11,15,1,20,37,314,351
2016,11,15,1,21,47,317,364
2016,11,15,1,22,24,184,208
2016,11,15,1,23,14,82,96
2016,11,16,2,0,4,28,32
2016,11,16,2,1,11,6,17
2016,11,16,2,2,0,8,8
2016,11,16,2,3,0,1,1
2016,11,16,2,4,1,7,8
2016,11,16,2,5,6,89,95
2016,11,16,2,6,11,315,326
2016,11,16,2,7,35,907,942
2016,11,16,2,8,64,1173,1237
2016,11,16,2,9,78,532,610
2016,11,16,2,10,66,231,297
2016,11,16,2,11,92,278,370
2016,11,16,2,12,83,342,425
2016,11,16,2,13,91,343,434
2016,11,16,2,14,96,271,367
2016,11,16,2,15,51,271,322
2016,11,16,2,16,91,563,654
2016,11,16,2,17,87,1094,1181
2016,11,16,2,18,67,912,979
2016,11,16,2,19,65,564,629
2016,11,16,2,20,44,402,446
2016,11,16,2,21,37,283,320
2016,11,16,2,22,38,200,238
2016,11,16,2,23,18,90,108
2016,11,17,3,0,3,26,29
2016,11,17,3,1,6,5,11
2016,11,17,3,2,0,12,12
2016,11,17,3,3,0,4,4
2016,11,17,3,4,1,9,10
2016,11,17,3,5,2,75,77
2016,11,17,3,6,10,290,300
2016,11,17,3,7,28,871,899
2016,11,17,3,8,63,1134,1197
2016,11,17,3,9,55,520,575
2016,11,17,3,10,74,223,297
2016,11,17,3,11,97,295,392
2016,11,17,3,12,96,375,471
2016,11,17,3,13,71,364,435
2016,11,17,3,14,95,335,430
2016,11,17,3,15,110,445,555
2016,11,17,3,16,99,670,769
2016,11,17,3,17,137,1151,1288
2016,11,17,3,18,77,1012,1089
2016,11,17,3,19,58,522,580
2016,11,17,3,20,38,366,404
2016,11,17,3,21,36,310,346
2016,11,17,3,22,43,168,211
2016,11,17,3,23,18,96,114
2016,11,18,4,0,14,45,59
2016,11,18,4,1,8,20,28
2016,11,18,4,2,3,6,9
2016,11,18,4,3,1,4,5
2016,11,18,4,4,0,6,6
2016,11,18,4,5,2,62,64
2016,11,18,4,6,11,234,245
2016,11,18,4,7,26,763,789
2016,11,18,4,8,63,1097,1160
2016,11,18,4,9,49,455,504
2016,11,18,4,10,91,263,354
2016,11,18,4,11,110,321,431
2016,11,18,4,12,175,413,588
2016,11,18,4,13,183,415,598
2016,11,18,4,14,232,419,651
2016,11,18,4,15,231,501,732
2016,11,18,4,16,279,805,1084
2016,11,18,4,17,171,1153,1324
2016,11,18,4,18,79,826,905
2016,11,18,4,19,91,475,566
2016,11,18,4,20,66,306,372
2016,11,18,4,21,66,241,307
2016,11,18,4,22,60,202,262
2016,11,18,4,23,48,162,210
2016,11,19,5,0,51,121,172
2016,11,19,5,1,26,59,85
2016,11,19,5,2,19,44,63
2016,11,19,5,3,11,14,25
2016,11,19,5,4,3,11,14
2016,11,19,5,5,6,9,15
2016,11,19,5,6,17,34,51
2016,11,19,5,7,11,104,115
2016,11,19,5,8,73,211,284
2016,11,19,5,9,141,370,511
2016,11,19,5,10,213,474,687
2016,11,19,5,11,372,508,880
2016,11,19,5,12,475,595,1070
2016,11,19,5,13,532,615,1147
2016,11,19,5,14,605,536,1141
2016,11,19,5,15,286,400,686
2016,11,19,5,16,135,252,387
2016,11,19,5,17,13,89,102
2016,11,19,5,18,19,121,140
2016,11,19,5,19,25,141,166
2016,11,19,5,20,32,130,162
2016,11,19,5,21,21,112,133
2016,11,19,5,22,23,98,121
2016,11,19,5,23,12,78,90
2016,11,20,6,0,11,64,75
2016,11,20,6,1,11,42,53
2016,11,20,6,2,8,26,34
2016,11,20,6,3,1,12,13
2016,11,20,6,4,0,10,10
2016,11,20,6,5,3,2,5
2016,11,20,6,6,1,10,11
2016,11,20,6,7,10,45,55
2016,11,20,6,8,18,97,115
2016,11,20,6,9,59,182,241
2016,11,20,6,10,87,238,325
2016,11,20,6,11,97,275,372
2016,11,20,6,12,66,304,370
2016,11,20,6,13,84,312,396
2016,11,20,6,14,75,238,313
2016,11,20,6,15,70,274,344
2016,11,20,6,16,52,278,330
2016,11,20,6,17,24,224,248
2016,11,20,6,18,14,158,172
2016,11,20,6,19,13,123,136
2016,11,20,6,20,14,80,94
2016,11,20,6,21,5,52,57
2016,11,20,6,22,2,38,40
2016,11,20,6,23,2,15,17
2016,11,21,0,0,1,13,14
2016,11,21,0,1,1,6,7
2016,11,21,0,2,0,1,1
2016,11,21,0,3,1,0,1
2016,11,21,0,4,2,5,7
2016,11,21,0,5,2,58,60
2016,11,21,0,6,1,209,210
2016,11,21,0,7,17,574,591
2016,11,21,0,8,39,832,871
2016,11,21,0,9,18,399,417
2016,11,21,0,10,25,184,209
2016,11,21,0,11,45,201,246
2016,11,21,0,12,52,210,262
2016,11,21,0,13,49,216,265
2016,11,21,0,14,46,206,252
2016,11,21,0,15,37,299,336
2016,11,21,0,16,40,519,559
2016,11,21,0,17,51,872,923
2016,11,21,0,18,31,631,662
2016,11,21,0,19,20,355,375
2016,11,21,0,20,21,244,265
2016,11,21,0,21,14,146,160
2016,11,21,0,22,6,84,90
2016,11,21,0,23,9,34,43
2016,11,22,1,0,0,17,17
2016,11,22,1,1,1,9,10
2016,11,22,1,2,0,4,4
2016,11,22,1,3,1,2,3
2016,11,22,1,4,2,6,8
2016,11,22,1,5,1,74,75
2016,11,22,1,6,0,210,210
2016,11,22,1,7,18,626,644
2016,11,22,1,8,28,973,1001
2016,11,22,1,9,28,466,494
2016,11,22,1,10,41,238,279
2016,11,22,1,11,54,231,285
2016,11,22,1,12,64,303,367
2016,11,22,1,13,78,221,299
2016,11,22,1,14,92,259,351
2016,11,22,1,15,81,314,395
2016,11,22,1,16,79,542,621
2016,11,22,1,17,95,871,966
2016,11,22,1,18,40,644,684
2016,11,22,1,19,24,371,395
2016,11,22,1,20,19,198,217
2016,11,22,1,21,21,131,152
2016,11,22,1,22,6,98,104
2016,11,22,1,23,6,39,45
2016,11,23,2,0,1,22,23
2016,11,23,2,1,2,9,11
2016,11,23,2,2,5,6,11
2016,11,23,2,3,1,2,3
2016,11,23,2,4,4,5,9
2016,11,23,2,5,1,55,56
2016,11,23,2,6,1,159,160
2016,11,23,2,7,11,428,439
2016,11,23,2,8,39,750,789
2016,11,23,2,9,30,422,452
2016,11,23,2,10,48,213,261
2016,11,23,2,11,98,236,334
2016,11,23,2,12,123,337,460
2016,11,23,2,13,153,380,533
2016,11,23,2,14,154,462,616
2016,11,23,2,15,168,528,696
2016,11,23,2,16,105,508,613
2016,11,23,2,17,66,386,452
2016,11,23,2,18,49,285,334
2016,11,23,2,19,41,202,243
2016,11,23,2,20,42,116,158
2016,11,23,2,21,14,95,109
2016,11,23,2,22,12,76,88
2016,11,23,2,23,4,49,53
2016,11,24,3,0,7,27,34
2016,11,24,3,1,8,19,27
2016,11,24,3,2,12,18,30
2016,11,24,3,3,4,7,11
2016,11,24,3,4,0,5,5
2016,11,24,3,5,6,8,14
2016,11,24,3,6,1,21,22
2016,11,24,3,7,10,66,76
2016,11,24,3,8,11,99,110
2016,11,24,3,9,38,128,166
2016,11,24,3,10,94,156,250
2016,11,24,3,11,204,172,376
2016,11,24,3,12,156,175,331
2016,11,24,3,13,194,154,348
2016,11,24,3,14,181,135,316
2016,11,24,3,15,161,107,268
2016,11,24,3,16,158,102,260
2016,11,24,3,17,104,70,174
2016,11,24,3,18,62,47,109
2016,11,24,3,19,52,45,97
2016,11,24,3,20,34,59,93
2016,11,24,3,21,27,52,79
2016,11,24,3,22,20,43,63
2016,11,24,3,23,22,47,69
2016,11,25,4,0,16,33,49
2016,11,25,4,1,8,11,19
2016,11,25,4,2,0,3,3
2016,11,25,4,3,0,3,3
2016,11,25,4,4,0,4,4
2016,11,25,4,5,5,10,15
2016,11,25,4,6,2,43,45
2016,11,25,4,7,18,98,116
2016,11,25,4,8,37,153,190
2016,11,25,4,9,113,146,259
2016,11,25,4,10,162,163,325
2016,11,25,4,11,238,176,414
2016,11,25,4,12,294,209,503
2016,11,25,4,13,304,230,534
2016,11,25,4,14,360,228,588
2016,11,25,4,15,354,277,631
2016,11,25,4,16,328,295,623
2016,11,25,4,17,164,242,406
2016,11,25,4,18,109,182,291
2016,11,25,4,19,108,147,255
2016,11,25,4,20,106,118,224
2016,11,25,4,21,50,84,134
2016,11,25,4,22,44,72,116
2016,11,25,4,23,30,54,84
2016,11,26,5,0,47,26,73
2016,11,26,5,1,16,30,46
2016,11,26,5,2,13,19,32
2016,11,26,5,3,7,12,19
2016,11,26,5,4,1,4,5
2016,11,26,5,5,4,7,11
2016,11,26,5,6,1,16,17
2016,11,26,5,7,16,38,54
2016,11,26,5,8,55,78,133
2016,11,26,5,9,92,151,243
2016,11,26,5,10,203,214,417
2016,11,26,5,11,213,260,473
2016,11,26,5,12,226,254,480
2016,11,26,5,13,242,252,494
2016,11,26,5,14,234,262,496
2016,11,26,5,15,254,215,469
2016,11,26,5,16,169,218,387
2016,11,26,5,17,92,191,283
2016,11,26,5,18,54,164,218
2016,11,26,5,19,46,144,190
2016,11,26,5,20,39,112,151
2016,11,26,5,21,37,97,134
2016,11,26,5,22,24,71,95
2016,11,26,5,23,9,62,71
2016,11,27,6,0,12,46,58
2016,11,27,6,1,9,38,47
2016,11,27,6,2,5,25,30
2016,11,27,6,3,1,10,11
2016,11,27,6,4,2,4,6
2016,11,27,6,5,1,8,9
2016,11,27,6,6,2,13,15
2016,11,27,6,7,5,30,35
2016,11,27,6,8,26,96,122
2016,11,27,6,9,41,153,194
2016,11,27,6,10,99,236,335
2016,11,27,6,11,119,310,429
2016,11,27,6,12,126,358,484
2016,11,27,6,13,168,331,499
2016,11,27,6,14,140,330,470
2016,11,27,6,15,135,387,522
2016,11,27,6,16,129,349,478
2016,11,27,6,17,64,265,329
2016,11,27,6,18,48,197,245
2016,11,27,6,19,26,171,197
2016,11,27,6,20,15,124,139
2016,11,27,6,21,10,81,91
2016,11,27,6,22,16,58,74
2016,11,27,6,23,17,31,48
2016,11,28,0,0,10,16,26
2016,11,28,0,1,0,7,7
2016,11,28,0,2,2,4,6
2016,11,28,0,3,0,2,2
2016,11,28,0,4,0,4,4
2016,11,28,0,5,3,62,65
2016,11,28,0,6,4,233,237
2016,11,28,0,7,20,650,670
2016,11,28,0,8,40,999,1039
2016,11,28,0,9,33,431,464
2016,11,28,0,10,51,176,227
2016,11,28,0,11,33,197,230
2016,11,28,0,12,52,265,317
2016,11,28,0,13,57,290,347
2016,11,28,0,14,77,234,311
2016,11,28,0,15,57,304,361
2016,11,28,0,16,71,560,631
2016,11,28,0,17,75,987,1062
2016,11,28,0,18,26,810,836
2016,11,28,0,19,29,448,477
2016,11,28,0,20,18,300,318
2016,11,28,0,21,10,196,206
2016,11,28,0,22,13,103,116
2016,11,28,0,23,10,58,68
2016,11,29,1,0,3,19,22
2016,11,29,1,1,0,15,15
2016,11,29,1,2,0,8,8
2016,11,29,1,4,1,9,10
2016,11,29,1,5,2,45,47
2016,11,29,1,6,1,219,220
2016,11,29,1,7,15,550,565
2016,11,29,1,8,20,824,844
2016,11,29,1,9,15,418,433
2016,11,29,1,10,5,99,104
2016,11,29,1,11,16,137,153
2016,11,29,1,12,9,155,164
2016,11,29,1,13,9,111,120
2016,11,29,1,14,12,170,182
2016,11,29,1,15,16,219,235
2016,11,29,1,16,37,391,428
2016,11,29,1,17,21,791,812
2016,11,29,1,18,32,689,721
2016,11,29,1,19,22,445,467
2016,11,29,1,20,15,302,317
2016,11,29,1,21,9,223,232
2016,11,29,1,22,12,144,156
2016,11,29,1,23,15,61,76
2016,11,30,2,0,5,26,31
2016,11,30,2,1,1,8,9
2016,11,30,2,2,3,5,8
2016,11,30,2,3,1,1,2
2016,11,30,2,4,1,6,7
2016,11,30,2,5,2,89,91
2016,11,30,2,6,4,192,196
2016,11,30,2,7,7,512,519
2016,11,30,2,8,9,472,481
2016,11,30,2,9,11,144,155
2016,11,30,2,10,7,112,119
2016,11,30,2,11,14,149,163
2016,11,30,2,12,24,230,254
2016,11,30,2,13,13,228,241
2016,11,30,2,14,33,216,249
2016,11,30,2,15,36,326,362
2016,11,30,2,16,35,543,578
2016,11,30,2,17,68,979,1047
2016,11,30,2,18,14,643,657
2016,11,30,2,19,29,415,444
2016,11,30,2,20,19,284,303
2016,11,30,2,21,0,88,88
2016,11,30,2,22,6,88,94
2016,11,30,2,23,7,65,72
2016,12,1,3,0,11,33,44
2016,12,1,3,1,0,5,5
2016,12,1,3,2,0,2,2
2016,12,1,3,3,1,3,4
2016,12,1,3,4,0,3,3
2016,12,1,3,5,3,71,74
2016,12,1,3,6,4,252,256
2016,12,1,3,7,25,771,796
2016,12,1,3,8,29,1109,1138
2016,12,1,3,9,35,480,515
2016,12,1,3,10,27,237,264
2016,12,1,3,11,29,230,259
2016,12,1,3,12,41,330,371
2016,12,1,3,13,60,343,403
2016,12,1,3,14,50,285,335
2016,12,1,3,15,62,391,453
2016,12,1,3,16,54,677,731
2016,12,1,3,17,62,1091,1153
2016,12,1,3,18,63,870,933
2016,12,1,3,19,35,515,550
2016,12,1,3,20,23,299,322
2016,12,1,3,21,17,235,252
2016,12,1,3,22,14,164,178
2016,12,1,3,23,11,79,90
2016,12,2,4,0,13,34,47
2016,12,2,4,1,11,16,27
2016,12,2,4,2,6,8,14
2016,12,2,4,3,1,5,6
2016,12,2,4,4,1,13,14
2016,12,2,4,5,6,64,70
2016,12,2,4,6,4,218,222
2016,12,2,4,7,27,609,636
2016,12,2,4,8,42,1004,1046
2016,12,2,4,9,37,464,501
2016,12,2,4,10,49,230,279
2016,12,2,4,11,58,250,308
2016,12,2,4,12,77,338,415
2016,12,2,4,13,90,315,405
2016,12,2,4,14,72,326,398
2016,12,2,4,15,95,407,502
2016,12,2,4,16,77,621,698
2016,12,2,4,17,72,941,1013
2016,12,2,4,18,55,622,677
2016,12,2,4,19,46,421,467
2016,12,2,4,20,20,219,239
2016,12,2,4,21,22,150,172
2016,12,2,4,22,23,126,149
2016,12,2,4,23,17,89,106
2016,12,3,5,0,10,71,81
2016,12,3,5,1,7,55,62
2016,12,3,5,2,10,34,44
2016,12,3,5,3,3,21,24
2016,12,3,5,4,4,5,9
2016,12,3,5,5,1,10,11
2016,12,3,5,6,2,19,21
2016,12,3,5,7,9,84,93
2016,12,3,5,8,40,179,219
2016,12,3,5,9,53,305,358
2016,12,3,5,10,93,342,435
2016,12,3,5,11,118,405,523
2016,12,3,5,12,154,440,594
2016,12,3,5,13,178,389,567
2016,12,3,5,14,224,408,632
2016,12,3,5,15,159,396,555
2016,12,3,5,16,124,359,483
2016,12,3,5,17,87,292,379
2016,12,3,5,18,46,270,316
2016,12,3,5,19,28,234,262
2016,12,3,5,20,27,157,184
2016,12,3,5,21,16,121,137
2016,12,3,5,22,16,105,121
2016,12,3,5,23,14,85,99
2016,12,4,6,0,11,84,95
2016,12,4,6,1,5,58,63
2016,12,4,6,2,8,48,56
2016,12,4,6,3,9,29,38
2016,12,4,6,4,2,7,9
2016,12,4,6,5,1,9,10
2016,12,4,6,6,2,16,18
2016,12,4,6,7,7,98,105
2016,12,4,6,8,11,101,112
2016,12,4,6,9,45,218,263
2016,12,4,6,10,66,315,381
2016,12,4,6,11,103,380,483
2016,12,4,6,12,124,406,530
2016,12,4,6,13,130,387,517
2016,12,4,6,14,106,356,462
2016,12,4,6,15,128,388,516
2016,12,4,6,16,76,415,491
2016,12,4,6,17,49,302,351
2016,12,4,6,18,22,235,257
2016,12,4,6,19,13,196,209
2016,12,4,6,20,16,144,160
2016,12,4,6,21,8,72,80
2016,12,4,6,22,4,31,35
2016,12,4,6,23,2,21,23
2016,12,5,0,0,0,14,14
2016,12,5,0,1,1,2,3
2016,12,5,0,2,1,3,4
2016,12,5,0,4,2,5,7
2016,12,5,0,5,2,57,59
2016,12,5,0,6,4,231,235
2016,12,5,0,7,13,621,634
2016,12,5,0,8,27,934,961
2016,12,5,0,9,17,452,469
2016,12,5,0,10,27,211,238
2016,12,5,0,11,47,213,260
2016,12,5,0,12,69,272,341
2016,12,5,0,13,73,288,361
2016,12,5,0,14,69,212,281
2016,12,5,0,15,46,332,378
2016,12,5,0,16,75,557,632
2016,12,5,0,17,44,1073,1117
2016,12,5,0,18,48,884,932
2016,12,5,0,19,45,462,507
2016,12,5,0,20,31,303,334
2016,12,5,0,21,32,218,250
2016,12,5,0,22,24,114,138
2016,12,5,0,23,7,48,55
2016,12,6,1,0,9,24,33
2016,12,6,1,1,2,4,6
2016,12,6,1,2,0,4,4
2016,12,6,1,3,1,1,2
2016,12,6,1,4,0,10,10
2016,12,6,1,5,1,65,66
2016,12,6,1,6,6,292,298
2016,12,6,1,7,11,721,732
2016,12,6,1,8,20,857,877
2016,12,6,1,9,20,295,315
2016,12,6,1,10,2,91,93
2016,12,6,1,11,3,81,84
2016,12,6,1,12,7,90,97
2016,12,6,1,13,1,56,57
2016,12,6,1,14,4,31,35
2016,12,6,1,15,3,52,55
2016,12,6,1,16,7,91,98
2016,12,6,1,17,13,231,244
2016,12,6,1,18,7,234,241
2016,12,6,1,19,6,130,136
2016,12,6,1,20,13,150,163
2016,12,6,1,21,7,104,111
2016,12,6,1,22,6,91,97
2016,12,6,1,23,6,33,39
2016,12,7,2,0,3,19,22
2016,12,7,2,1,0,8,8
2016,12,7,2,2,2,4,6
2016,12,7,2,3,0,1,1
2016,12,7,2,4,0,8,8
2016,12,7,2,5,6,73,79
2016,12,7,2,6,5,258,263
2016,12,7,2,7,24,753,777
2016,12,7,2,8,32,989,1021
2016,12,7,2,9,26,437,463
2016,12,7,2,10,18,212,230
2016,12,7,2,11,27,221,248
2016,12,7,2,12,58,330,388
2016,12,7,2,13,43,322,365
2016,12,7,2,14,66,278,344
2016,12,7,2,15,58,356,414
2016,12,7,2,16,64,582,646
2016,12,7,2,17,66,1039,1105
2016,12,7,2,18,39,843,882
2016,12,7,2,19,38,514,552
2016,12,7,2,20,23,320,343
2016,12,7,2,21,15,220,235
2016,12,7,2,22,12,142,154
2016,12,7,2,23,13,88,101
2016,12,8,3,0,12,23,35
2016,12,8,3,1,6,14,20
2016,12,8,3,2,2,4,6
2016,12,8,3,3,0,1,1
2016,12,8,3,4,0,5,5
2016,12,8,3,5,5,59,64
2016,12,8,3,6,3,237,240
2016,12,8,3,7,20,709,729
2016,12,8,3,8,35,1094,1129
2016,12,8,3,9,27,533,560
2016,12,8,3,10,26,215,241
2016,12,8,3,11,35,239,274
2016,12,8,3,12,30,297,327
2016,12,8,3,13,41,277,318
2016,12,8,3,14,48,259,307
2016,12,8,3,15,39,330,369
2016,12,8,3,16,40,534,574
2016,12,8,3,17,51,882,933
2016,12,8,3,18,49,710,759
2016,12,8,3,19,19,423,442
2016,12,8,3,20,17,255,272
2016,12,8,3,21,20,190,210
2016,12,8,3,22,10,119,129
2016,12,8,3,23,2,47,49
2016,12,9,4,0,3,28,31
2016,12,9,4,1,3,12,15
2016,12,9,4,2,3,15,18
2016,12,9,4,3,1,1,2
2016,12,9,4,4,1,3,4
2016,12,9,4,5,2,46,48
2016,12,9,4,6,1,167,168
2016,12,9,4,7,13,461,474
2016,12,9,4,8,27,881,908
2016,12,9,4,9,26,429,455
2016,12,9,4,10,27,224,251
2016,12,9,4,11,33,240,273
2016,12,9,4,12,35,266,301
2016,12,9,4,13,42,248,290
2016,12,9,4,14,39,245,284
2016,12,9,4,15,46,323,369
2016,12,9,4,16,29,473,502
2016,12,9,4,17,38,658,696
2016,12,9,4,18,23,466,489
2016,12,9,4,19,16,272,288
2016,12,9,4,20,15,186,201
2016,12,9,4,21,8,147,155
2016,12,9,4,22,11,103,114
2016,12,9,4,23,13,70,83
2016,12,10,5,0,9,60,69
2016,12,10,5,1,6,39,45
2016,12,10,5,2,2,18,20
2016,12,10,5,3,2,9,11
2016,12,10,5,4,3,3,6
2016,12,10,5,5,2,3,5
2016,12,10,5,6,5,14,19
2016,12,10,5,7,11,63,74
2016,12,10,5,8,10,148,158
2016,12,10,5,9,29,212,241
2016,12,10,5,10,31,250,281
2016,12,10,5,11,63,279,342
2016,12,10,5,12,84,333,417
2016,12,10,5,13,101,352,453
2016,12,10,5,14,72,276,348
2016,12,10,5,15,86,318,404
2016,12,10,5,16,59,252,311
2016,12,10,5,17,53,210,263
2016,12,10,5,18,29,183,212
2016,12,10,5,19,16,134,150
2016,12,10,5,20,10,109,119
2016,12,10,5,21,9,102,111
2016,12,10,5,22,8,63,71
2016,12,10,5,23,11,61,72
2016,12,11,6,0,9,46,55
2016,12,11,6,1,7,45,52
2016,12,11,6,2,2,44,46
2016,12,11,6,3,4,10,14
2016,12,11,6,4,0,4,4
2016,12,11,6,5,1,9,10
2016,12,11,6,6,2,16,18
2016,12,11,6,7,3,36,39
2016,12,11,6,8,11,82,93
2016,12,11,6,9,24,141,165
2016,12,11,6,10,44,212,256
2016,12,11,6,11,56,263,319
2016,12,11,6,12,70,300,370
2016,12,11,6,13,65,324,389
2016,12,11,6,14,51,286,337
2016,12,11,6,15,63,295,358
2016,12,11,6,16,51,294,345
2016,12,11,6,17,35,228,263
2016,12,11,6,18,26,166,192
2016,12,11,6,19,13,173,186
2016,12,11,6,20,18,105,123
2016,12,11,6,21,14,77,91
2016,12,11,6,22,11,51,62
2016,12,11,6,23,5,23,28
2016,12,12,0,0,2,12,14
2016,12,12,0,1,0,8,8
2016,12,12,0,2,1,3,4
2016,12,12,0,3,0,3,3
2016,12,12,0,4,0,4,4
2016,12,12,0,5,2,27,29
2016,12,12,0,6,2,124,126
2016,12,12,0,7,9,426,435
2016,12,12,0,8,25,790,815
2016,12,12,0,9,14,428,442
2016,12,12,0,10,28,176,204
2016,12,12,0,11,26,169,195
2016,12,12,0,12,36,239,275
2016,12,12,0,13,47,234,281
2016,12,12,0,14,55,241,296
2016,12,12,0,15,57,308,365
2016,12,12,0,16,60,561,621
2016,12,12,0,17,60,998,1058
2016,12,12,0,18,52,742,794
2016,12,12,0,19,42,406,448
2016,12,12,0,20,25,241,266
2016,12,12,0,21,19,157,176
2016,12,12,0,22,8,102,110
2016,12,12,0,23,3,65,68
2016,12,13,1,0,7,25,32
2016,12,13,1,1,0,11,11
2016,12,13,1,2,0,6,6
2016,12,13,1,3,1,1,2
2016,12,13,1,4,0,6,6
2016,12,13,1,5,2,66,68
2016,12,13,1,6,3,234,237
2016,12,13,1,7,15,694,709
2016,12,13,1,8,25,1036,1061
2016,12,13,1,9,17,479,496
2016,12,13,1,10,16,194,210
2016,12,13,1,11,31,220,251
2016,12,13,1,12,27,258,285
2016,12,13,1,13,34,250,284
2016,12,13,1,14,45,227,272
2016,12,13,1,15,48,290,338
2016,12,13,1,16,23,535,558
2016,12,13,1,17,44,948,992
2016,12,13,1,18,37,730,767
2016,12,13,1,19,34,429,463
2016,12,13,1,20,18,270,288
2016,12,13,1,21,11,174,185
2016,12,13,1,22,25,124,149
2016,12,13,1,23,1,72,73
2016,12,14,2,0,2,19,21
2016,12,14,2,1,3,8,11
2016,12,14,2,2,1,3,4
2016,12,14,2,3,2,2,4
2016,12,14,2,4,0,10,10
2016,12,14,2,5,2,66,68
2016,12,14,2,6,8,250,258
2016,12,14,2,7,15,647,662
2016,12,14,2,8,32,934,966
2016,12,14,2,9,14,418,432
2016,12,14,2,10,9,188,197
2016,12,14,2,11,32,197,229
2016,12,14,2,12,21,270,291
2016,12,14,2,13,39,227,266
2016,12,14,2,14,45,233,278
2016,12,14,2,15,46,296,342
2016,12,14,2,16,35,504,539
2016,12,14,2,17,60,926,986
2016,12,14,2,18,39,786,825
2016,12,14,2,19,27,475,502
2016,12,14,2,20,28,276,304
2016,12,14,2,21,6,211,217
2016,12,14,2,22,16,111,127
2016,12,14,2,23,4,67,71
2016,12,15,3,0,5,35,40
2016,12,15,3,1,1,16,17
2016,12,15,3,2,2,5,7
2016,12,15,3,4,2,6,8
2016,12,15,3,5,0,58,58
2016,12,15,3,6,0,170,170
2016,12,15,3,7,7,455,462
2016,12,15,3,8,15,744,759
2016,12,15,3,9,15,310,325
2016,12,15,3,10,11,137,148
2016,12,15,3,11,4,102,106
2016,12,15,3,12,10,145,155
2016,12,15,3,13,3,134,137
2016,12,15,3,14,9,126,135
2016,12,15,3,15,7,175,182
2016,12,15,3,16,6,279,285
2016,12,15,3,17,22,499,521
2016,12,15,3,18,16,418,434
2016,12,15,3,19,2,220,222
2016,12,15,3,20,2,154,156
2016,12,15,3,21,5,121,126
2016,12,15,3,22,3,59,62
2016,12,15,3,23,1,40,41
2016,12,16,4,0,0,19,19
2016,12,16,4,1,1,9,10
2016,12,16,4,2,0,1,1
2016,12,16,4,3,0,1,1
2016,12,16,4,4,1,5,6
2016,12,16,4,5,0,36,36
2016,12,16,4,6,0,121,121
2016,12,16,4,7,7,314,321
2016,12,16,4,8,9,612,621
2016,12,16,4,9,4,334,338
2016,12,16,4,10,12,149,161
2016,12,16,4,11,6,182,188
2016,12,16,4,12,10,189,199
2016,12,16,4,13,18,180,198
2016,12,16,4,14,13,164,177
2016,12,16,4,15,12,247,259
2016,12,16,4,16,25,340,365
2016,12,16,4,17,29,460,489
2016,12,16,4,18,18,397,415
2016,12,16,4,19,11,183,194
2016,12,16,4,20,12,131,143
2016,12,16,4,21,9,102,111
2016,12,16,4,22,9,76,85
2016,12,16,4,23,4,55,59
2016,12,17,5,0,2,41,43
2016,12,17,5,1,8,36,44
2016,12,17,5,2,5,17,22
2016,12,17,5,3,1,10,11
2016,12,17,5,4,0,6,6
2016,12,17,5,5,0,3,3
2016,12,17,5,6,0,4,4
2016,12,17,5,7,1,10,11
2016,12,17,5,8,2,18,20
2016,12,17,5,9,0,27,27
2016,12,17,5,10,2,52,54
2016,12,17,5,11,2,51,53
2016,12,17,5,12,4,127,131
2016,12,17,5,13,13,107,120
2016,12,17,5,14,23,200,223
2016,12,17,5,15,40,228,268
2016,12,17,5,16,32,263,295
2016,12,17,5,17,32,225,257
2016,12,17,5,18,18,177,195
2016,12,17,5,19,15,133,148
2016,12,17,5,20,6,112,118
2016,12,17,5,21,16,96,112
2016,12,17,5,22,4,75,79
2016,12,17,5,23,7,68,75
2016,12,18,6,0,11,53,64
2016,12,18,6,1,5,51,56
2016,12,18,6,2,13,31,44
2016,12,18,6,3,3,26,29
2016,12,18,6,4,1,5,6
2016,12,18,6,5,2,7,9
2016,12,18,6,6,1,5,6
2016,12,18,6,7,7,31,38
2016,12,18,6,8,9,83,92
2016,12,18,6,9,20,111,131
2016,12,18,6,10,26,220,246
2016,12,18,6,11,42,268,310
2016,12,18,6,12,73,306,379
2016,12,18,6,13,62,275,337
2016,12,18,6,14,23,176,199
2016,12,18,6,15,25,204,229
2016,12,18,6,16,28,266,294
2016,12,18,6,17,26,189,215
2016,12,18,6,18,10,192,202
2016,12,18,6,19,12,150,162
2016,12,18,6,20,5,70,75
2016,12,18,6,21,10,92,102
2016,12,18,6,22,9,49,58
2016,12,18,6,23,2,28,30
2016,12,19,0,0,2,12,14
2016,12,19,0,1,0,7,7
2016,12,19,0,2,1,1,2
2016,12,19,0,3,0,1,1
2016,12,19,0,4,5,5,10
2016,12,19,0,5,2,49,51
2016,12,19,0,6,4,167,171
2016,12,19,0,7,8,492,500
2016,12,19,0,8,5,763,768
2016,12,19,0,9,23,395,418
2016,12,19,0,10,32,159,191
2016,12,19,0,11,40,189,229
2016,12,19,0,12,49,262,311
2016,12,19,0,13,66,221,287
2016,12,19,0,14,56,198,254
2016,12,19,0,15,66,264,330
2016,12,19,0,16,45,399,444
2016,12,19,0,17,31,753,784
2016,12,19,0,18,25,651,676
2016,12,19,0,19,8,375,383
2016,12,19,0,20,9,219,228
2016,12,19,0,21,7,132,139
2016,12,19,0,22,9,67,76
2016,12,19,0,23,1,53,54
2016,12,20,1,0,6,23,29
2016,12,20,1,1,0,16,16
2016,12,20,1,2,0,5,5
2016,12,20,1,3,1,1,2
2016,12,20,1,4,0,5,5
2016,12,20,1,5,1,73,74
2016,12,20,1,6,3,188,191
2016,12,20,1,7,3,466,469
2016,12,20,1,8,13,773,786
2016,12,20,1,9,18,382,400
2016,12,20,1,10,23,161,184
2016,12,20,1,11,43,199,242
2016,12,20,1,12,43,225,268
2016,12,20,1,13,39,212,251
2016,12,20,1,14,40,207,247
2016,12,20,1,15,29,259,288
2016,12,20,1,16,28,408,436
2016,12,20,1,17,35,699,734
2016,12,20,1,18,24,585,609
2016,12,20,1,19,11,333,344
2016,12,20,1,20,10,220,230
2016,12,20,1,21,10,157,167
2016,12,20,1,22,1,82,83
2016,12,20,1,23,3,43,46
2016,12,21,2,0,0,19,19
2016,12,21,2,1,0,3,3
2016,12,21,2,2,0,3,3
2016,12,21,2,3,0,3,3
2016,12,21,2,4,2,8,10
2016,12,21,2,5,2,61,63
2016,12,21,2,6,1,166,167
2016,12,21,2,7,6,465,471
2016,12,21,2,8,19,757,776
2016,12,21,2,9,23,433,456
2016,12,21,2,10,27,200,227
2016,12,21,2,11,39,219,258
2016,12,21,2,12,50,290,340
2016,12,21,2,13,50,268,318
2016,12,21,2,14,66,253,319
2016,12,21,2,15,66,293,359
2016,12,21,2,16,56,460,516
2016,12,21,2,17,40,757,797
2016,12,21,2,18,40,545,585
2016,12,21,2,19,25,374,399
2016,12,21,2,20,19,171,190
2016,12,21,2,21,6,135,141
2016,12,21,2,22,13,94,107
2016,12,21,2,23,10,50,60
2016,12,22,3,0,4,26,30
2016,12,22,3,1,0,11,11
2016,12,22,3,2,0,8,8
2016,12,22,3,3,0,4,4
2016,12,22,3,4,1,2,3
2016,12,22,3,5,6,39,45
2016,12,22,3,6,8,149,157
2016,12,22,3,7,6,408,414
2016,12,22,3,8,22,670,692
2016,12,22,3,9,33,415,448
2016,12,22,3,10,38,195,233
2016,12,22,3,11,62,247,309
2016,12,22,3,12,59,320,379
2016,12,22,3,13,94,346,440
2016,12,22,3,14,91,281,372
2016,12,22,3,15,69,306,375
2016,12,22,3,16,44,465,509
2016,12,22,3,17,46,576,622
2016,12,22,3,18,29,427,456
2016,12,22,3,19,15,249,264
2016,12,22,3,20,19,162,181
2016,12,22,3,21,9,109,118
2016,12,22,3,22,10,60,70
2016,12,22,3,23,5,42,47
2016,12,23,4,0,2,25,27
2016,12,23,4,1,1,17,18
2016,12,23,4,2,1,4,5
2016,12,23,4,3,3,1,4
2016,12,23,4,4,1,3,4
2016,12,23,4,5,0,35,35
2016,12,23,4,6,1,80,81
2016,12,23,4,7,4,192,196
2016,12,23,4,8,21,376,397
2016,12,23,4,9,22,255,277
2016,12,23,4,10,44,176,220
2016,12,23,4,11,47,195,242
2016,12,23,4,12,34,274,308
2016,12,23,4,13,56,315,371
2016,12,23,4,14,65,345,410
2016,12,23,4,15,56,341,397
2016,12,23,4,16,51,310,361
2016,12,23,4,17,37,240,277
2016,12,23,4,18,16,180,196
2016,12,23,4,19,21,91,112
2016,12,23,4,20,13,86,99
2016,12,23,4,21,10,72,82
2016,12,23,4,22,11,39,50
2016,12,23,4,23,6,34,40
2016,12,24,5,0,5,23,28
2016,12,24,5,1,1,20,21
2016,12,24,5,2,0,13,13
2016,12,24,5,3,0,9,9
2016,12,24,5,4,5,4,9
2016,12,24,5,5,0,1,1
2016,12,24,5,6,0,2,2
2016,12,24,5,7,0,10,10
2016,12,24,5,8,2,14,16
2016,12,24,5,9,2,26,28
2016,12,24,5,10,2,42,44
2016,12,24,5,11,3,80,83
2016,12,24,5,12,17,111,128
2016,12,24,5,13,33,125,158
2016,12,24,5,14,45,113,158
2016,12,24,5,15,45,93,138
2016,12,24,5,16,41,93,134
2016,12,24,5,17,38,79,117
2016,12,24,5,18,11,68,79
2016,12,24,5,19,13,57,70
2016,12,24,5,20,4,25,29
2016,12,24,5,21,7,31,38
2016,12,24,5,22,4,35,39
2016,12,24,5,23,3,17,20
2016,12,25,6,0,0,11,11
2016,12,25,6,1,4,8,12
2016,12,25,6,2,3,8,11
2016,12,25,6,3,0,1,1
2016,12,25,6,5,1,7,8
2016,12,25,6,6,1,9,10
2016,12,25,6,7,1,6,7
2016,12,25,6,8,6,15,21
2016,12,25,6,9,11,34,45
2016,12,25,6,10,50,58,108
2016,12,25,6,11,115,75,190
2016,12,25,6,12,160,70,230
2016,12,25,6,13,198,109,307
2016,12,25,6,14,206,87,293
2016,12,25,6,15,179,115,294
2016,12,25,6,16,152,98,250
2016,12,25,6,17,60,59,119
2016,12,25,6,18,30,41,71
2016,12,25,6,19,26,29,55
2016,12,25,6,20,11,21,32
2016,12,25,6,21,13,25,38
2016,12,25,6,22,5,18,23
2016,12,25,6,23,8,11,19
2016,12,26,0,0,11,10,21
2016,12,26,0,1,2,4,6
2016,12,26,0,2,3,4,7
2016,12,26,0,4,0,2,2
2016,12,26,0,5,1,6,7
2016,12,26,0,6,4,16,20
2016,12,26,0,7,5,29,34
2016,12,26,0,8,21,32,53
2016,12,26,0,9,40,75,115
2016,12,26,0,10,45,72,117
2016,12,26,0,11,57,117,174
2016,12,26,0,12,82,107,189
2016,12,26,0,13,97,116,213
2016,12,26,0,14,92,112,204
2016,12,26,0,15,90,170,260
2016,12,26,0,16,111,169,280
2016,12,26,0,17,42,141,183
2016,12,26,0,18,36,115,151
2016,12,26,0,19,28,87,115
2016,12,26,0,20,25,56,81
2016,12,26,0,21,16,48,64
2016,12,26,0,22,6,36,42
2016,12,26,0,23,4,19,23
2016,12,27,1,0,4,11,15
2016,12,27,1,1,4,7,11
2016,12,27,1,2,0,2,2
2016,12,27,1,4,2,1,3
2016,12,27,1,5,0,32,32
2016,12,27,1,6,2,99,101
2016,12,27,1,7,11,203,214
2016,12,27,1,8,25,328,353
2016,12,27,1,9,58,257,315
2016,12,27,1,10,79,145,224
2016,12,27,1,11,126,164,290
2016,12,27,1,12,114,237,351
2016,12,27,1,13,184,242,426
2016,12,27,1,14,239,242,481
2016,12,27,1,15,230,303,533
2016,12,27,1,16,209,389,598
2016,12,27,1,17,160,531,691
2016,12,27,1,18,71,390,461
2016,12,27,1,19,40,232,272
2016,12,27,1,20,29,150,179
2016,12,27,1,21,26,89,115
2016,12,27,1,22,25,66,91
2016,12,27,1,23,7,38,45
2016,12,28,2,0,6,16,22
2016,12,28,2,1,4,8,12
2016,12,28,2,2,2,5,7
2016,12,28,2,3,1,2,3
2016,12,28,2,4,3,5,8
2016,12,28,2,5,3,39,42
2016,12,28,2,6,2,129,131
2016,12,28,2,7,11,287,298
2016,12,28,2,8,46,468,514
2016,12,28,2,9,87,308,395
2016,12,28,2,10,167,170,337
2016,12,28,2,11,191,184,375
2016,12,28,2,12,205,266,471
2016,12,28,2,13,221,255,476
2016,12,28,2,14,195,214,409
2016,12,28,2,15,217,263,480
2016,12,28,2,16,189,414,603
2016,12,28,2,17,139,545,684
2016,12,28,2,18,69,387,456
2016,12,28,2,19,59,205,264
2016,12,28,2,20,19,119,138
2016,12,28,2,21,29,97,126
2016,12,28,2,22,31,64,95
2016,12,28,2,23,14,36,50
2016,12,29,3,0,4,13,17
2016,12,29,3,1,8,7,15
2016,12,29,3,2,0,6,6
2016,12,29,3,4,0,1,1
2016,12,29,3,5,0,13,13
2016,12,29,3,6,1,36,37
2016,12,29,3,7,7,117,124
2016,12,29,3,8,6,169,175
2016,12,29,3,9,24,153,177
2016,12,29,3,10,37,124,161
2016,12,29,3,11,52,137,189
2016,12,29,3,12,80,196,276
2016,12,29,3,13,67,191,258
2016,12,29,3,14,104,202,306
2016,12,29,3,15,124,265,389
2016,12,29,3,16,122,372,494
2016,12,29,3,17,78,516,594
2016,12,29,3,18,34,358,392
2016,12,29,3,19,24,214,238
2016,12,29,3,20,16,108,124
2016,12,29,3,21,22,99,121
2016,12,29,3,22,19,70,89
2016,12,29,3,23,13,45,58
2016,12,30,4,0,3,15,18
2016,12,30,4,1,4,16,20
2016,12,30,4,2,4,11,15
2016,12,30,4,3,0,3,3
2016,12,30,4,4,0,1,1
2016,12,30,4,5,1,23,24
2016,12,30,4,6,7,89,96
2016,12,30,4,7,15,208,223
2016,12,30,4,8,34,368,402
2016,12,30,4,9,50,257,307
2016,12,30,4,10,47,168,215
2016,12,30,4,11,90,192,282
2016,12,30,4,12,80,211,291
2016,12,30,4,13,99,268,367
2016,12,30,4,14,98,235,333
2016,12,30,4,15,90,321,411
2016,12,30,4,16,65,327,392
2016,12,30,4,17,41,286,327
2016,12,30,4,18,36,212,248
2016,12,30,4,19,21,136,157
2016,12,30,4,20,18,100,118
2016,12,30,4,21,11,72,83
2016,12,30,4,22,5,52,57
2016,12,30,4,23,13,44,57
2016,12,31,5,0,7,32,39
2016,12,31,5,1,4,26,30
2016,12,31,5,2,1,7,8
2016,12,31,5,3,3,11,14
2016,12,31,5,4,0,2,2
2016,12,31,5,5,1,2,3
2016,12,31,5,6,1,9,10
2016,12,31,5,7,2,27,29
2016,12,31,5,8,15,77,92
2016,12,31,5,9,47,103,150
2016,12,31,5,10,88,173,261
2016,12,31,5,11,98,197,295
2016,12,31,5,12,120,218,338
2016,12,31,5,13,127,194,321
2016,12,31,5,14,142,186,328
2016,12,31,5,15,105,173,278
2016,12,31,5,16,49,206,255
2016,12,31,5,17,62,150,212
2016,12,31,5,18,17,127,144
2016,12,31,5,19,19,107,126
2016,12,31,5,20,18,73,91
2016,12,31,5,21,17,59,76
2016,12,31,5,22,17,40,57
2016,12,31,5,23,17,41,58
2017,1,1,6,0,23,54,77
2017,1,1,6,1,16,64,80
2017,1,1,6,2,5,57,62
2017,1,1,6,3,3,15,18
2017,1,1,6,4,0,5,5
2017,1,1,6,5,2,3,5
2017,1,1,6,6,1,7,8
2017,1,1,6,7,4,20,24
2017,1,1,6,8,7,46,53
2017,1,1,6,9,15,93,108
2017,1,1,6,10,50,118,168
2017,1,1,6,11,85,163,248
2017,1,1,6,12,169,206,375
2017,1,1,6,13,197,223,420
2017,1,1,6,14,306,216,522
2017,1,1,6,15,271,277,548
2017,1,1,6,16,136,252,388
2017,1,1,6,17,129,172,301
2017,1,1,6,18,55,129,184
2017,1,1,6,19,32,130,162
2017,1,1,6,20,29,81,110
2017,1,1,6,21,25,66,91
2017,1,1,6,22,10,50,60
2017,1,1,6,23,10,36,46
2017,1,2,0,0,22,23,45
2017,1,2,0,1,14,8,22
2017,1,2,0,2,1,5,6
2017,1,2,0,3,0,1,1
2017,1,2,0,4,0,2,2
2017,1,2,0,5,0,10,10
2017,1,2,0,6,1,19,20
2017,1,2,0,7,2,31,33
2017,1,2,0,8,8,33,41
2017,1,2,0,9,9,41,50
2017,1,2,0,10,11,65,76
2017,1,2,0,11,15,104,119
2017,1,2,0,12,7,96,103
2017,1,2,0,13,11,83,94
2017,1,2,0,14,6,79,85
2017,1,2,0,15,9,89,98
2017,1,2,0,16,15,128,143
2017,1,2,0,17,14,157,171
2017,1,2,0,18,6,144,150
2017,1,2,0,19,8,106,114
2017,1,2,0,20,8,87,95
2017,1,2,0,21,7,70,77
2017,1,2,0,22,2,48,50
2017,1,2,0,23,5,28,33
2017,1,3,1,0,1,12,13
2017,1,3,1,1,1,4,5
2017,1,3,1,2,0,2,2
2017,1,3,1,4,0,2,2
2017,1,3,1,5,0,47,47
2017,1,3,1,6,2,87,89
2017,1,3,1,7,3,127,130
2017,1,3,1,8,5,173,178
2017,1,3,1,9,3,54,57
2017,1,3,1,10,4,33,37
2017,1,3,1,11,8,44,52
2017,1,3,1,12,11,71,82
2017,1,3,1,13,12,113,125
2017,1,3,1,14,10,119,129
2017,1,3,1,15,17,204,221
2017,1,3,1,16,30,361,391
2017,1,3,1,17,39,727,766
2017,1,3,1,18,26,611,637
2017,1,3,1,19,31,307,338
2017,1,3,1,20,9,186,195
2017,1,3,1,21,22,120,142
2017,1,3,1,22,15,82,97
2017,1,3,1,23,5,31,36
2017,1,4,2,0,5,11,16
2017,1,4,2,1,3,5,8
2017,1,4,2,2,3,3,6
2017,1,4,2,3,1,0,1
2017,1,4,2,4,0,8,8
2017,1,4,2,5,1,65,66
2017,1,4,2,6,4,230,234
2017,1,4,2,7,12,621,633
2017,1,4,2,8,25,921,946
2017,1,4,2,9,26,396,422
2017,1,4,2,10,18,95,113
2017,1,4,2,11,42,152,194
2017,1,4,2,12,49,227,276
2017,1,4,2,13,73,226,299
2017,1,4,2,14,132,209,341
2017,1,4,2,15,99,304,403
2017,1,4,2,16,102,486,588
2017,1,4,2,17,60,903,963
2017,1,4,2,18,30,708,738
2017,1,4,2,19,22,400,422
2017,1,4,2,20,17,189,206
2017,1,4,2,21,12,154,166
2017,1,4,2,22,9,80,89
2017,1,4,2,23,3,44,47
2017,1,5,3,0,3,20,23
2017,1,5,3,1,5,4,9
2017,1,5,3,2,1,1,2
2017,1,5,3,3,1,1,2
2017,1,5,3,4,0,2,2
2017,1,5,3,5,0,61,61
2017,1,5,3,6,1,207,208
2017,1,5,3,7,10,537,547
2017,1,5,3,8,17,832,849
2017,1,5,3,9,14,402,416
2017,1,5,3,10,21,153,174
2017,1,5,3,11,36,175,211
2017,1,5,3,12,32,198,230
2017,1,5,3,13,42,218,260
2017,1,5,3,14,26,196,222
2017,1,5,3,15,40,243,283
2017,1,5,3,16,48,380,428
2017,1,5,3,17,35,742,777
2017,1,5,3,18,20,591,611
2017,1,5,3,19,14,362,376
2017,1,5,3,20,12,225,237
2017,1,5,3,21,14,122,136
2017,1,5,3,22,7,99,106
2017,1,5,3,23,3,41,44
2017,1,6,4,0,3,16,19
2017,1,6,4,1,1,4,5
2017,1,6,4,2,2,5,7
2017,1,6,4,3,0,2,2
2017,1,6,4,4,0,3,3
2017,1,6,4,5,2,48,50
2017,1,6,4,6,2,148,150
2017,1,6,4,7,3,436,439
2017,1,6,4,8,13,774,787
2017,1,6,4,9,14,392,406
2017,1,6,4,10,14,145,159
2017,1,6,4,11,32,178,210
2017,1,6,4,12,38,229,267
2017,1,6,4,13,35,213,248
2017,1,6,4,14,22,202,224
2017,1,6,4,15,23,256,279
2017,1,6,4,16,22,384,406
2017,1,6,4,17,32,689,721
2017,1,6,4,18,15,485,500
2017,1,6,4,19,16,242,258
2017,1,6,4,20,4,157,161
2017,1,6,4,21,9,110,119
2017,1,6,4,22,5,87,92
2017,1,6,4,23,2,56,58
2017,1,7,5,0,0,42,42
2017,1,7,5,1,3,36,39
2017,1,7,5,2,5,16,21
2017,1,7,5,3,0,7,7
2017,1,7,5,4,0,4,4
2017,1,7,5,5,1,4,5
2017,1,7,5,6,0,9,9
2017,1,7,5,7,1,56,57
2017,1,7,5,8,6,93,99
2017,1,7,5,9,7,128,135
2017,1,7,5,10,18,179,197
2017,1,7,5,11,14,169,183
2017,1,7,5,12,12,103,115
2017,1,7,5,13,9,81,90
2017,1,7,5,14,4,94,98
2017,1,7,5,15,11,119,130
2017,1,7,5,16,12,114,126
2017,1,7,5,17,10,101,111
2017,1,7,5,18,7,99,106
2017,1,7,5,19,4,60,64
2017,1,7,5,20,2,61,63
2017,1,7,5,21,1,34,35
2017,1,7,5,22,1,36,37
2017,1,7,5,23,3,33,36
2017,1,8,6,0,1,32,33
2017,1,8,6,1,0,19,19
2017,1,8,6,2,0,12,12
2017,1,8,6,3,0,7,7
2017,1,8,6,5,0,1,1
2017,1,8,6,6,0,8,8
2017,1,8,6,7,1,21,22
2017,1,8,6,8,5,63,68
2017,1,8,6,9,7,64,71
2017,1,8,6,10,7,137,144
2017,1,8,6,11,16,127,143
2017,1,8,6,12,7,187,194
2017,1,8,6,13,27,149,176
2017,1,8,6,14,15,134,149
2017,1,8,6,15,16,177,193
2017,1,8,6,16,14,151,165
2017,1,8,6,17,6,143,149
2017,1,8,6,18,8,94,102
2017,1,8,6,19,2,81,83
2017,1,8,6,20,1,67,68
2017,1,8,6,21,3,45,48
2017,1,8,6,22,4,44,48
2017,1,8,6,23,2,15,17
2017,1,9,0,0,0,6,6
2017,1,9,0,1,0,2,2
2017,1,9,0,2,1,3,4
2017,1,9,0,4,1,3,4
2017,1,9,0,5,0,55,55
2017,1,9,0,6,0,168,168
2017,1,9,0,7,6,389,395
2017,1,9,0,8,14,594,608
2017,1,9,0,9,11,295,306
2017,1,9,0,10,6,119,125
2017,1,9,0,11,19,108,127
2017,1,9,0,12,13,164,177
2017,1,9,0,13,17,140,157
2017,1,9,0,14,19,127,146
2017,1,9,0,15,17,154,171
2017,1,9,0,16,17,304,321
2017,1,9,0,17,14,621,635
2017,1,9,0,18,9,520,529
2017,1,9,0,19,8,302,310
2017,1,9,0,20,9,163,172
2017,1,9,0,21,4,109,113
2017,1,9,0,22,4,52,56
2017,1,9,0,23,5,25,30
2017,1,10,1,0,0,21,21
2017,1,10,1,1,1,7,8
2017,1,10,1,2,0,2,2
2017,1,10,1,4,0,1,1
2017,1,10,1,5,0,51,51
2017,1,10,1,6,0,187,187
2017,1,10,1,7,15,458,473
2017,1,10,1,8,26,748,774
2017,1,10,1,9,16,349,365
2017,1,10,1,10,10,136,146
2017,1,10,1,11,12,141,153
2017,1,10,1,12,16,176,192
2017,1,10,1,13,13,203,216
2017,1,10,1,14,17,175,192
2017,1,10,1,15,15,207,222
2017,1,10,1,16,25,375,400
2017,1,10,1,17,16,696,712
2017,1,10,1,18,11,589,600
2017,1,10,1,19,10,337,347
2017,1,10,1,20,12,226,238
2017,1,10,1,21,3,146,149
2017,1,10,1,22,10,91,101
2017,1,10,1,23,16,40,56
2017,1,11,2,0,5,14,19
2017,1,11,2,1,1,4,5
2017,1,11,2,2,1,3,4
2017,1,11,2,3,0,1,1
2017,1,11,2,4,0,4,4
2017,1,11,2,5,1,52,53
2017,1,11,2,6,4,227,231
2017,1,11,2,7,14,581,595
2017,1,11,2,8,32,979,1011
2017,1,11,2,9,27,456,483
2017,1,11,2,10,38,189,227
2017,1,11,2,11,46,212,258
2017,1,11,2,12,53,276,329
2017,1,11,2,13,49,250,299
2017,1,11,2,14,70,239,309
2017,1,11,2,15,57,295,352
2017,1,11,2,16,62,470,532
2017,1,11,2,17,52,936,988
2017,1,11,2,18,29,753,782
2017,1,11,2,19,5,254,259
2017,1,11,2,20,5,167,172
2017,1,11,2,21,11,141,152
2017,1,11,2,22,16,108,124
2017,1,11,2,23,11,67,78
2017,1,12,3,0,4,26,30
2017,1,12,3,1,1,13,14
2017,1,12,3,2,2,2,4
2017,1,12,3,3,0,5,5
2017,1,12,3,4,1,8,9
2017,1,12,3,5,0,54,54
2017,1,12,3,6,7,230,237
2017,1,12,3,7,11,652,663
2017,1,12,3,8,36,1042,1078
2017,1,12,3,9,39,434,473
2017,1,12,3,10,40,194,234
2017,1,12,3,11,56,223,279
2017,1,12,3,12,66,300,366
2017,1,12,3,13,62,329,391
2017,1,12,3,14,74,288,362
2017,1,12,3,15,100,395,495
2017,1,12,3,16,85,597,682
2017,1,12,3,17,111,1059,1170
2017,1,12,3,18,78,890,968
2017,1,12,3,19,56,539,595
2017,1,12,3,20,31,358,389
2017,1,12,3,21,33,268,301
2017,1,12,3,22,28,153,181
2017,1,12,3,23,23,88,111
2017,1,13,4,0,17,43,60
2017,1,13,4,1,20,23,43
2017,1,13,4,2,3,10,13
2017,1,13,4,3,2,2,4
2017,1,13,4,4,2,8,10
2017,1,13,4,5,2,65,67
2017,1,13,4,6,1,193,194
2017,1,13,4,7,11,592,603
2017,1,13,4,8,33,1021,1054
2017,1,13,4,9,33,472,505
2017,1,13,4,10,35,208,243
2017,1,13,4,11,55,246,301
2017,1,13,4,12,62,322,384
2017,1,13,4,13,85,322,407
2017,1,13,4,14,109,323,432
2017,1,13,4,15,104,384,488
2017,1,13,4,16,107,579,686
2017,1,13,4,17,72,826,898
2017,1,13,4,18,37,598,635
2017,1,13,4,19,22,387,409
2017,1,13,4,20,30,167,197
2017,1,13,4,21,26,143,169
2017,1,13,4,22,21,117,138
2017,1,13,4,23,10,81,91
2017,1,14,5,0,6,58,64
2017,1,14,5,1,6,49,55
2017,1,14,5,2,6,31,37
2017,1,14,5,3,1,11,12
2017,1,14,5,4,1,3,4
2017,1,14,5,5,1,4,5
2017,1,14,5,6,0,21,21
2017,1,14,5,7,1,43,44
2017,1,14,5,8,0,75,75
2017,1,14,5,9,10,115,125
2017,1,14,5,10,9,135,144
2017,1,14,5,11,9,166,175
2017,1,14,5,12,14,121,135
2017,1,14,5,13,10,93,103
2017,1,14,5,14,21,124,145
2017,1,14,5,15,21,181,202
2017,1,14,5,16,11,102,113
2017,1,14,5,17,4,72,76
2017,1,14,5,18,2,61,63
2017,1,14,5,19,6,45,51
2017,1,14,5,20,6,36,42
2017,1,14,5,21,4,50,54
2017,1,14,5,22,5,52,57
2017,1,14,5,23,11,51,62
2017,1,15,6,0,2,50,52
2017,1,15,6,1,0,35,35
2017,1,15,6,2,3,19,22
2017,1,15,6,3,1,12,13
2017,1,15,6,4,0,6,6
2017,1,15,6,5,2,5,7
2017,1,15,6,6,0,15,15
2017,1,15,6,7,5,33,38
2017,1,15,6,8,15,79,94
2017,1,15,6,9,35,167,202
2017,1,15,6,10,80,271,351
2017,1,15,6,11,77,328,405
2017,1,15,6,12,143,376,519
2017,1,15,6,13,212,431,643
2017,1,15,6,14,194,383,577
2017,1,15,6,15,214,401,615
2017,1,15,6,16,185,336,521
2017,1,15,6,17,93,258,351
2017,1,15,6,18,62,198,260
2017,1,15,6,19,32,134,166
2017,1,15,6,20,26,138,164
2017,1,15,6,21,27,103,130
2017,1,15,6,22,19,76,95
2017,1,15,6,23,9,58,67
2017,1,16,0,0,10,33,43
2017,1,16,0,1,2,24,26
2017,1,16,0,2,5,4,9
2017,1,16,0,3,3,10,13
2017,1,16,0,4,2,2,4
2017,1,16,0,5,0,14,14
2017,1,16,0,6,1,39,40
2017,1,16,0,7,2,109,111
2017,1,16,0,8,14,186,200
2017,1,16,0,9,42,178,220
2017,1,16,0,10,24,219,243
2017,1,16,0,11,55,275,330
2017,1,16,0,12,49,328,377
2017,1,16,0,13,63,282,345
2017,1,16,0,14,69,321,390
2017,1,16,0,15,60,315,375
2017,1,16,0,16,57,325,382
2017,1,16,0,17,39,336,375
2017,1,16,0,18,33,308,341
2017,1,16,0,19,14,208,222
2017,1,16,0,20,7,170,177
2017,1,16,0,21,15,104,119
2017,1,16,0,22,12,91,103
2017,1,16,0,23,0,26,26
2017,1,17,1,0,0,16,16
2017,1,17,1,1,1,7,8
2017,1,17,1,2,1,6,7
2017,1,17,1,4,0,9,9
2017,1,17,1,5,3,64,67
2017,1,17,1,6,4,223,227
2017,1,17,1,7,4,548,552
2017,1,17,1,8,24,847,871
2017,1,17,1,9,7,275,282
2017,1,17,1,10,4,52,56
2017,1,17,1,11,2,137,139
2017,1,17,1,12,16,174,190
2017,1,17,1,13,4,149,153
2017,1,17,1,14,5,76,81
2017,1,17,1,15,2,113,115
2017,1,17,1,16,8,331,339
2017,1,17,1,17,20,692,712
2017,1,17,1,18,30,655,685
2017,1,17,1,19,8,412,420
2017,1,17,1,20,12,288,300
2017,1,17,1,21,12,176,188
2017,1,17,1,22,7,93,100
2017,1,17,1,23,9,48,57
2017,1,18,2,0,2,14,16
2017,1,18,2,1,0,8,8
2017,1,18,2,2,0,6,6
2017,1,18,2,3,2,4,6
2017,1,18,2,4,0,4,4
2017,1,18,2,5,0,58,58
2017,1,18,2,6,6,205,211
2017,1,18,2,7,14,547,561
2017,1,18,2,8,38,885,923
2017,1,18,2,9,10,411,421
2017,1,18,2,10,34,216,250
2017,1,18,2,11,29,238,267
2017,1,18,2,12,49,316,365
2017,1,18,2,13,48,281,329
2017,1,18,2,14,37,249,286
2017,1,18,2,15,55,295,350
2017,1,18,2,16,47,428,475
2017,1,18,2,17,65,804,869
2017,1,18,2,18,28,709,737
2017,1,18,2,19,27,454,481
2017,1,18,2,20,8,299,307
2017,1,18,2,21,14,211,225
2017,1,18,2,22,14,115,129
2017,1,18,2,23,8,53,61
2017,1,19,3,0,6,28,34
2017,1,19,3,1,5,9,14
2017,1,19,3,2,4,6,10
2017,1,19,3,4,1,4,5
2017,1,19,3,5,3,46,49
2017,1,19,3,6,4,162,166
2017,1,19,3,7,14,448,462
2017,1,19,3,8,38,693,731
2017,1,19,3,9,26,406,432
2017,1,19,3,10,39,209,248
2017,1,19,3,11,54,236,290
2017,1,19,3,12,93,307,400
2017,1,19,3,13,70,298,368
2017,1,19,3,14,89,274,363
2017,1,19,3,15,116,345,461
2017,1,19,3,16,83,442,525
2017,1,19,3,17,115,677,792
2017,1,19,3,18,82,625,707
2017,1,19,3,19,60,409,469
2017,1,19,3,20,31,264,295
2017,1,19,3,21,51,220,271
2017,1,19,3,22,34,157,191
2017,1,19,3,23,13,80,93
2017,1,20,4,0,8,71,79
2017,1,20,4,1,15,37,52
2017,1,20,4,2,5,26,31
2017,1,20,4,3,5,14,19
2017,1,20,4,4,0,18,18
2017,1,20,4,5,15,44,59
2017,1,20,4,6,17,78,95
2017,1,20,4,7,35,143,178
2017,1,20,4,8,49,233,282
2017,1,20,4,9,75,194,269
2017,1,20,4,10,91,270,361
2017,1,20,4,11,112,297,409
2017,1,20,4,12,109,284,393
2017,1,20,4,13,151,291,442
2017,1,20,4,14,138,280,418
2017,1,20,4,15,102,255,357
2017,1,20,4,16,119,290,409
2017,1,20,4,17,85,314,399
2017,1,20,4,18,55,281,336
2017,1,20,4,19,46,245,291
2017,1,20,4,20,40,192,232
2017,1,20,4,21,43,134,177
2017,1,20,4,22,34,105,139
2017,1,20,4,23,35,86,121
2017,1,21,5,0,27,70,97
2017,1,21,5,1,25,37,62
2017,1,21,5,2,12,24,36
2017,1,21,5,3,0,9,9
2017,1,21,5,4,1,7,8
2017,1,21,5,5,9,11,20
2017,1,21,5,6,19,30,49
2017,1,21,5,7,50,109,159
2017,1,21,5,8,197,336,533
2017,1,21,5,9,390,444,834
2017,1,21,5,10,312,348,660
2017,1,21,5,11,232,295,527
2017,1,21,5,12,254,334,588
2017,1,21,5,13,259,291,550
2017,1,21,5,14,307,405,712
2017,1,21,5,15,368,449,817
2017,1,21,5,16,350,424,774
2017,1,21,5,17,224,301,525
2017,1,21,5,18,125,228,353
2017,1,21,5,19,69,172,241
2017,1,21,5,20,48,140,188
2017,1,21,5,21,54,104,158
2017,1,21,5,22,48,92,140
2017,1,21,5,23,32,85,117
2017,1,22,6,0,24,73,97
2017,1,22,6,1,24,54,78
2017,1,22,6,2,17,23,40
2017,1,22,6,3,5,12,17
2017,1,22,6,4,1,3,4
2017,1,22,6,5,1,3,4
2017,1,22,6,6,0,12,12
2017,1,22,6,7,11,29,40
2017,1,22,6,8,25,71,96
2017,1,22,6,9,55,166,221
2017,1,22,6,10,92,252,344
2017,1,22,6,11,164,286,450
2017,1,22,6,12,172,365,537
2017,1,22,6,13,196,359,555
2017,1,22,6,14,151,296,447
2017,1,22,6,15,29,124,153
2017,1,22,6,16,82,147,229
2017,1,22,6,17,47,153,200
2017,1,22,6,18,22,132,154
2017,1,22,6,19,23,117,140
2017,1,22,6,20,12,65,77
2017,1,22,6,21,10,68,78
2017,1,22,6,22,14,55,69
2017,1,22,6,23,3,21,24
2017,1,23,0,0,12,7,19
2017,1,23,0,1,1,6,7
2017,1,23,0,2,0,4,4
2017,1,23,0,3,4,0,4
2017,1,23,0,4,0,3,3
2017,1,23,0,5,0,38,38
2017,1,23,0,6,0,124,124
2017,1,23,0,7,3,217,220
2017,1,23,0,8,10,277,287
2017,1,23,0,9,8,133,141
2017,1,23,0,10,7,49,56
2017,1,23,0,11,4,50,54
2017,1,23,0,12,3,54,57
2017,1,23,0,13,2,38,40
2017,1,23,0,14,0,43,43
2017,1,23,0,15,2,86,88
2017,1,23,0,16,2,171,173
2017,1,23,0,17,16,434,450
2017,1,23,0,18,18,409,427
2017,1,23,0,19,7,265,272
2017,1,23,0,20,7,167,174
2017,1,23,0,21,4,121,125
2017,1,23,0,22,7,63,70
2017,1,23,0,23,1,28,29
2017,1,24,1,0,1,12,13
2017,1,24,1,1,0,10,10
2017,1,24,1,2,0,2,2
2017,1,24,1,4,0,5,5
2017,1,24,1,5,0,56,56
2017,1,24,1,6,1,222,223
2017,1,24,1,7,6,601,607
2017,1,24,1,8,25,925,950
2017,1,24,1,9,13,414,427
2017,1,24,1,10,27,191,218
2017,1,24,1,11,32,209,241
2017,1,24,1,12,39,214,253
2017,1,24,1,13,36,232,268
2017,1,24,1,14,25,199,224
2017,1,24,1,15,21,307,328
2017,1,24,1,16,32,528,560
2017,1,24,1,17,39,895,934
2017,1,24,1,18,28,806,834
2017,1,24,1,19,28,467,495
2017,1,24,1,20,18,314,332
2017,1,24,1,21,21,198,219
2017,1,24,1,22,16,116,132
2017,1,24,1,23,8,50,58
2017,1,25,2,0,2,15,17
2017,1,25,2,1,1,6,7
2017,1,25,2,2,0,5,5
2017,1,25,2,4,0,9,9
2017,1,25,2,5,2,83,85
2017,1,25,2,6,4,257,261
2017,1,25,2,7,11,726,737
2017,1,25,2,8,46,1037,1083
2017,1,25,2,9,19,426,445
2017,1,25,2,10,26,167,193
2017,1,25,2,11,44,229,273
2017,1,25,2,12,55,287,342
2017,1,25,2,13,72,285,357
2017,1,25,2,14,85,278,363
2017,1,25,2,15,104,382,486
2017,1,25,2,16,84,615,699
2017,1,25,2,17,87,1144,1231
2017,1,25,2,18,61,888,949
2017,1,25,2,19,31,567,598
2017,1,25,2,20,13,340,353
2017,1,25,2,21,13,257,270
2017,1,25,2,22,19,157,176
2017,1,25,2,23,14,71,85
2017,1,26,3,0,1,17,18
2017,1,26,3,1,1,9,10
2017,1,26,3,2,1,8,9
2017,1,26,3,3,1,5,6
2017,1,26,3,4,0,10,10
2017,1,26,3,5,1,57,58
2017,1,26,3,6,2,242,244
2017,1,26,3,7,16,681,697
2017,1,26,3,8,36,1095,1131
2017,1,26,3,9,29,470,499
2017,1,26,3,10,26,191,217
2017,1,26,3,11,31,248,279
2017,1,26,3,12,49,311,360
2017,1,26,3,13,30,284,314
2017,1,26,3,14,27,280,307
2017,1,26,3,15,42,331,373
2017,1,26,3,16,35,485,520
2017,1,26,3,17,32,942,974
2017,1,26,3,18,32,752,784
2017,1,26,3,19,24,459,483
2017,1,26,3,20,21,325,346
2017,1,26,3,21,7,190,197
2017,1,26,3,22,13,125,138
2017,1,26,3,23,6,67,73
2017,1,27,4,0,0,25,25
2017,1,27,4,1,1,18,19
2017,1,27,4,2,0,2,2
2017,1,27,4,3,0,1,1
2017,1,27,4,4,0,7,7
2017,1,27,4,5,1,62,63
2017,1,27,4,6,2,180,182
2017,1,27,4,7,16,581,597
2017,1,27,4,8,22,932,954
2017,1,27,4,9,20,454,474
2017,1,27,4,10,34,196,230
2017,1,27,4,11,38,211,249
2017,1,27,4,12,53,280,333
2017,1,27,4,13,51,272,323
2017,1,27,4,14,39,212,251
2017,1,27,4,15,41,334,375
2017,1,27,4,16,63,493,556
2017,1,27,4,17,56,805,861
2017,1,27,4,18,38,543,581
2017,1,27,4,19,14,293,307
2017,1,27,4,20,16,169,185
2017,1,27,4,21,11,113,124
2017,1,27,4,22,3,117,120
2017,1,27,4,23,5,63,68
2017,1,28,5,0,5,54,59
2017,1,28,5,1,12,33,45
2017,1,28,5,2,7,23,30
2017,1,28,5,3,4,12,16
2017,1,28,5,4,3,9,12
2017,1,28,5,5,0,5,5
2017,1,28,5,6,0,14,14
2017,1,28,5,7,1,63,64
2017,1,28,5,8,16,123,139
2017,1,28,5,9,41,216,257
2017,1,28,5,10,57,280,337
2017,1,28,5,11,88,303,391
2017,1,28,5,12,104,380,484
2017,1,28,5,13,144,349,493
2017,1,28,5,14,185,361,546
2017,1,28,5,15,180,375,555
2017,1,28,5,16,200,355,555
2017,1,28,5,17,142,297,439
2017,1,28,5,18,66,276,342
2017,1,28,5,19,26,244,270
2017,1,28,5,20,11,138,149
2017,1,28,5,21,21,118,139
2017,1,28,5,22,16,118,134
2017,1,28,5,23,7,73,80
2017,1,29,6,0,8,62,70
2017,1,29,6,1,9,52,61
2017,1,29,6,2,9,39,48
2017,1,29,6,3,3,23,26
2017,1,29,6,4,4,5,9
2017,1,29,6,5,1,5,6
2017,1,29,6,6,2,7,9
2017,1,29,6,7,4,29,33
2017,1,29,6,8,11,86,97
2017,1,29,6,9,12,153,165
2017,1,29,6,10,80,262,342
2017,1,29,6,11,86,296,382
2017,1,29,6,12,148,490,638
2017,1,29,6,13,127,403,530
2017,1,29,6,14,130,350,480
2017,1,29,6,15,103,481,584
2017,1,29,6,16,114,473,587
2017,1,29,6,17,67,320,387
2017,1,29,6,18,49,202,251
2017,1,29,6,19,31,168,199
2017,1,29,6,20,10,137,147
2017,1,29,6,21,22,80,102
2017,1,29,6,22,10,55,65
2017,1,29,6,23,2,30,32
2017,1,30,0,0,3,12,15
2017,1,30,0,1,2,10,12
2017,1,30,0,2,0,5,5
2017,1,30,0,4,0,5,5
2017,1,30,0,5,0,49,49
2017,1,30,0,6,0,153,153
2017,1,30,0,7,9,376,385
2017,1,30,0,8,12,686,698
2017,1,30,0,9,12,304,316
2017,1,30,0,10,10,141,151
2017,1,30,0,11,7,140,147
2017,1,30,0,12,16,167,183
2017,1,30,0,13,13,178,191
2017,1,30,0,14,15,133,148
2017,1,30,0,15,10,200,210
2017,1,30,0,16,8,366,374
2017,1,30,0,17,27,766,793
2017,1,30,0,18,14,646,660
2017,1,30,0,19,17,408,425
2017,1,30,0,20,8,243,251
2017,1,30,0,21,4,141,145
2017,1,30,0,22,7,64,71
2017,1,30,0,23,0,33,33
2017,1,31,1,0,1,19,20
2017,1,31,1,1,0,7,7
2017,1,31,1,2,0,5,5
2017,1,31,1,3,0,4,4
2017,1,31,1,4,0,7,7
2017,1,31,1,5,1,57,58
2017,1,31,1,6,0,226,226
2017,1,31,1,7,3,569,572
2017,1,31,1,8,20,916,936
2017,1,31,1,9,20,428,448
2017,1,31,1,10,13,225,238
2017,1,31,1,11,18,206,224
2017,1,31,1,12,35,275,310
2017,1,31,1,13,22,225,247
2017,1,31,1,14,30,204,234
2017,1,31,1,15,43,337,380
2017,1,31,1,16,55,542,597
2017,1,31,1,17,79,981,1060
2017,1,31,1,18,39,836,875
2017,1,31,1,19,26,472,498
2017,1,31,1,20,22,343,365
2017,1,31,1,21,19,230,249
2017,1,31,1,22,10,141,151
2017,1,31,1,23,7,46,53
2017,2,1,2,0,4,23,27
2017,2,1,2,1,2,8,10
2017,2,1,2,2,1,8,9
2017,2,1,2,3,1,2,3
2017,2,1,2,4,0,6,6
2017,2,1,2,5,1,91,92
2017,2,1,2,6,3,247,250
2017,2,1,2,7,17,666,683
2017,2,1,2,8,24,1095,1119
2017,2,1,2,9,20,465,485
2017,2,1,2,10,29,201,230
2017,2,1,2,11,31,240,271
2017,2,1,2,12,28,269,297
2017,2,1,2,13,19,262,281
2017,2,1,2,14,26,199,225
2017,2,1,2,15,24,299,323
2017,2,1,2,16,45,544,589
2017,2,1,2,17,64,1075,1139
2017,2,1,2,18,51,773,824
2017,2,1,2,19,25,492,517
2017,2,1,2,20,21,323,344
2017,2,1,2,21,17,219,236
2017,2,1,2,22,11,176,187
2017,2,1,2,23,5,79,84
2017,2,2,3,0,1,24,25
2017,2,2,3,1,4,9,13
2017,2,2,3,2,2,0,2
2017,2,2,3,3,1,4,5
2017,2,2,3,4,1,7,8
2017,2,2,3,5,0,55,55
2017,2,2,3,6,10,241,251
2017,2,2,3,7,14,691,705
2017,2,2,3,8,32,1076,1108
2017,2,2,3,9,34,444,478
2017,2,2,3,10,15,184,199
2017,2,2,3,11,16,210,226
2017,2,2,3,12,20,281,301
2017,2,2,3,13,22,287,309
2017,2,2,3,14,31,220,251
2017,2,2,3,15,40,329,369
2017,2,2,3,16,52,501,553
2017,2,2,3,17,68,886,954
2017,2,2,3,18,25,733,758
2017,2,2,3,19,19,396,415
2017,2,2,3,20,10,270,280
2017,2,2,3,21,9,191,200
2017,2,2,3,22,12,113,125
2017,2,2,3,23,1,58,59
2017,2,3,4,0,1,49,50
2017,2,3,4,1,1,15,16
2017,2,3,4,2,0,5,5
2017,2,3,4,3,0,1,1
2017,2,3,4,4,1,5,6
2017,2,3,4,5,0,54,54
2017,2,3,4,6,4,183,187
2017,2,3,4,7,12,518,530
2017,2,3,4,8,32,884,916
2017,2,3,4,9,20,452,472
2017,2,3,4,10,21,200,221
2017,2,3,4,11,25,240,265
2017,2,3,4,12,25,276,301
2017,2,3,4,13,29,276,305
2017,2,3,4,14,26,242,268
2017,2,3,4,15,37,323,360
2017,2,3,4,16,37,450,487
2017,2,3,4,17,34,742,776
2017,2,3,4,18,30,518,548
2017,2,3,4,19,23,283,306
2017,2,3,4,20,3,179,182
2017,2,3,4,21,10,124,134
2017,2,3,4,22,4,83,87
2017,2,3,4,23,7,59,66
2017,2,4,5,0,2,47,49
2017,2,4,5,1,6,27,33
2017,2,4,5,2,0,6,6
2017,2,4,5,3,1,8,9
2017,2,4,5,4,2,4,6
2017,2,4,5,5,1,8,9
2017,2,4,5,6,3,16,19
2017,2,4,5,7,4,64,68
2017,2,4,5,8,10,131,141
2017,2,4,5,9,38,213,251
2017,2,4,5,10,36,224,260
2017,2,4,5,11,75,298,373
2017,2,4,5,12,81,333,414
2017,2,4,5,13,105,342,447
2017,2,4,5,14,125,365,490
2017,2,4,5,15,118,360,478
2017,2,4,5,16,109,357,466
2017,2,4,5,17,81,290,371
2017,2,4,5,18,35,224,259
2017,2,4,5,19,17,184,201
2017,2,4,5,20,29,137,166
2017,2,4,5,21,19,86,105
2017,2,4,5,22,10,103,113
2017,2,4,5,23,11,62,73
2017,2,5,6,0,3,54,57
2017,2,5,6,1,5,45,50
2017,2,5,6,2,9,28,37
2017,2,5,6,3,3,14,17
2017,2,5,6,4,3,3,6
2017,2,5,6,5,1,7,8
2017,2,5,6,6,6,10,16
2017,2,5,6,7,8,42,50
2017,2,5,6,8,17,95,112
2017,2,5,6,9,28,152,180
2017,2,5,6,10,65,290,355
2017,2,5,6,11,100,326,426
2017,2,5,6,12,121,384,505
2017,2,5,6,13,118,398,516
2017,2,5,6,14,138,380,518
2017,2,5,6,15,142,420,562
2017,2,5,6,16,119,402,521
2017,2,5,6,17,114,410,524
2017,2,5,6,18,45,290,335
2017,2,5,6,19,28,115,143
2017,2,5,6,20,16,89,105
2017,2,5,6,21,14,76,90
2017,2,5,6,22,30,227,257
2017,2,5,6,23,10,89,99
2017,2,6,0,0,7,15,22
2017,2,6,0,1,0,10,10
2017,2,6,0,2,5,11,16
2017,2,6,0,3,0,8,8
2017,2,6,0,4,0,6,6
2017,2,6,0,5,1,55,56
2017,2,6,0,6,2,191,193
2017,2,6,0,7,19,554,573
2017,2,6,0,8,61,1101,1162
2017,2,6,0,9,36,412,448
2017,2,6,0,10,30,173,203
2017,2,6,0,11,53,211,264
2017,2,6,0,12,45,266,311
2017,2,6,0,13,68,263,331
2017,2,6,0,14,70,234,304
2017,2,6,0,15,98,311,409
2017,2,6,0,16,93,551,644
2017,2,6,0,17,103,1100,1203
2017,2,6,0,18,63,871,934
2017,2,6,0,19,29,509,538
2017,2,6,0,20,39,295,334
2017,2,6,0,21,25,208,233
2017,2,6,0,22,19,126,145
2017,2,6,0,23,13,39,52
2017,2,7,1,0,0,14,14
2017,2,7,1,1,1,8,9
2017,2,7,1,3,0,3,3
2017,2,7,1,4,0,5,5
2017,2,7,1,5,1,68,69
2017,2,7,1,6,5,288,293
2017,2,7,1,7,17,692,709
2017,2,7,1,8,46,1148,1194
2017,2,7,1,9,31,436,467
2017,2,7,1,10,39,226,265
2017,2,7,1,11,45,264,309
2017,2,7,1,12,44,352,396
2017,2,7,1,13,71,342,413
2017,2,7,1,14,64,257,321
2017,2,7,1,15,90,372,462
2017,2,7,1,16,122,611,733
2017,2,7,1,17,145,1297,1442
2017,2,7,1,18,80,967,1047
2017,2,7,1,19,44,608,652
2017,2,7,1,20,39,366,405
2017,2,7,1,21,35,273,308
2017,2,7,1,22,28,175,203
2017,2,7,1,23,16,61,77
2017,2,8,2,0,6,24,30
2017,2,8,2,1,1,16,17
2017,2,8,2,2,1,4,5
2017,2,8,2,3,1,5,6
2017,2,8,2,4,0,8,8
2017,2,8,2,5,2,96,98
2017,2,8,2,6,11,310,321
2017,2,8,2,7,25,838,863
2017,2,8,2,8,47,1205,1252
2017,2,8,2,9,33,457,490
2017,2,8,2,10,49,218,267
2017,2,8,2,11,44,296,340
2017,2,8,2,12,100,401,501
2017,2,8,2,13,97,401,498
2017,2,8,2,14,118,336,454
2017,2,8,2,15,104,373,477
2017,2,8,2,16,129,688,817
2017,2,8,2,17,153,1356,1509
2017,2,8,2,18,90,1004,1094
2017,2,8,2,19,50,575,625
2017,2,8,2,20,40,378,418
2017,2,8,2,21,36,249,285
2017,2,8,2,22,27,130,157
2017,2,8,2,23,12,75,87
2017,2,9,3,0,4,19,23
2017,2,9,3,1,1,6,7
2017,2,9,3,2,0,5,5
2017,2,9,3,4,0,4,4
2017,2,9,3,5,2,33,35
2017,2,9,3,6,3,161,164
2017,2,9,3,7,7,442,449
2017,2,9,3,8,24,811,835
2017,2,9,3,9,27,386,413
2017,2,9,3,10,16,163,179
2017,2,9,3,11,21,141,162
2017,2,9,3,12,6,215,221
2017,2,9,3,13,14,177,191
2017,2,9,3,14,15,166,181
2017,2,9,3,15,9,197,206
2017,2,9,3,16,16,354,370
2017,2,9,3,17,22,647,669
2017,2,9,3,18,13,525,538
2017,2,9,3,19,6,289,295
2017,2,9,3,20,4,161,165
2017,2,9,3,21,5,130,135
2017,2,9,3,22,4,77,81
2017,2,9,3,23,0,41,41
2017,2,10,4,0,3,16,19
2017,2,10,4,1,1,9,10
2017,2,10,4,2,3,5,8
2017,2,10,4,3,0,1,1
2017,2,10,4,4,0,5,5
2017,2,10,4,5,0,34,34
2017,2,10,4,6,6,153,159
2017,2,10,4,7,5,406,411
2017,2,10,4,8,27,745,772
2017,2,10,4,9,16,378,394
2017,2,10,4,10,22,171,193
2017,2,10,4,11,23,179,202
2017,2,10,4,12,60,264,324
2017,2,10,4,13,40,247,287
2017,2,10,4,14,36,214,250
2017,2,10,4,15,37,306,343
2017,2,10,4,16,32,476,508
2017,2,10,4,17,32,714,746
2017,2,10,4,18,13,492,505
2017,2,10,4,19,10,293,303
2017,2,10,4,20,15,155,170
2017,2,10,4,21,13,118,131
2017,2,10,4,22,17,87,104
2017,2,10,4,23,14,81,95
2017,2,11,5,0,8,44,52
2017,2,11,5,1,9,39,48
2017,2,11,5,2,5,24,29
2017,2,11,5,3,8,13,21
2017,2,11,5,4,2,7,9
2017,2,11,5,5,0,7,7
2017,2,11,5,6,0,19,19
2017,2,11,5,7,10,64,74
2017,2,11,5,8,12,144,156
2017,2,11,5,9,45,243,288
2017,2,11,5,10,94,313,407
2017,2,11,5,11,136,371,507
2017,2,11,5,12,183,467,650
2017,2,11,5,13,258,364,622
2017,2,11,5,14,247,403,650
2017,2,11,5,15,244,412,656
2017,2,11,5,16,247,366,613
2017,2,11,5,17,182,384,566
2017,2,11,5,18,116,343,459
2017,2,11,5,19,79,213,292
2017,2,11,5,20,54,153,207
2017,2,11,5,21,57,158,215
2017,2,11,5,22,20,118,138
2017,2,11,5,23,29,107,136
2017,2,12,6,0,31,71,102
2017,2,12,6,1,30,61,91
2017,2,12,6,2,22,39,61
2017,2,12,6,3,4,26,30
2017,2,12,6,4,7,8,15
2017,2,12,6,5,2,8,10
2017,2,12,6,6,3,14,17
2017,2,12,6,7,8,40,48
2017,2,12,6,8,17,98,115
2017,2,12,6,9,33,163,196
2017,2,12,6,10,44,187,231
2017,2,12,6,11,35,142,177
2017,2,12,6,12,70,264,334
2017,2,12,6,13,104,282,386
2017,2,12,6,14,149,400,549
2017,2,12,6,15,157,433,590
2017,2,12,6,16,143,315,458
2017,2,12,6,17,70,305,375
2017,2,12,6,18,49,264,313
2017,2,12,6,19,29,203,232
2017,2,12,6,20,39,131,170
2017,2,12,6,21,23,93,116
2017,2,12,6,22,12,58,70
2017,2,12,6,23,5,32,37
2017,2,13,0,0,3,22,25
2017,2,13,0,1,1,8,9
2017,2,13,0,2,0,2,2
2017,2,13,0,3,0,1,1
2017,2,13,0,4,1,5,6
2017,2,13,0,5,1,49,50
2017,2,13,0,6,6,184,190
2017,2,13,0,7,12,470,482
2017,2,13,0,8,26,728,754
2017,2,13,0,9,20,334,354
2017,2,13,0,10,24,131,155
2017,2,13,0,11,18,137,155
2017,2,13,0,12,28,178,206
2017,2,13,0,13,29,179,208
2017,2,13,0,14,49,183,232
2017,2,13,0,15,35,256,291
2017,2,13,0,16,32,436,468
2017,2,13,0,17,42,852,894
2017,2,13,0,18,35,741,776
2017,2,13,0,19,19,442,461
2017,2,13,0,20,11,279,290
2017,2,13,0,21,14,179,193
2017,2,13,0,22,1,110,111
2017,2,13,0,23,2,49,51
2017,2,14,1,0,3,19,22
2017,2,14,1,1,1,9,10
2017,2,14,1,2,0,2,2
2017,2,14,1,3,0,3,3
2017,2,14,1,4,0,5,5
2017,2,14,1,5,2,63,65
2017,2,14,1,6,0,251,251
2017,2,14,1,7,7,629,636
2017,2,14,1,8,30,927,957
2017,2,14,1,9,34,401,435
2017,2,14,1,10,21,182,203
2017,2,14,1,11,18,185,203
2017,2,14,1,12,29,230,259
2017,2,14,1,13,16,221,237
2017,2,14,1,14,21,206,227
2017,2,14,1,15,29,324,353
2017,2,14,1,16,43,528,571
2017,2,14,1,17,62,1033,1095
2017,2,14,1,18,34,795,829
2017,2,14,1,19,19,411,430
2017,2,14,1,20,14,237,251
2017,2,14,1,21,7,201,208
2017,2,14,1,22,14,100,114
2017,2,14,1,23,2,41,43
2017,2,15,2,0,6,20,26
2017,2,15,2,1,3,5,8
2017,2,15,2,2,1,7,8
2017,2,15,2,3,0,3,3
2017,2,15,2,4,1,5,6
2017,2,15,2,5,1,66,67
2017,2,15,2,6,0,259,259
2017,2,15,2,7,19,632,651
2017,2,15,2,8,24,1047,1071
2017,2,15,2,9,32,458,490
2017,2,15,2,10,23,196,219
2017,2,15,2,11,40,218,258
2017,2,15,2,12,37,270,307
2017,2,15,2,13,36,282,318
2017,2,15,2,14,60,220,280
2017,2,15,2,15,50,270,320
2017,2,15,2,16,26,438,464
2017,2,15,2,17,57,909,966
2017,2,15,2,18,34,697,731
2017,2,15,2,19,18,414,432
2017,2,15,2,20,18,239,257
2017,2,15,2,21,17,181,198
2017,2,15,2,22,8,90,98
2017,2,15,2,23,0,48,48
2017,2,16,3,0,0,14,14
2017,2,16,3,1,1,5,6
2017,2,16,3,2,1,3,4
2017,2,16,3,3,1,2,3
2017,2,16,3,4,0,4,4
2017,2,16,3,5,2,57,59
2017,2,16,3,6,1,204,205
2017,2,16,3,7,14,570,584
2017,2,16,3,8,24,856,880
2017,2,16,3,9,21,446,467
2017,2,16,3,10,17,168,185
2017,2,16,3,11,25,201,226
2017,2,16,3,12,17,206,223
2017,2,16,3,13,17,206,223
2017,2,16,3,14,29,187,216
2017,2,16,3,15,23,247,270
2017,2,16,3,16,27,412,439
2017,2,16,3,17,35,786,821
2017,2,16,3,18,24,659,683
2017,2,16,3,19,22,305,327
2017,2,16,3,20,14,237,251
2017,2,16,3,21,14,169,183
2017,2,16,3,22,7,87,94
2017,2,16,3,23,3,57,60
2017,2,17,4,0,2,23,25
2017,2,17,4,1,9,15,24
2017,2,17,4,2,2,3,5
2017,2,17,4,3,0,1,1
2017,2,17,4,4,0,7,7
2017,2,17,4,5,2,49,51
2017,2,17,4,6,1,154,155
2017,2,17,4,7,11,440,451
2017,2,17,4,8,29,847,876
2017,2,17,4,9,23,413,436
2017,2,17,4,10,33,187,220
2017,2,17,4,11,27,233,260
2017,2,17,4,12,63,335,398
2017,2,17,4,13,52,309,361
2017,2,17,4,14,84,299,383
2017,2,17,4,15,102,369,471
2017,2,17,4,16,114,566,680
2017,2,17,4,17,84,797,881
2017,2,17,4,18,67,530,597
2017,2,17,4,19,50,345,395
2017,2,17,4,20,14,211,225
2017,2,17,4,21,19,137,156
2017,2,17,4,22,14,111,125
2017,2,17,4,23,13,86,99
2017,2,18,5,0,12,49,61
2017,2,18,5,1,7,35,42
2017,2,18,5,2,4,26,30
2017,2,18,5,3,1,15,16
2017,2,18,5,4,2,10,12
2017,2,18,5,5,2,7,9
2017,2,18,5,6,3,28,31
2017,2,18,5,7,13,57,70
2017,2,18,5,8,28,118,146
2017,2,18,5,9,99,263,362
2017,2,18,5,10,209,315,524
2017,2,18,5,11,394,391,785
2017,2,18,5,12,526,490,1016
2017,2,18,5,13,632,463,1095
2017,2,18,5,14,794,510,1304
2017,2,18,5,15,759,496,1255
2017,2,18,5,16,728,489,1217
2017,2,18,5,17,577,416,993
2017,2,18,5,18,268,297,565
2017,2,18,5,19,163,241,404
2017,2,18,5,20,92,151,243
2017,2,18,5,21,82,118,200
2017,2,18,5,22,65,122,187
2017,2,18,5,23,71,88,159
2017,2,19,6,0,39,87,126
2017,2,19,6,1,20,47,67
2017,2,19,6,2,12,43,55
2017,2,19,6,3,7,19,26
2017,2,19,6,4,3,5,8
2017,2,19,6,5,2,11,13
2017,2,19,6,6,6,16,22
2017,2,19,6,7,13,42,55
2017,2,19,6,8,68,102,170
2017,2,19,6,9,178,172,350
2017,2,19,6,10,371,355,726
2017,2,19,6,11,570,378,948
2017,2,19,6,12,740,522,1262
2017,2,19,6,13,844,517,1361
2017,2,19,6,14,901,539,1440
2017,2,19,6,15,949,571,1520
2017,2,19,6,16,868,504,1372
2017,2,19,6,17,695,432,1127
2017,2,19,6,18,274,336,610
2017,2,19,6,19,132,206,338
2017,2,19,6,20,134,126,260
2017,2,19,6,21,96,133,229
2017,2,19,6,22,76,82,158
2017,2,19,6,23,51,56,107
2017,2,20,0,0,45,46,91
2017,2,20,0,1,13,19,32
2017,2,20,0,2,3,8,11
2017,2,20,0,3,3,8,11
2017,2,20,0,4,0,8,8
2017,2,20,0,5,2,31,33
2017,2,20,0,6,7,43,50
2017,2,20,0,7,32,138,170
2017,2,20,0,8,80,292,372
2017,2,20,0,9,171,291,462
2017,2,20,0,10,280,326,606
2017,2,20,0,11,415,404,819
2017,2,20,0,12,431,452,883
2017,2,20,0,13,504,505,1009
2017,2,20,0,14,488,478,966
2017,2,20,0,15,462,510,972
2017,2,20,0,16,494,525,1019
2017,2,20,0,17,345,598,943
2017,2,20,0,18,129,451,580
2017,2,20,0,19,104,330,434
2017,2,20,0,20,57,217,274
2017,2,20,0,21,51,113,164
2017,2,20,0,22,16,94,110
2017,2,20,0,23,6,33,39
2017,2,21,1,0,6,6,12
2017,2,21,1,1,3,11,14
2017,2,21,1,2,0,4,4
2017,2,21,1,3,0,7,7
2017,2,21,1,4,0,5,5
2017,2,21,1,5,3,73,76
2017,2,21,1,6,3,271,274
2017,2,21,1,7,33,715,748
2017,2,21,1,8,44,952,996
2017,2,21,1,9,76,305,381
2017,2,21,1,10,89,161,250
2017,2,21,1,11,114,205,319
2017,2,21,1,12,115,277,392
2017,2,21,1,13,84,234,318
2017,2,21,1,14,68,219,287
2017,2,21,1,15,104,352,456
2017,2,21,1,16,112,575,687
2017,2,21,1,17,147,1119,1266
2017,2,21,1,18,68,866,934
2017,2,21,1,19,54,500,554
2017,2,21,1,20,34,304,338
2017,2,21,1,21,40,241,281
2017,2,21,1,22,24,119,143
2017,2,21,1,23,18,55,73
2017,2,22,2,0,5,23,28
2017,2,22,2,1,1,10,11
2017,2,22,2,2,1,3,4
2017,2,22,2,3,0,2,2
2017,2,22,2,4,2,6,8
2017,2,22,2,5,2,83,85
2017,2,22,2,6,4,296,300
2017,2,22,2,7,30,760,790
2017,2,22,2,8,37,1056,1093
2017,2,22,2,9,32,396,428
2017,2,22,2,10,69,186,255
2017,2,22,2,11,72,218,290
2017,2,22,2,12,91,291,382
2017,2,22,2,13,100,290,390
2017,2,22,2,14,85,290,375
2017,2,22,2,15,137,337,474
2017,2,22,2,16,135,640,775
2017,2,22,2,17,135,1154,1289
2017,2,22,2,18,80,935,1015
2017,2,22,2,19,61,543,604
2017,2,22,2,20,64,379,443
2017,2,22,2,21,54,289,343
2017,2,22,2,22,18,167,185
2017,2,22,2,23,12,78,90
2017,2,23,3,0,4,25,29
2017,2,23,3,1,4,15,19
2017,2,23,3,2,0,2,2
2017,2,23,3,3,1,2,3
2017,2,23,3,4,1,10,11
2017,2,23,3,5,4,66,70
2017,2,23,3,6,6,322,328
2017,2,23,3,7,42,838,880
2017,2,23,3,8,82,1205,1287
2017,2,23,3,9,72,473,545
2017,2,23,3,10,93,203,296
2017,2,23,3,11,101,311,412
2017,2,23,3,12,167,446,613
2017,2,23,3,13,184,367,551
2017,2,23,3,14,196,351,547
2017,2,23,3,15,199,407,606
2017,2,23,3,16,251,676,927
2017,2,23,3,17,223,1316,1539
2017,2,23,3,18,164,998,1162
2017,2,23,3,19,99,615,714
2017,2,23,3,20,67,410,477
2017,2,23,3,21,58,322,380
2017,2,23,3,22,36,175,211
2017,2,23,3,23,35,100,135
2017,2,24,4,0,27,42,69
2017,2,24,4,1,16,28,44
2017,2,24,4,2,1,11,12
2017,2,24,4,3,1,6,7
2017,2,24,4,4,0,9,9
2017,2,24,4,5,5,73,78
2017,2,24,4,6,4,264,268
2017,2,24,4,7,33,766,799
2017,2,24,4,8,75,1164,1239
2017,2,24,4,9,106,464,570
2017,2,24,4,10,145,251,396
2017,2,24,4,11,186,351,537
2017,2,24,4,12,272,445,717
2017,2,24,4,13,274,470,744
2017,2,24,4,14,336,428,764
2017,2,24,4,15,402,554,956
2017,2,24,4,16,356,854,1210
2017,2,24,4,17,375,1261,1636
2017,2,24,4,18,237,836,1073
2017,2,24,4,19,143,482,625
2017,2,24,4,20,93,309,402
2017,2,24,4,21,123,216,339
2017,2,24,4,22,68,172,240
2017,2,24,4,23,87,138,225
2017,2,25,5,0,26,105,131
2017,2,25,5,1,34,64,98
2017,2,25,5,2,25,33,58
2017,2,25,5,3,20,16,36
2017,2,25,5,4,5,6,11
2017,2,25,5,5,2,23,25
2017,2,25,5,6,8,30,38
2017,2,25,5,7,33,90,123
2017,2,25,5,8,70,245,315
2017,2,25,5,9,165,423,588
2017,2,25,5,10,288,493,781
2017,2,25,5,11,435,566,1001
2017,2,25,5,12,432,582,1014
2017,2,25,5,13,397,528,925
2017,2,25,5,14,235,327,562
2017,2,25,5,15,132,172,304
2017,2,25,5,16,169,274,443
2017,2,25,5,17,170,285,455
2017,2,25,5,18,86,286,372
2017,2,25,5,19,77,201,278
2017,2,25,5,20,65,158,223
2017,2,25,5,21,34,131,165
2017,2,25,5,22,26,97,123
2017,2,25,5,23,22,83,105
2017,2,26,6,0,20,84,104
2017,2,26,6,1,6,47,53
2017,2,26,6,2,12,36,48
2017,2,26,6,3,12,13,25
2017,2,26,6,4,0,3,3
2017,2,26,6,5,1,7,8
2017,2,26,6,6,1,14,15
2017,2,26,6,7,7,43,50
2017,2,26,6,8,34,137,171
2017,2,26,6,9,72,212,284
2017,2,26,6,10,132,333,465
2017,2,26,6,11,159,316,475
2017,2,26,6,12,182,404,586
2017,2,26,6,13,256,417,673
2017,2,26,6,14,239,392,631
2017,2,26,6,15,223,433,656
2017,2,26,6,16,205,397,602
2017,2,26,6,17,176,331,507
2017,2,26,6,18,78,289,367
2017,2,26,6,19,39,201,240
2017,2,26,6,20,25,115,140
2017,2,26,6,21,16,89,105
2017,2,26,6,22,15,74,89
2017,2,26,6,23,8,34,42
2017,2,27,0,0,4,36,40
2017,2,27,0,1,0,5,5
2017,2,27,0,2,1,3,4
2017,2,27,0,3,0,1,1
2017,2,27,0,4,0,7,7
2017,2,27,0,5,4,60,64
2017,2,27,0,6,7,258,265
2017,2,27,0,7,21,576,597
2017,2,27,0,8,45,933,978
2017,2,27,0,9,42,400,442
2017,2,27,0,10,54,159,213
2017,2,27,0,11,77,183,260
2017,2,27,0,12,68,290,358
2017,2,27,0,13,71,265,336
2017,2,27,0,14,84,211,295
2017,2,27,0,15,94,343,437
2017,2,27,0,16,71,540,611
2017,2,27,0,17,95,1037,1132
2017,2,27,0,18,53,838,891
2017,2,27,0,19,48,503,551
2017,2,27,0,20,29,281,310
2017,2,27,0,21,29,221,250
2017,2,27,0,22,32,117,149
2017,2,27,0,23,8,60,68
2017,2,28,1,0,3,22,25
2017,2,28,1,1,1,8,9
2017,2,28,1,2,0,5,5
2017,2,28,1,3,0,2,2
2017,2,28,1,4,0,7,7
2017,2,28,1,5,13,71,84
2017,2,28,1,6,12,309,321
2017,2,28,1,7,28,861,889
2017,2,28,1,8,65,1209,1274
2017,2,28,1,9,49,454,503
2017,2,28,1,10,63,217,280
2017,2,28,1,11,82,283,365
2017,2,28,1,12,84,365,449
2017,2,28,1,13,106,331,437
2017,2,28,1,14,122,289,411
2017,2,28,1,15,128,357,485
2017,2,28,1,16,98,637,735
2017,2,28,1,17,60,776,836
2017,2,28,1,18,5,215,220
2017,2,28,1,19,10,118,128
2017,2,28,1,20,4,101,105
2017,2,28,1,21,3,83,86
2017,2,28,1,22,13,97,110
2017,2,28,1,23,0,62,62
2017,3,1,2,0,5,22,27
2017,3,1,2,1,3,16,19
2017,3,1,2,2,3,8,11
2017,3,1,2,3,2,2,4
2017,3,1,2,4,0,8,8
2017,3,1,2,5,8,82,90
2017,3,1,2,6,8,310,318
2017,3,1,2,7,32,763,795
2017,3,1,2,8,63,1016,1079
2017,3,1,2,9,29,377,406
2017,3,1,2,10,54,192,246
2017,3,1,2,11,55,284,339
2017,3,1,2,12,87,346,433
2017,3,1,2,13,54,269,323
2017,3,1,2,14,46,215,261
2017,3,1,2,15,67,282,349
2017,3,1,2,16,53,573,626
2017,3,1,2,17,78,1007,1085
2017,3,1,2,18,60,911,971
2017,3,1,2,19,49,551,600
2017,3,1,2,20,48,377,425
2017,3,1,2,21,25,269,294
2017,3,1,2,22,26,162,188
2017,3,1,2,23,10,70,80
2017,3,2,3,0,10,33,43
2017,3,2,3,1,8,6,14
2017,3,2,3,2,3,6,9
2017,3,2,3,3,1,1,2
2017,3,2,3,4,2,10,12
2017,3,2,3,5,1,62,63
2017,3,2,3,6,4,247,251
2017,3,2,3,7,25,702,727
2017,3,2,3,8,42,1028,1070
2017,3,2,3,9,26,438,464
2017,3,2,3,10,25,184,209
2017,3,2,3,11,46,234,280
2017,3,2,3,12,31,296,327
2017,3,2,3,13,52,281,333
2017,3,2,3,14,59,233,292
2017,3,2,3,15,61,325,386
2017,3,2,3,16,58,494,552
2017,3,2,3,17,97,996,1093
2017,3,2,3,18,65,761,826
2017,3,2,3,19,21,407,428
2017,3,2,3,20,23,284,307
2017,3,2,3,21,15,214,229
2017,3,2,3,22,12,125,137
2017,3,2,3,23,9,71,80
2017,3,3,4,0,9,34,43
2017,3,3,4,1,2,11,13
2017,3,3,4,2,4,10,14
2017,3,3,4,3,0,1,1
2017,3,3,4,4,1,13,14
2017,3,3,4,5,4,60,64
2017,3,3,4,6,4,176,180
2017,3,3,4,7,11,457,468
2017,3,3,4,8,37,886,923
2017,3,3,4,9,36,453,489
2017,3,3,4,10,56,198,254
2017,3,3,4,11,54,232,286
2017,3,3,4,12,35,300,335
2017,3,3,4,13,64,243,307
2017,3,3,4,14,44,232,276
2017,3,3,4,15,45,294,339
2017,3,3,4,16,53,480,533
2017,3,3,4,17,67,730,797
2017,3,3,4,18,45,542,587
2017,3,3,4,19,22,269,291
2017,3,3,4,20,16,173,189
2017,3,3,4,21,15,130,145
2017,3,3,4,22,13,111,124
2017,3,3,4,23,4,65,69
2017,3,4,5,0,6,46,52
2017,3,4,5,1,4,32,36
2017,3,4,5,2,4,17,21
2017,3,4,5,3,0,9,9
2017,3,4,5,4,0,3,3
2017,3,4,5,5,2,6,8
2017,3,4,5,6,1,15,16
2017,3,4,5,7,8,55,63
2017,3,4,5,8,22,151,173
2017,3,4,5,9,53,223,276
2017,3,4,5,10,65,300,365
2017,3,4,5,11,75,367,442
2017,3,4,5,12,120,339,459
2017,3,4,5,13,139,348,487
2017,3,4,5,14,178,283,461
2017,3,4,5,15,156,316,472
2017,3,4,5,16,168,330,498
2017,3,4,5,17,107,319,426
2017,3,4,5,18,60,244,304
2017,3,4,5,19,29,173,202
2017,3,4,5,20,24,127,151
2017,3,4,5,21,22,92,114
2017,3,4,5,22,19,101,120
2017,3,4,5,23,41,84,125
2017,3,5,6,0,16,42,58
2017,3,5,6,1,7,36,43
2017,3,5,6,2,1,28,29
2017,3,5,6,3,1,14,15
2017,3,5,6,4,0,4,4
2017,3,5,6,5,2,5,7
2017,3,5,6,6,3,7,10
2017,3,5,6,7,16,49,65
2017,3,5,6,8,16,102,118
2017,3,5,6,9,46,152,198
2017,3,5,6,10,62,252,314
2017,3,5,6,11,114,297,411
2017,3,5,6,12,145,317,462
2017,3,5,6,13,155,340,495
2017,3,5,6,14,189,362,551
2017,3,5,6,15,174,346,520
2017,3,5,6,16,142,333,475
2017,3,5,6,17,75,302,377
2017,3,5,6,18,50,257,307
2017,3,5,6,19,22,173,195
2017,3,5,6,20,17,117,134
2017,3,5,6,21,19,79,98
2017,3,5,6,22,13,64,77
2017,3,5,6,23,8,28,36
2017,3,6,0,0,4,13,17
2017,3,6,0,1,0,4,4
2017,3,6,0,2,0,2,2
2017,3,6,0,3,1,2,3
2017,3,6,0,4,1,10,11
2017,3,6,0,5,1,54,55
2017,3,6,0,6,5,224,229
2017,3,6,0,7,13,591,604
2017,3,6,0,8,35,951,986
2017,3,6,0,9,50,368,418
2017,3,6,0,10,67,172,239
2017,3,6,0,11,72,205,277
2017,3,6,0,12,98,256,354
2017,3,6,0,13,130,258,388
2017,3,6,0,14,140,208,348
2017,3,6,0,15,124,332,456
2017,3,6,0,16,92,515,607
2017,3,6,0,17,133,1083,1216
2017,3,6,0,18,87,863,950
2017,3,6,0,19,58,516,574
2017,3,6,0,20,76,298,374
2017,3,6,0,21,31,194,225
2017,3,6,0,22,29,136,165
2017,3,6,0,23,15,66,81
2017,3,7,1,0,3,18,21
2017,3,7,1,1,0,8,8
2017,3,7,1,2,1,8,9
2017,3,7,1,3,1,2,3
2017,3,7,1,4,2,10,12
2017,3,7,1,5,1,71,72
2017,3,7,1,6,7,270,277
2017,3,7,1,7,37,740,777
2017,3,7,1,8,61,1103,1164
2017,3,7,1,9,46,424,470
2017,3,7,1,10,74,226,300
2017,3,7,1,11,118,284,402
2017,3,7,1,12,112,335,447
2017,3,7,1,13,97,307,404
2017,3,7,1,14,85,269,354
2017,3,7,1,15,129,366,495
2017,3,7,1,16,146,549,695
2017,3,7,1,17,99,880,979
2017,3,7,1,18,64,549,613
2017,3,7,1,19,36,284,320
2017,3,7,1,20,14,153,167
2017,3,7,1,21,18,142,160
2017,3,7,1,22,22,130,152
2017,3,7,1,23,16,66,82
2017,3,8,2,0,4,26,30
2017,3,8,2,1,4,6,10
2017,3,8,2,2,3,7,10
2017,3,8,2,3,0,1,1
2017,3,8,2,4,1,5,6
2017,3,8,2,5,3,67,70
2017,3,8,2,6,13,247,260
2017,3,8,2,7,33,767,800
2017,3,8,2,8,50,1100,1150
2017,3,8,2,9,66,438,504
2017,3,8,2,10,97,221,318
2017,3,8,2,11,130,320,450
2017,3,8,2,12,177,393,570
2017,3,8,2,13,205,373,578
2017,3,8,2,14,193,294,487
2017,3,8,2,15,219,422,641
2017,3,8,2,16,237,647,884
2017,3,8,2,17,207,1159,1366
2017,3,8,2,18,160,948,1108
2017,3,8,2,19,92,546,638
2017,3,8,2,20,64,366,430
2017,3,8,2,21,82,282,364
2017,3,8,2,22,36,162,198
2017,3,8,2,23,17,81,98
2017,3,9,3,0,17,39,56
2017,3,9,3,1,4,17,21
2017,3,9,3,2,4,3,7
2017,3,9,3,3,1,4,5
2017,3,9,3,4,0,12,12
2017,3,9,3,5,4,73,77
2017,3,9,3,6,6,292,298
2017,3,9,3,7,32,836,868
2017,3,9,3,8,72,1216,1288
2017,3,9,3,9,122,482,604
2017,3,9,3,10,141,250,391
2017,3,9,3,11,155,329,484
2017,3,9,3,12,153,441,594
2017,3,9,3,13,243,414,657
2017,3,9,3,14,282,358,640
2017,3,9,3,15,290,457,747
2017,3,9,3,16,289,689,978
2017,3,9,3,17,322,1324,1646
2017,3,9,3,18,162,1044,1206
2017,3,9,3,19,93,581,674
2017,3,9,3,20,82,372,454
2017,3,9,3,21,58,294,352
2017,3,9,3,22,60,168,228
2017,3,9,3,23,33,86,119
2017,3,10,4,0,11,41,52
2017,3,10,4,1,10,16,26
2017,3,10,4,2,5,11,16
2017,3,10,4,3,3,3,6
2017,3,10,4,4,3,7,10
2017,3,10,4,5,4,64,68
2017,3,10,4,6,8,205,213
2017,3,10,4,7,20,605,625
2017,3,10,4,8,49,821,870
2017,3,10,4,9,11,140,151
2017,3,10,4,10,7,59,66
2017,3,10,4,11,14,123,137
2017,3,10,4,12,32,226,258
2017,3,10,4,13,42,239,281
2017,3,10,4,14,59,242,301
2017,3,10,4,15,65,300,365
2017,3,10,4,16,65,425,490
2017,3,10,4,17,52,804,856
2017,3,10,4,18,39,487,526
2017,3,10,4,19,17,229,246
2017,3,10,4,20,22,136,158
2017,3,10,4,21,13,106,119
2017,3,10,4,22,7,80,87
2017,3,10,4,23,6,65,71
2017,3,11,5,0,8,40,48
2017,3,11,5,1,3,23,26
2017,3,11,5,2,4,23,27
2017,3,11,5,3,2,9,11
2017,3,11,5,4,0,4,4
2017,3,11,5,5,1,22,23
2017,3,11,5,6,10,37,47
2017,3,11,5,7,28,140,168
2017,3,11,5,8,44,194,238
2017,3,11,5,9,67,245,312
2017,3,11,5,10,81,322,403
2017,3,11,5,11,107,348,455
2017,3,11,5,12,113,340,453
2017,3,11,5,13,103,322,425
2017,3,11,5,14,104,272,376
2017,3,11,5,15,132,302,434
2017,3,11,5,16,113,279,392
2017,3,11,5,17,154,272,426
2017,3,11,5,18,43,209,252
2017,3,11,5,19,28,172,200
2017,3,11,5,20,15,108,123
2017,3,11,5,21,20,106,126
2017,3,11,5,22,9,73,82
2017,3,11,5,23,2,63,65
2017,3,12,6,0,6,36,42
2017,3,12,6,1,5,29,34
2017,3,12,6,3,3,45,48
2017,3,12,6,4,1,10,11
2017,3,12,6,5,0,7,7
2017,3,12,6,6,1,5,6
2017,3,12,6,7,3,32,35
2017,3,12,6,8,7,52,59
2017,3,12,6,9,14,106,120
2017,3,12,6,10,42,197,239
2017,3,12,6,11,77,275,352
2017,3,12,6,12,107,330,437
2017,3,12,6,13,127,274,401
2017,3,12,6,14,168,339,507
2017,3,12,6,15,184,300,484
2017,3,12,6,16,169,290,459
2017,3,12,6,17,143,326,469
2017,3,12,6,18,100,261,361
2017,3,12,6,19,50,165,215
2017,3,12,6,20,28,104,132
2017,3,12,6,21,23,74,97
2017,3,12,6,22,11,55,66
2017,3,12,6,23,6,34,40
2017,3,13,0,0,1,26,27
2017,3,13,0,1,0,13,13
2017,3,13,0,2,0,2,2
2017,3,13,0,3,0,1,1
2017,3,13,0,4,1,5,6
2017,3,13,0,5,1,61,62
2017,3,13,0,6,3,172,175
2017,3,13,0,7,5,455,460
2017,3,13,0,8,18,821,839
2017,3,13,0,9,35,397,432
2017,3,13,0,10,47,151,198
2017,3,13,0,11,41,157,198
2017,3,13,0,12,70,215,285
2017,3,13,0,13,82,206,288
2017,3,13,0,14,104,210,314
2017,3,13,0,15,131,273,404
2017,3,13,0,16,122,457,579
2017,3,13,0,17,73,836,909
2017,3,13,0,18,65,670,735
2017,3,13,0,19,23,259,282
2017,3,13,0,20,15,129,144
2017,3,13,0,21,6,55,61
2017,3,13,0,22,6,34,40
2017,3,13,0,23,0,16,16
2017,3,14,1,0,1,2,3
2017,3,14,1,1,0,4,4
2017,3,14,1,2,1,0,1
2017,3,14,1,4,0,1,1
2017,3,14,1,5,0,2,2
2017,3,14,1,6,0,6,6
2017,3,14,1,7,0,16,16
2017,3,14,1,8,2,26,28
2017,3,14,1,9,4,46,50
2017,3,14,1,10,7,68,75
2017,3,14,1,11,8,85,93
2017,3,14,1,12,9,62,71
2017,3,14,1,13,9,71,80
2017,3,14,1,14,4,63,67
2017,3,14,1,15,18,81,99
2017,3,14,1,16,12,129,141
2017,3,14,1,17,10,229,239
2017,3,14,1,18,15,237,252
2017,3,14,1,19,5,151,156
2017,3,14,1,20,2,80,82
2017,3,14,1,21,2,57,59
2017,3,14,1,22,1,39,40
2017,3,14,1,23,1,17,18
2017,3,15,2,0,0,8,8
2017,3,15,2,1,0,3,3
2017,3,15,2,2,0,3,3
2017,3,15,2,4,0,3,3
2017,3,15,2,5,0,29,29
2017,3,15,2,6,0,118,118
2017,3,15,2,7,2,244,246
2017,3,15,2,8,2,432,434
2017,3,15,2,9,9,241,250
2017,3,15,2,10,1,120,121
2017,3,15,2,11,3,86,89
2017,3,15,2,12,8,97,105
2017,3,15,2,13,8,97,105
2017,3,15,2,14,8,69,77
2017,3,15,2,15,7,110,117
2017,3,15,2,16,9,228,237
2017,3,15,2,17,14,460,474
2017,3,15,2,18,8,401,409
2017,3,15,2,19,3,216,219
2017,3,15,2,20,4,135,139
2017,3,15,2,21,4,95,99
2017,3,15,2,22,0,51,51
2017,3,15,2,23,0,23,23
2017,3,16,3,0,2,4,6
2017,3,16,3,1,2,7,9
2017,3,16,3,2,3,5,8
2017,3,16,3,3,0,2,2
2017,3,16,3,4,1,3,4
2017,3,16,3,5,2,36,38
2017,3,16,3,6,1,147,148
2017,3,16,3,7,5,331,336
2017,3,16,3,8,14,630,644
2017,3,16,3,9,14,300,314
2017,3,16,3,10,14,119,133
2017,3,16,3,11,11,106,117
2017,3,16,3,12,25,136,161
2017,3,16,3,13,25,151,176
2017,3,16,3,14,28,154,182
2017,3,16,3,15,33,202,235
2017,3,16,3,16,43,353,396
2017,3,16,3,17,58,730,788
2017,3,16,3,18,34,590,624
2017,3,16,3,19,28,304,332
2017,3,16,3,20,10,190,200
2017,3,16,3,21,20,149,169
2017,3,16,3,22,3,108,111
2017,3,16,3,23,5,41,46
2017,3,17,4,0,3,24,27
2017,3,17,4,1,0,7,7
2017,3,17,4,2,1,5,6
2017,3,17,4,3,1,3,4
2017,3,17,4,4,0,9,9
2017,3,17,4,5,0,50,50
2017,3,17,4,6,2,145,147
2017,3,17,4,7,5,372,377
2017,3,17,4,8,27,740,767
2017,3,17,4,9,27,376,403
2017,3,17,4,10,47,181,228
2017,3,17,4,11,68,180,248
2017,3,17,4,12,95,284,379
2017,3,17,4,13,120,278,398
2017,3,17,4,14,136,236,372
2017,3,17,4,15,144,342,486
2017,3,17,4,16,146,490,636
2017,3,17,4,17,161,818,979
2017,3,17,4,18,82,583,665
2017,3,17,4,19,27,339,366
2017,3,17,4,20,21,195,216
2017,3,17,4,21,27,142,169
2017,3,17,4,22,11,135,146
2017,3,17,4,23,11,111,122
2017,3,18,5,0,9,57,66
2017,3,18,5,1,4,34,38
2017,3,18,5,2,9,33,42
2017,3,18,5,3,2,15,17
2017,3,18,5,4,1,7,8
2017,3,18,5,5,1,6,7
2017,3,18,5,6,3,27,30
2017,3,18,5,7,6,64,70
2017,3,18,5,8,15,131,146
2017,3,18,5,9,58,202,260
2017,3,18,5,10,141,282,423
2017,3,18,5,11,218,349,567
2017,3,18,5,12,319,412,731
2017,3,18,5,13,426,437,863
2017,3,18,5,14,558,399,957
2017,3,18,5,15,578,470,1048
2017,3,18,5,16,556,461,1017
2017,3,18,5,17,416,432,848
2017,3,18,5,18,275,342,617
2017,3,18,5,19,72,146,218
2017,3,18,5,20,29,116,145
2017,3,18,5,21,16,73,89
2017,3,18,5,22,4,19,23
2017,3,18,5,23,2,13,15
2017,3,19,6,0,3,21,24
2017,3,19,6,1,4,12,16
2017,3,19,6,2,1,18,19
2017,3,19,6,3,0,4,4
2017,3,19,6,4,2,3,5
2017,3,19,6,5,2,2,4
2017,3,19,6,6,1,4,5
2017,3,19,6,7,7,19,26
2017,3,19,6,8,15,56,71
2017,3,19,6,9,49,132,181
2017,3,19,6,10,90,232,322
2017,3,19,6,11,116,288,404
2017,3,19,6,12,181,329,510
2017,3,19,6,13,209,345,554
2017,3,19,6,14,254,402,656
2017,3,19,6,15,221,384,605
2017,3,19,6,16,244,343,587
2017,3,19,6,17,204,338,542
2017,3,19,6,18,134,291,425
2017,3,19,6,19,64,197,261
2017,3,19,6,20,40,127,167
2017,3,19,6,21,44,97,141
2017,3,19,6,22,32,74,106
2017,3,19,6,23,13,41,54
2017,3,20,0,0,6,17,23
2017,3,20,0,1,2,7,9
2017,3,20,0,2,0,4,4
2017,3,20,0,3,1,3,4
2017,3,20,0,4,1,4,5
2017,3,20,0,5,5,58,63
2017,3,20,0,6,7,218,225
2017,3,20,0,7,25,558,583
2017,3,20,0,8,51,870,921
2017,3,20,0,9,70,395,465
2017,3,20,0,10,120,151,271
2017,3,20,0,11,136,186,322
2017,3,20,0,12,170,293,463
2017,3,20,0,13,174,289,463
2017,3,20,0,14,186,247,433
2017,3,20,0,15,190,338,528
2017,3,20,0,16,174,519,693
2017,3,20,0,17,194,1113,1307
2017,3,20,0,18,122,936,1058
2017,3,20,0,19,65,528,593
2017,3,20,0,20,56,329,385
2017,3,20,0,21,33,217,250
2017,3,20,0,22,28,134,162
2017,3,20,0,23,23,50,73
2017,3,21,1,0,4,23,27
2017,3,21,1,1,3,7,10
2017,3,21,1,2,1,6,7
2017,3,21,1,3,1,0,1
2017,3,21,1,4,0,6,6
2017,3,21,1,5,1,71,72
2017,3,21,1,6,8,288,296
2017,3,21,1,7,21,678,699
2017,3,21,1,8,38,1133,1171
2017,3,21,1,9,53,490,543
2017,3,21,1,10,99,198,297
2017,3,21,1,11,94,205,299
2017,3,21,1,12,101,277,378
2017,3,21,1,13,157,278,435
2017,3,21,1,14,184,252,436
2017,3,21,1,15,202,372,574
2017,3,21,1,16,227,609,836
2017,3,21,1,17,213,1215,1428
2017,3,21,1,18,171,1078,1249
2017,3,21,1,19,112,587,699
2017,3,21,1,20,83,406,489
2017,3,21,1,21,58,292,350
2017,3,21,1,22,45,172,217
2017,3,21,1,23,19,74,93
2017,3,22,2,0,9,30,39
2017,3,22,2,1,7,6,13
2017,3,22,2,2,2,4,6
2017,3,22,2,3,0,3,3
2017,3,22,2,4,2,9,11
2017,3,22,2,5,2,65,67
2017,3,22,2,6,7,273,280
2017,3,22,2,7,19,627,646
2017,3,22,2,8,33,984,1017
2017,3,22,2,9,45,443,488
2017,3,22,2,10,44,195,239
2017,3,22,2,11,64,218,282
2017,3,22,2,12,51,285,336
2017,3,22,2,13,55,266,321
2017,3,22,2,14,83,207,290
2017,3,22,2,15,114,304,418
2017,3,22,2,16,75,477,552
2017,3,22,2,17,110,954,1064
2017,3,22,2,18,70,843,913
2017,3,22,2,19,52,524,576
2017,3,22,2,20,38,266,304
2017,3,22,2,21,30,202,232
2017,3,22,2,22,17,138,155
2017,3,22,2,23,0,61,61
2017,3,23,3,0,3,19,22
2017,3,23,3,1,0,5,5
2017,3,23,3,2,1,8,9
2017,3,23,3,4,1,3,4
2017,3,23,3,5,2,59,61
2017,3,23,3,6,3,228,231
2017,3,23,3,7,19,567,586
2017,3,23,3,8,39,968,1007
2017,3,23,3,9,23,472,495
2017,3,23,3,10,46,173,219
2017,3,23,3,11,67,229,296
2017,3,23,3,12,63,274,337
2017,3,23,3,13,71,273,344
2017,3,23,3,14,96,248,344
2017,3,23,3,15,117,348,465
2017,3,23,3,16,134,529,663
2017,3,23,3,17,152,1021,1173
2017,3,23,3,18,116,856,972
2017,3,23,3,19,68,493,561
2017,3,23,3,20,32,311,343
2017,3,23,3,21,23,234,257
2017,3,23,3,22,17,136,153
2017,3,23,3,23,6,63,69
2017,3,24,4,0,12,25,37
2017,3,24,4,1,0,9,9
2017,3,24,4,2,0,7,7
2017,3,24,4,3,2,4,6
2017,3,24,4,4,1,5,6
2017,3,24,4,5,0,52,52
2017,3,24,4,6,6,202,208
2017,3,24,4,7,26,533,559
2017,3,24,4,8,53,903,956
2017,3,24,4,9,46,432,478
2017,3,24,4,10,10,80,90
2017,3,24,4,11,10,71,81
2017,3,24,4,12,71,242,313
2017,3,24,4,13,129,332,461
2017,3,24,4,14,190,274,464
2017,3,24,4,15,200,412,612
2017,3,24,4,16,209,629,838
2017,3,24,4,17,253,1015,1268
2017,3,24,4,18,211,772,983
2017,3,24,4,19,146,484,630
2017,3,24,4,20,86,270,356
2017,3,24,4,21,71,199,270
2017,3,24,4,22,59,162,221
2017,3,24,4,23,52,129,181
2017,3,25,5,0,38,97,135
2017,3,25,5,1,21,76,97
2017,3,25,5,2,15,45,60
2017,3,25,5,3,11,22,33
2017,3,25,5,4,8,7,15
2017,3,25,5,5,7,9,16
2017,3,25,5,6,19,30,49
2017,3,25,5,7,32,94,126
2017,3,25,5,8,90,221,311
2017,3,25,5,9,267,355,622
2017,3,25,5,10,448,458,906
2017,3,25,5,11,720,585,1305
2017,3,25,5,12,883,616,1499
2017,3,25,5,13,1034,582,1616
2017,3,25,5,14,979,578,1557
2017,3,25,5,15,1030,595,1625
2017,3,25,5,16,883,584,1467
2017,3,25,5,17,808,528,1336
2017,3,25,5,18,588,501,1089
2017,3,25,5,19,390,371,761
2017,3,25,5,20,259,272,531
2017,3,25,5,21,180,216,396
2017,3,25,5,22,188,177,365
2017,3,25,5,23,126,148,274
2017,3,26,6,0,68,86,154
2017,3,26,6,1,24,61,85
2017,3,26,6,2,6,55,61
2017,3,26,6,3,14,17,31
2017,3,26,6,4,5,6,11
2017,3,26,6,5,3,4,7
2017,3,26,6,6,9,14,23
2017,3,26,6,7,27,43,70
2017,3,26,6,8,86,130,216
2017,3,26,6,9,148,185,333
2017,3,26,6,10,176,281,457
2017,3,26,6,11,244,327,571
2017,3,26,6,12,261,373,634
2017,3,26,6,13,272,391,663
2017,3,26,6,14,231,331,562
2017,3,26,6,15,254,359,613
2017,3,26,6,16,196,337,533
2017,3,26,6,17,155,364,519
2017,3,26,6,18,91,275,366
2017,3,26,6,19,63,197,260
2017,3,26,6,20,38,119,157
2017,3,26,6,21,29,106,135
2017,3,26,6,22,34,70,104
2017,3,26,6,23,19,37,56
2017,3,27,0,0,12,25,37
2017,3,27,0,1,1,7,8
2017,3,27,0,2,2,1,3
2017,3,27,0,4,2,6,8
2017,3,27,0,5,5,46,51
2017,3,27,0,6,4,230,234
2017,3,27,0,7,19,520,539
2017,3,27,0,8,47,838,885
2017,3,27,0,9,47,392,439
2017,3,27,0,10,83,181,264
2017,3,27,0,11,123,219,342
2017,3,27,0,12,135,308,443
2017,3,27,0,13,196,311,507
2017,3,27,0,14,293,283,576
2017,3,27,0,15,339,400,739
2017,3,27,0,16,296,632,928
2017,3,27,0,17,322,1334,1656
2017,3,27,0,18,286,1142,1428
2017,3,27,0,19,262,735,997
2017,3,27,0,20,149,461,610
2017,3,27,0,21,83,273,356
2017,3,27,0,22,65,143,208
2017,3,27,0,23,34,75,109
2017,3,28,1,0,23,32,55
2017,3,28,1,1,11,11,22
2017,3,28,1,2,8,6,14
2017,3,28,1,3,6,3,9
2017,3,28,1,4,1,7,8
2017,3,28,1,5,3,69,72
2017,3,28,1,6,17,296,313
2017,3,28,1,7,43,790,833
2017,3,28,1,8,52,967,1019
2017,3,28,1,9,24,264,288
2017,3,28,1,10,43,122,165
2017,3,28,1,11,42,172,214
2017,3,28,1,12,60,194,254
2017,3,28,1,13,104,264,368
2017,3,28,1,14,128,279,407
2017,3,28,1,15,206,430,636
2017,3,28,1,16,203,663,866
2017,3,28,1,17,257,1334,1591
2017,3,28,1,18,201,1111,1312
2017,3,28,1,19,153,645,798
2017,3,28,1,20,85,402,487
2017,3,28,1,21,83,303,386
2017,3,28,1,22,43,175,218
2017,3,28,1,23,26,83,109
2017,3,29,2,0,7,36,43
2017,3,29,2,1,10,9,19
2017,3,29,2,2,3,7,10
2017,3,29,2,3,0,1,1
2017,3,29,2,4,1,8,9
2017,3,29,2,5,7,80,87
2017,3,29,2,6,16,302,318
2017,3,29,2,7,39,804,843
2017,3,29,2,8,62,1170,1232
2017,3,29,2,9,54,521,575
2017,3,29,2,10,137,235,372
2017,3,29,2,11,189,274,463
2017,3,29,2,12,222,418,640
2017,3,29,2,13,249,390,639
2017,3,29,2,14,255,323,578
2017,3,29,2,15,304,427,731
2017,3,29,2,16,328,668,996
2017,3,29,2,17,335,1354,1689
2017,3,29,2,18,326,1094,1420
2017,3,29,2,19,192,707,899
2017,3,29,2,20,117,413,530
2017,3,29,2,21,67,298,365
2017,3,29,2,22,59,166,225
2017,3,29,2,23,17,86,103
2017,3,30,3,0,12,23,35
2017,3,30,3,1,3,8,11
2017,3,30,3,2,2,1,3
2017,3,30,3,3,1,1,2
2017,3,30,3,4,0,6,6
2017,3,30,3,5,4,68,72
2017,3,30,3,6,8,261,269
2017,3,30,3,7,36,702,738
2017,3,30,3,8,80,1090,1170
2017,3,30,3,9,60,455,515
2017,3,30,3,10,99,253,352
2017,3,30,3,11,112,241,353
2017,3,30,3,12,121,341,462
2017,3,30,3,13,130,344,474
2017,3,30,3,14,209,303,512
2017,3,30,3,15,191,373,564
2017,3,30,3,16,170,593,763
2017,3,30,3,17,192,1137,1329
2017,3,30,3,18,138,959,1097
2017,3,30,3,19,85,508,593
2017,3,30,3,20,70,362,432
2017,3,30,3,21,46,243,289
2017,3,30,3,22,31,149,180
2017,3,30,3,23,19,84,103
2017,3,31,4,0,6,29,35
2017,3,31,4,1,4,7,11
2017,3,31,4,2,1,5,6
2017,3,31,4,4,0,8,8
2017,3,31,4,5,0,38,38
2017,3,31,4,6,2,118,120
2017,3,31,4,7,4,118,122
2017,3,31,4,8,18,261,279
2017,3,31,4,9,8,122,130
2017,3,31,4,10,6,31,37
2017,3,31,4,11,1,39,40
2017,3,31,4,12,9,44,53
2017,3,31,4,13,12,92,104
2017,3,31,4,14,34,148,182
2017,3,31,4,15,32,163,195
2017,3,31,4,16,64,349,413
2017,3,31,4,17,69,692,761
2017,3,31,4,18,73,542,615
2017,3,31,4,19,9,135,144
2017,3,31,4,20,15,139,154
2017,3,31,4,21,13,112,125
2017,3,31,4,22,26,102,128
2017,3,31,4,23,15,78,93
