year,month,day,wkday,casual,registered,cnt
2010,9,15,2,1,0,1
2010,9,16,3,1,0,1
2010,9,17,4,2,7,9
2010,9,19,6,1,10,11
2010,9,20,0,34,204,238
2010,9,21,1,109,226,335
2010,9,22,2,117,289,406
2010,9,23,3,124,256,380
2010,9,24,4,156,214,370
2010,9,25,5,267,288,555
2010,9,26,6,230,317,547
2010,9,27,0,65,227,292
2010,9,28,1,102,320,422
2010,9,29,2,77,378,455
2010,9,30,3,22,143,165
2010,10,1,4,164,425,589
2010,10,2,5,397,461,858
2010,10,3,6,223,293,516
2010,10,4,0,58,278,336
2010,10,5,1,86,550,636
2010,10,6,2,94,595,689
2010,10,7,3,163,726,889
2010,10,8,4,219,733,952
2010,10,9,5,572,560,1132
2010,10,10,6,622,492,1114
2010,10,11,0,350,635,985
2010,10,12,1,248,848,1096
2010,10,13,2,238,902,1140
2010,10,14,3,72,511,583
2010,10,15,4,280,876,1156
2010,10,16,5,567,835,1402
2010,10,17,6,599,755,1354
2010,10,18,0,194,957,1151
2010,10,19,1,194,965,1159
2010,10,20,2,167,989,1156
2010,10,21,3,194,1155,1349
2010,10,22,4,238,1155,1393
2010,10,23,5,760,966,1726
2010,10,24,6,718,857,1575
2010,10,25,0,227,1125,1352
2010,10,26,1,267,1305,1572
2010,10,27,2,142,905,1047
2010,10,28,3,358,1356,1714
2010,10,29,4,416,1265,1681
2010,10,30,5,1159,1183,2342
2010,10,31,6,988,990,1978
2010,11,1,0,237,1237,1474
2010,11,2,1,183,1239,1422
2010,11,3,2,180,1327,1507
2010,11,4,3,45,557,602
2010,11,5,4,295,1585,1880
2010,11,6,5,605,1240,1845
2010,11,7,6,395,1047,1442
2010,11,8,0,163,1460,1623
2010,11,9,1,215,1749,1964
2010,11,10,2,226,1849,2075
2010,11,11,3,418,1669,2087
2010,11,12,4,396,1663,2059
2010,11,13,5,916,1384,2300
2010,11,14,6,823,1216,2039
2010,11,15,0,218,1539,1757
2010,11,16,1,62,721,783
2010,11,17,2,180,1768,1948
2010,11,18,3,191,1690,1881
2010,11,19,4,251,1730,1981
2010,11,20,5,839,1547,2386
2010,11,21,6,564,1213,1777
2010,11,22,0,257,1670,1927
2010,11,23,1,161,1628,1789
2010,11,24,2,157,1356,1513
2010,11,25,3,198,371,569
2010,11,26,4,197,595,792
2010,11,27,5,362,590,952
2010,11,28,6,209,749,958
2010,11,29,0,96,1412,1508
2010,11,30,1,94,1183,1277
2010,12,1,2,40,951,991
2010,12,2,3,89,1397,1486
2010,12,3,4,113,1496,1609
2010,12,4,5,247,975,1222
2010,12,5,6,166,853,1019
2010,12,6,0,48,1146,1194
2010,12,7,1,46,1050,1096
2010,12,8,2,59,1093,1152
2010,12,9,3,71,1225,1296
2010,12,10,4,73,1234,1307
2010,12,11,5,184,970,1154
2010,12,12,6,43,385,428
2010,12,13,0,46,1005,1051
2010,12,14,1,38,821,859
2010,12,15,2,43,1019,1062
2010,12,16,3,12,666,678
2010,12,17,4,35,838,873
2010,12,18,5,84,762,846
2010,12,19,6,101,713,814
2010,12,20,0,54,992,1046
2010,12,21,1,50,1011,1061
2010,12,22,2,100,1012,1112
2010,12,23,3,61,686,747
2010,12,24,4,72,280,352
2010,12,25,5,102,89,191
2010,12,26,6,15,77,92
2010,12,27,0,26,282,308
2010,12,28,1,69,636,705
2010,12,29,2,111,835,946
2010,12,30,3,148,973,1121
2010,12,31,4,285,663,948
2011,1,1,5,330,654,984
2011,1,2,6,131,669,800
2011,1,3,0,120,1227,1347
2011,1,4,1,108,1453,1561
2011,1,5,2,82,1515,1597
2011,1,6,3,88,1515,1603
2011,1,7,4,148,1358,1506
2011,1,8,5,68,891,959
2011,1,9,6,54,767,821
2011,1,10,0,41,1278,1319
2011,1,11,1,43,1217,1260
2011,1,12,2,25,1134,1159
2011,1,13,3,37,1362,1399
2011,1,14,4,54,1364,1418
2011,1,15,5,222,1026,1248
2011,1,16,6,251,953,1204
2011,1,17,0,117,883,1000
2011,1,18,1,9,671,680
2011,1,19,2,78,1571,1649
2011,1,20,3,81,1834,1915
2011,1,21,4,73,1464,1537
2011,1,22,5,93,888,981
2011,1,23,6,150,836,986
2011,1,24,0,86,1328,1414
2011,1,25,1,186,1796,1982
2011,1,26,2,34,469,503
2011,1,27,3,15,415,430
2011,1,28,4,38,1127,1165
2011,1,29,5,123,974,1097
2011,1,30,6,140,953,1093
2011,1,31,0,42,1459,1501
2011,2,1,1,47,1313,1360
2011,2,2,2,72,1452,1524
2011,2,3,3,61,1484,1545
2011,2,4,4,88,1617,1705
2011,2,5,5,100,905,1005
2011,2,6,6,354,1266,1620
2011,2,7,0,120,1586,1706
2011,2,8,1,64,1460,1524
2011,2,9,2,52,1545,1597
2011,2,10,3,46,1488,1534
2011,2,11,4,148,1591,1739
2011,2,12,5,288,1183,1471
2011,2,13,6,397,1192,1589
2011,2,14,0,208,1698,1906
2011,2,15,1,139,1669,1808
2011,2,16,2,218,1890,2108
2011,2,17,3,258,2211,2469
2011,2,18,4,578,2344,2922
2011,2,19,5,532,1102,1634
2011,2,20,6,639,1173,1812
2011,2,21,0,195,910,1105
2011,2,22,1,73,1368,1441
2011,2,23,2,139,1769,1908
2011,2,24,3,100,1701,1801
2011,2,25,4,120,1334,1454
2011,2,26,5,424,1544,1968
2011,2,27,6,694,1707,2401
2011,2,28,0,81,1358,1439
2011,3,1,1,137,1706,1843
2011,3,2,2,231,1896,2127
2011,3,3,3,123,1554,1677
2011,3,4,4,214,1722,1936
2011,3,5,5,640,1433,2073
2011,3,6,6,114,490,604
2011,3,7,0,243,1624,1867
2011,3,8,1,315,1808,2123
2011,3,9,2,191,1690,1881
2011,3,10,3,46,574,620
2011,3,11,4,246,1725,1971
2011,3,12,5,724,1408,2132
2011,3,13,6,979,1434,2413
2011,3,14,0,359,1684,2043
2011,3,15,1,289,1757,2046
2011,3,16,2,321,1866,2187
2011,3,17,3,423,2313,2736
2011,3,18,4,883,2344,3227
2011,3,19,5,1423,1689,3112
2011,3,20,6,1047,1421,2468
2011,3,21,0,401,1672,2073
2011,3,22,1,460,2235,2695
2011,3,23,2,203,1914,2117
2011,3,24,3,166,1693,1859
2011,3,25,4,300,1899,2199
2011,3,26,5,981,1514,2495
2011,3,27,6,472,1220,1692
2011,3,28,0,222,1798,2020
2011,3,29,1,317,2103,2420
2011,3,30,2,168,1360,1528
2011,3,31,3,179,1495,1674
2011,4,1,4,307,1909,2216
2011,4,2,5,898,1354,2252
2011,4,3,6,1651,1597,3248
2011,4,4,0,734,2374,3108
2011,4,5,1,167,1619,1786
2011,4,6,2,413,2384,2797
2011,4,7,3,571,2562,3133
2011,4,8,4,172,1295,1467
2011,4,9,5,879,1575,2454
2011,4,10,6,1188,1704,2892
2011,4,11,0,854,2487,3341
2011,4,12,1,257,1768,2025
2011,4,13,2,208,1942,2150
2011,4,14,3,528,2723,3251
2011,4,15,4,642,2473,3115
2011,4,16,5,121,674,795
2011,4,17,6,1555,2186,3741
2011,4,18,0,668,2750,3418
2011,4,19,1,409,2783,3192
2011,4,20,2,612,3321,3933
2011,4,21,3,744,3435,4179
2011,4,22,4,177,1499,1676
2011,4,23,5,1461,2574,4035
2011,4,24,6,1708,2480,4188
2011,4,25,0,772,3290,4062
2011,4,26,1,676,3702,4378
2011,4,27,2,546,3313,3859
2011,4,28,3,568,3476,4044
2011,4,29,4,878,3712,4590
2011,4,30,5,1965,3347,5312
2011,5,1,6,1137,2211,3348
2011,5,2,0,846,3539,4385
2011,5,3,1,603,3834,4437
2011,5,4,2,253,2371,2624
2011,5,5,3,613,3809,4422
2011,5,6,4,892,3702,4594
2011,5,7,5,1612,3098,4710
2011,5,8,6,1401,2931,4332
2011,5,9,0,661,3674,4335
2011,5,10,1,691,4091,4782
2011,5,11,2,549,3623,4172
2011,5,12,3,694,4161,4855
2011,5,13,4,691,3405,4096
2011,5,14,5,900,2502,3402
2011,5,15,6,1582,2970,4552
2011,5,16,0,773,3177,3950
2011,5,17,1,678,3435,4113
2011,5,18,2,535,3308,3843
2011,5,19,3,735,3826,4561
2011,5,20,4,908,3998,4906
2011,5,21,5,2258,3545,5803
2011,5,22,6,1576,3078,4654
2011,5,23,0,834,3435,4269
2011,5,24,1,659,3828,4487
2011,5,25,2,739,4227,4966
2011,5,26,3,757,3908,4665
2011,5,27,4,869,3801,4670
2011,5,28,5,2001,2755,4756
2011,5,29,6,2354,2431,4785
2011,5,30,0,1549,2543,4092
2011,5,31,1,671,3303,3974
2011,6,1,2,512,3453,3965
2011,6,2,3,736,4226,4962
2011,6,3,4,898,4400,5298
2011,6,4,5,1868,3471,5339
2011,6,5,6,1684,3218,4902
2011,6,6,0,673,3865,4538
2011,6,7,1,761,4059,4820
2011,6,8,2,675,3715,4390
2011,6,9,3,562,3349,3911
2011,6,10,4,815,3763,4578
2011,6,11,5,1729,3235,4964
2011,6,12,6,1467,2991,4458
2011,6,13,0,863,4149,5012
2011,6,14,1,727,4152,4879
2011,6,15,2,769,4398,5167
2011,6,16,3,545,3213,3758
2011,6,17,4,862,3970,4832
2011,6,18,5,1807,3311,5118
2011,6,19,6,1638,3104,4742
2011,6,20,0,699,3306,4005
2011,6,21,1,771,4051,4822
2011,6,22,2,659,3835,4494
2011,6,23,3,746,4036,4782
2011,6,24,4,969,4013,4982
2011,6,25,5,1782,3417,5199
2011,6,26,6,1918,3381,5299
2011,6,27,0,853,3845,4698
2011,6,28,1,729,3906,4635
2011,6,29,2,848,4370,5218
2011,6,30,3,1025,4478,5503
2011,7,1,4,1244,4107,5351
2011,7,2,5,2204,2910,5114
2011,7,3,6,2281,2367,4648
2011,7,4,0,3060,2975,6035
2011,7,5,1,1030,3622,4652
2011,7,6,2,784,3835,4619
2011,7,7,3,754,3824,4578
2011,7,8,4,692,3339,4031
2011,7,9,5,1988,3342,5330
2011,7,10,6,1743,3135,4878
2011,7,11,0,721,3357,4078
2011,7,12,1,661,3586,4247
2011,7,13,2,748,3585,4333
2011,7,14,3,888,4183,5071
2011,7,15,4,1318,4210,5528
2011,7,16,5,2418,3503,5921
2011,7,17,6,2006,3291,5297
2011,7,18,0,841,3604,4445
2011,7,19,1,751,3782,4533
2011,7,20,2,644,3679,4323
2011,7,21,3,632,3142,3774
2011,7,22,4,562,2818,3380
2011,7,23,5,987,2295,3282
2011,7,24,6,1049,2556,3605
2011,7,25,0,568,3266,3834
2011,7,26,1,750,3827,4577
2011,7,27,2,753,3891,4644
2011,7,28,3,606,3773,4379
2011,7,29,4,670,3174,3844
2011,7,30,5,1558,2916,4474
2011,7,31,6,1524,2776,4300
2011,8,1,0,729,3526,4255
2011,8,2,1,800,4035,4835
2011,8,3,2,467,3103,3570
2011,8,4,3,799,3770,4569
2011,8,5,4,1023,3835,4858
2011,8,6,5,1521,2771,4292
2011,8,7,6,1298,2483,3781
2011,8,8,0,845,3470,4315
2011,8,9,1,906,3682,4588
2011,8,10,2,884,3883,4767
2011,8,11,3,812,3968,4780
2011,8,12,4,1051,3843,4894
2011,8,13,5,1502,2639,4141
2011,8,14,6,1338,2481,3819
2011,8,15,0,775,3562,4337
2011,8,16,1,721,3994,4715
2011,8,17,2,668,4013,4681
2011,8,18,3,639,3158,3797
2011,8,19,4,797,3348,4145
2011,8,20,5,1914,3276,5190
2011,8,21,6,1249,2622,3871
2011,8,22,0,831,3923,4754
2011,8,23,1,1276,4605,5881
2011,8,24,2,945,4169,5114
2011,8,25,3,435,3098,3533
2011,8,26,4,768,3887,4655
2011,8,27,5,226,889,1115
2011,8,28,6,1414,2917,4331
2011,8,29,0,729,3894,4623
2011,8,30,1,774,4420,5194
2011,8,31,2,688,4359,5047
2011,9,1,3,783,4317,5100
2011,9,2,4,873,3845,4718
2011,9,3,5,1933,2547,4480
2011,9,4,6,2521,2418,4939
2011,9,5,0,1236,2115,3351
2011,9,6,1,204,2494,2698
2011,9,7,2,118,1869,1987
2011,9,8,3,153,1677,1830
2011,9,9,4,417,3117,3534
2011,9,10,5,1747,3593,5340
2011,9,11,6,1633,3405,5038
2011,9,12,0,688,4013,4701
2011,9,13,1,699,4047,4746
2011,9,14,2,646,4130,4776
2011,9,15,3,428,3218,3646
2011,9,16,4,742,4000,4742
2011,9,17,5,1432,3077,4509
2011,9,18,6,1353,2921,4274
2011,9,19,0,690,3836,4526
2011,9,20,1,438,3195,3633
2011,9,21,2,538,3805,4343
2011,9,22,3,555,4229,4784
2011,9,23,4,258,2128,2386
2011,9,24,5,1776,3640,5416
2011,9,25,6,1544,3464,5008
2011,9,26,0,684,3936,4620
2011,9,27,1,477,3630,4107
2011,9,28,2,480,3422,3902
2011,9,29,3,653,4183,4836
2011,9,30,4,830,4359,5189
2011,10,1,5,478,1946,2424
2011,10,2,6,616,2302,2918
2011,10,3,0,330,3232,3562
2011,10,4,1,486,3957,4443
2011,10,5,2,559,4256,4815
2011,10,6,3,639,4112,4751
2011,10,7,4,949,4022,4971
2011,10,8,5,2235,3173,5408
2011,10,9,6,2397,3112,5509
2011,10,10,0,1514,3596,5110
2011,10,11,1,666,3884,4550
2011,10,12,2,217,2190,2407
2011,10,13,3,290,2613,2903
2011,10,14,4,528,3106,3634
2011,10,15,5,1899,3315,5214
2011,10,16,6,1748,3291,5039
2011,10,17,0,713,3852,4565
2011,10,18,1,635,4101,4736
2011,10,19,2,254,2163,2417
2011,10,20,3,471,3715,4186
2011,10,21,4,676,3620,4296
2011,10,22,5,1499,2807,4306
2011,10,23,6,1618,2761,4379
2011,10,24,0,699,3478,4177
2011,10,25,1,693,3983,4676
2011,10,26,2,404,3482,3886
2011,10,27,3,240,2412,2652
2011,10,28,4,456,3288,3744
2011,10,29,5,57,570,627
2011,10,30,6,885,2442,3327
2011,10,31,0,362,3299,3661
2011,11,1,1,410,3651,4061
2011,11,2,2,368,3808,4176
2011,11,3,3,318,3643,3961
2011,11,4,4,470,3569,4039
2011,11,5,5,1155,2765,3920
2011,11,6,6,952,2696,3648
2011,11,7,0,372,3652,4024
2011,11,8,1,376,3821,4197
2011,11,9,2,305,3802,4107
2011,11,10,3,190,2736,2926
2011,11,11,4,440,2920,3360
2011,11,12,5,1275,2790,4065
2011,11,13,6,1004,2709,3713
2011,11,14,0,595,3874,4469
2011,11,15,1,449,3735,4184
2011,11,16,2,145,1668,1813
2011,11,17,3,139,2905,3044
2011,11,18,4,243,3143,3386
2011,11,19,5,941,2715,3656
2011,11,20,6,787,2727,3514
2011,11,21,0,220,2542,2762
2011,11,22,1,69,1532,1601
2011,11,23,2,112,2451,2563
2011,11,24,3,560,934,1494
2011,11,25,4,1095,1693,2788
2011,11,26,5,1249,1817,3066
2011,11,27,6,808,2257,3065
2011,11,28,0,253,3601,3854
2011,11,29,1,96,2809,2905
2011,11,30,2,188,3417,3605
2011,12,1,3,182,3530,3712
2011,12,2,4,268,3661,3929
2011,12,3,5,706,2905,3611
2011,12,4,6,634,2849,3483
2011,12,5,0,233,3567,3800
2011,12,6,1,126,2460,2586
2011,12,7,2,50,652,702
2011,12,8,3,150,3163,3313
2011,12,9,4,261,3349,3610
2011,12,10,5,502,2682,3184
2011,12,11,6,376,2364,2740
2011,12,12,0,143,3149,3292
2011,12,13,1,154,3356,3510
2011,12,14,2,178,3547,3725
2011,12,15,3,181,3517,3698
2011,12,16,4,178,3378,3556
2011,12,17,5,275,2459,2734
2011,12,18,6,220,2205,2425
2011,12,19,0,260,3135,3395
2011,12,20,1,216,3525,3741
2011,12,21,2,107,2547,2654
2011,12,22,3,227,2833,3060
2011,12,23,4,163,2039,2202
2011,12,24,5,155,855,1010
2011,12,25,6,303,451,754
2011,12,26,0,430,886,1316
2011,12,27,1,103,1054,1157
2011,12,28,2,255,2042,2297
2011,12,29,3,254,2162,2416
2011,12,30,4,491,2500,2991
2011,12,31,5,665,1819,2484
2012,1,1,6,686,1608,2294
2012,1,2,0,244,1706,1950
2012,1,3,1,89,2144,2233
2012,1,4,2,95,2272,2367
2012,1,5,3,140,3129,3269
2012,1,6,4,304,3787,4091
2012,1,7,5,1069,3451,4520
2012,1,8,6,599,2825,3424
2012,1,9,0,106,2264,2370
2012,1,10,1,173,3419,3592
2012,1,11,2,92,2082,2174
2012,1,12,3,269,3822,4091
2012,1,13,4,173,3034,3207
2012,1,14,5,333,2158,2491
2012,1,15,6,283,2023,2306
2012,1,16,0,217,2078,2295
2012,1,17,1,126,2805,2931
2012,1,18,2,109,3261,3370
2012,1,19,3,130,3155,3285
2012,1,20,4,114,3042,3156
2012,1,21,5,67,1233,1300
2012,1,22,6,196,1779,1975
2012,1,23,0,145,2284,2429
2012,1,24,1,439,3888,4327
2012,1,25,2,467,3792,4259
2012,1,26,3,243,3817,4060
2012,1,27,4,269,3180,3449
2012,1,28,5,775,3244,4019
2012,1,29,6,556,2684,3240
2012,1,30,0,126,3489,3615
2012,1,31,1,324,4177,4501
2012,2,1,2,304,4270,4574
2012,2,2,3,190,3564,3754
2012,2,3,4,310,3836,4146
2012,2,4,5,384,2447,2831
2012,2,5,6,317,2627,2944
2012,2,6,0,206,3573,3779
2012,2,7,1,199,4164,4363
2012,2,8,2,107,2687,2794
2012,2,9,3,161,3663,3824
2012,2,10,4,225,3597,3822
2012,2,11,5,192,1976,2168
2012,2,12,6,73,1456,1529
2012,2,13,0,94,3325,3419
2012,2,14,1,131,3778,3909
2012,2,15,2,141,4019,4160
2012,2,16,3,74,2926,3000
2012,2,17,4,349,3796,4145
2012,2,18,5,1435,2881,4316
2012,2,19,6,618,2071,2689
2012,2,20,0,502,2625,3127
2012,2,21,1,163,3608,3771
2012,2,22,2,394,4373,4767
2012,2,23,3,515,4533,5048
2012,2,24,4,246,3234,3480
2012,2,25,5,317,2415,2732
2012,2,26,6,515,2874,3389
2012,2,27,0,253,4064,4317
2012,2,28,1,229,4124,4353
2012,2,29,2,65,1764,1829
2012,3,1,3,325,4653,4978
2012,3,2,4,245,2945,3190
2012,3,3,5,956,3105,4061
2012,3,4,6,710,2708,3418
2012,3,5,0,203,3128,3331
2012,3,6,1,220,3726,3946
2012,3,7,2,432,4475,4907
2012,3,8,3,486,4888,5374
2012,3,9,4,447,4114,4561
2012,3,10,5,968,3148,4116
2012,3,11,6,1658,3248,4906
2012,3,12,0,838,4452,5290
2012,3,13,1,761,5072,5833
2012,3,14,2,997,5308,6305
2012,3,15,3,1005,5178,6183
2012,3,16,4,548,3820,4368
2012,3,17,5,3155,4677,7832
2012,3,18,6,2207,3683,5890
2012,3,19,0,982,5164,6146
2012,3,20,1,1051,5037,6088
2012,3,21,2,1121,5100,6221
2012,3,22,3,1334,5525,6859
2012,3,23,4,2467,5884,8351
2012,3,24,5,1033,2334,3367
2012,3,25,6,1532,3461,4993
2012,3,26,0,795,4754,5549
2012,3,27,1,531,4562,5093
2012,3,28,2,674,5018,5692
2012,3,29,3,834,5292,6126
2012,3,30,4,791,4656,5447
2012,3,31,5,2301,3932,6233
2012,4,1,6,2347,3691,6038
2012,4,2,0,1208,4712,5920
2012,4,3,1,1348,5409,6757
2012,4,4,2,1058,5361,6419
2012,4,5,3,1192,5249,6441
2012,4,6,4,1807,4646,6453
2012,4,7,5,3252,3603,6855
2012,4,8,6,2230,2938,5168
2012,4,9,0,905,4671,5576
2012,4,10,1,819,5088,5907
2012,4,11,2,482,4367,4849
2012,4,12,3,663,4733,5396
2012,4,13,4,1252,5137,6389
2012,4,14,5,2795,4663,7458
2012,4,15,6,2846,4278,7124
2012,4,16,0,1197,5164,6361
2012,4,17,1,987,5684,6671
2012,4,18,2,347,4013,4360
2012,4,19,3,845,5702,6547
2012,4,20,4,1339,5934,7273
2012,4,21,5,2541,4080,6621
2012,4,22,6,120,903,1023
2012,4,23,0,194,3010,3204
2012,4,24,1,516,5105,5621
2012,4,25,2,655,5532,6187
2012,4,26,3,475,4545,5020
2012,4,27,4,1013,5212,6225
2012,4,28,5,1120,3100,4220
2012,4,29,6,2229,4073,6302
2012,4,30,0,665,4904,5569
2012,5,1,1,653,5080,5733
2012,5,2,2,667,5491,6158
2012,5,3,3,764,5651,6415
2012,5,4,4,1068,5220,6288
2012,5,5,5,2496,4387,6883
2012,5,6,6,2135,4220,6355
2012,5,7,0,1007,5260,6267
2012,5,8,1,736,4983,5719
2012,5,9,2,620,4090,4710
2012,5,10,3,1026,5537,6563
2012,5,11,4,1317,5702,7019
2012,5,12,5,2622,4805,7427
2012,5,13,6,2171,3945,6116
2012,5,14,0,342,2500,2842
2012,5,15,1,625,4484,5109
2012,5,16,2,991,6422,7413
2012,5,17,3,1241,6130,7371
2012,5,18,4,1521,6110,7631
2012,5,19,5,3410,4882,8292
2012,5,20,6,2702,4422,7124
2012,5,21,0,630,3725,4355
2012,5,22,1,819,5241,6060
2012,5,23,2,766,4483,5249
2012,5,24,3,1059,5700,6759
2012,5,25,4,1417,5303,6720
2012,5,26,5,2855,3678,6533
2012,5,27,6,3283,3305,6588
2012,5,28,0,2557,3481,6038
2012,5,29,1,878,4855,5733
2012,5,30,2,745,6095,6840
2012,5,31,3,1099,6229,7328
2012,6,1,4,531,3587,4118
2012,6,2,5,2795,5323,8118
2012,6,3,6,2494,5147,7641
2012,6,4,0,1071,5923,6994
2012,6,5,1,967,6030,6997
2012,6,6,2,1026,6022,7048
2012,6,7,3,1038,6451,7489
2012,6,8,4,1488,6242,7730
2012,6,9,5,2707,4789,7496
2012,6,10,6,2223,4372,6595
2012,6,11,0,1016,5639,6655
2012,6,12,1,477,4484,4961
2012,6,13,2,1173,6243,7416
2012,6,14,3,1180,6179,7359
2012,6,15,4,1563,6093,7656
2012,6,16,5,2962,4736,7698
2012,6,17,6,2634,4334,6968
2012,6,18,0,652,4440,5092
2012,6,19,1,967,5845,6812
2012,6,20,2,870,5326,6196
2012,6,21,3,776,5115,5891
2012,6,22,4,961,4849,5810
2012,6,23,5,2655,4797,7452
2012,6,24,6,2551,4338,6889
2012,6,25,0,1139,5630,6769
2012,6,26,1,1077,6348,7425
2012,6,27,2,1077,6246,7323
2012,6,28,3,921,5947,6868
2012,6,29,4,829,4626,5455
2012,6,30,5,1454,4225,5679
2012,7,1,6,1421,4110,5531
2012,7,2,0,904,5323,6227
2012,7,3,1,1052,5608,6660
2012,7,4,2,2562,4841,7403
2012,7,5,3,1405,4836,6241
2012,7,6,4,1366,4841,6207
2012,7,7,5,1448,3392,4840
2012,7,8,6,1203,3469,4672
2012,7,9,0,998,5571,6569
2012,7,10,1,954,5336,6290
2012,7,11,2,975,6289,7264
2012,7,12,3,1032,6414,7446
2012,7,13,4,1511,5988,7499
2012,7,14,5,2355,4614,6969
2012,7,15,6,1920,4111,6031
2012,7,16,0,1088,5742,6830
2012,7,17,1,921,5865,6786
2012,7,18,2,799,4914,5713
2012,7,19,3,888,5703,6591
2012,7,20,4,747,5123,5870
2012,7,21,5,1264,3195,4459
2012,7,22,6,2544,4866,7410
2012,7,23,0,1135,5831,6966
2012,7,24,1,1140,6452,7592
2012,7,25,2,1383,6790,8173
2012,7,26,3,1036,5825,6861
2012,7,27,4,1259,5645,6904
2012,7,28,5,2234,4451,6685
2012,7,29,6,2153,4444,6597
2012,7,30,0,1040,6065,7105
2012,7,31,1,968,6248,7216
2012,8,1,2,1074,6506,7580
2012,8,2,3,983,6278,7261
2012,8,3,4,1328,5847,7175
2012,8,4,5,2345,4479,6824
2012,8,5,6,1707,3757,5464
2012,8,6,0,1233,5780,7013
2012,8,7,1,1278,5995,7273
2012,8,8,2,1263,6271,7534
2012,8,9,3,1196,6090,7286
2012,8,10,4,1065,4721,5786
2012,8,11,5,2247,4052,6299
2012,8,12,6,2182,4362,6544
2012,8,13,0,1207,5676,6883
2012,8,14,1,1128,5656,6784
2012,8,15,2,1198,6149,7347
2012,8,16,3,1338,6267,7605
2012,8,17,4,1483,5665,7148
2012,8,18,5,2827,5038,7865
2012,8,19,6,1208,3341,4549
2012,8,20,0,1026,5504,6530
2012,8,21,1,1081,5925,7006
2012,8,22,2,1094,6281,7375
2012,8,23,3,1363,6402,7765
2012,8,24,4,1325,6257,7582
2012,8,25,5,1829,4224,6053
2012,8,26,6,1483,3772,5255
2012,8,27,0,989,5928,6917
2012,8,28,1,935,6105,7040
2012,8,29,2,1177,6520,7697
2012,8,30,3,1172,6541,7713
2012,8,31,4,1433,5917,7350
2012,9,1,5,2352,3788,6140
2012,9,2,6,2613,3197,5810
2012,9,3,0,1965,4069,6034
2012,9,4,1,867,5997,6864
2012,9,5,2,832,6280,7112
2012,9,6,3,611,5592,6203
2012,9,7,4,1045,6459,7504
2012,9,8,5,1557,4419,5976
2012,9,9,6,2570,5657,8227
2012,9,10,0,1118,6407,7525
2012,9,11,1,1070,6697,7767
2012,9,12,2,1050,6820,7870
2012,9,13,3,1054,6750,7804
2012,9,14,4,1379,6630,8009
2012,9,15,5,3160,5554,8714
2012,9,16,6,2166,5167,7333
2012,9,17,0,1022,5847,6869
2012,9,18,1,371,3702,4073
2012,9,19,2,788,6803,7591
2012,9,20,3,939,6781,7720
2012,9,21,4,1250,6917,8167
2012,9,22,5,2512,5883,8395
2012,9,23,6,2454,5453,7907
2012,9,24,0,1001,6435,7436
2012,9,25,1,845,6693,7538
2012,9,26,2,787,6946,7733
2012,9,27,3,751,6642,7393
2012,9,28,4,1045,6370,7415
2012,9,29,5,2589,5966,8555
2012,9,30,6,2015,4874,6889
2012,10,1,0,763,6015,6778
2012,10,2,1,315,4324,4639
2012,10,3,2,728,6844,7572
2012,10,4,3,891,6437,7328
2012,10,5,4,1516,6640,8156
2012,10,6,5,3031,4934,7965
2012,10,7,6,781,2729,3510
2012,10,8,0,874,4604,5478
2012,10,9,1,601,5791,6392
2012,10,10,2,780,6911,7691
2012,10,11,3,834,6736,7570
2012,10,12,4,1060,6222,7282
2012,10,13,5,2252,4857,7109
2012,10,14,6,2080,4559,6639
2012,10,15,0,760,5115,5875
2012,10,16,1,922,6612,7534
2012,10,17,2,979,6482,7461
2012,10,18,3,1008,6501,7509
2012,10,19,4,753,4671,5424
2012,10,20,5,2806,5284,8090
2012,10,21,6,2132,4692,6824
2012,10,22,0,830,6228,7058
2012,10,23,1,841,6625,7466
2012,10,24,2,795,6898,7693
2012,10,25,3,875,6484,7359
2012,10,26,4,1182,6262,7444
2012,10,27,5,2643,5209,7852
2012,10,28,6,998,3461,4459
2012,10,29,0,2,20,22
2012,10,30,1,87,1009,1096
2012,10,31,2,419,5147,5566
2012,11,1,3,466,5520,5986
2012,11,2,4,618,5229,5847
2012,11,3,5,1029,4109,5138
2012,11,4,6,1201,3906,5107
2012,11,5,0,378,4881,5259
2012,11,6,1,466,5220,5686
2012,11,7,2,326,4709,5035
2012,11,8,3,340,4975,5315
2012,11,9,4,709,5283,5992
2012,11,10,5,2090,4446,6536
2012,11,11,6,2290,4562,6852
2012,11,12,0,1097,5172,6269
2012,11,13,1,327,3767,4094
2012,11,14,2,373,5122,5495
2012,11,15,3,320,5125,5445
2012,11,16,4,484,5214,5698
2012,11,17,5,1313,4316,5629
2012,11,18,6,922,3747,4669
2012,11,19,0,449,5050,5499
2012,11,20,1,534,5100,5634
2012,11,21,2,615,4531,5146
2012,11,22,3,955,1470,2425
2012,11,23,4,1603,2307,3910
2012,11,24,5,532,1745,2277
2012,11,25,6,309,2115,2424
2012,11,26,0,337,4750,5087
2012,11,27,1,123,3836,3959
2012,11,28,2,198,5062,5260
2012,11,29,3,243,5080,5323
2012,11,30,4,362,5306,5668
2012,12,1,5,951,4240,5191
2012,12,2,6,892,3757,4649
2012,12,3,0,555,5679,6234
2012,12,4,1,551,6055,6606
2012,12,5,2,331,5398,5729
2012,12,6,3,340,5035,5375
2012,12,7,4,349,4659,5008
2012,12,8,5,1153,4429,5582
2012,12,9,6,441,2787,3228
2012,12,10,0,329,4841,5170
2012,12,11,1,282,5219,5501
2012,12,12,2,310,5009,5319
2012,12,13,3,425,5107,5532
2012,12,14,4,429,5182,5611
2012,12,15,5,767,4280,5047
2012,12,16,6,538,3248,3786
2012,12,17,0,212,4373,4585
2012,12,18,1,433,5124,5557
2012,12,19,2,333,4934,5267
2012,12,20,3,314,3814,4128
2012,12,21,4,221,3402,3623
2012,12,22,5,205,1544,1749
2012,12,23,6,408,1379,1787
2012,12,24,0,174,746,920
2012,12,25,1,440,573,1013
2012,12,26,2,9,432,441
2012,12,27,3,247,1867,2114
2012,12,28,4,644,2451,3095
2012,12,29,5,159,1182,1341
2012,12,30,6,364,1432,1796
2012,12,31,0,439,2290,2729
2013,1,1,1,421,1564,1985
2013,1,2,2,284,3419,3703
2013,1,3,3,297,3576,3873
2013,1,4,4,297,3821,4118
2013,1,5,5,509,3053,3562
2013,1,6,6,586,3204,3790
2013,1,7,0,332,4442,4774
2013,1,8,1,442,4869,5311
2013,1,9,2,356,4791,5147
2013,1,10,3,359,5056,5415
2013,1,11,4,254,3896,4150
2013,1,12,5,1240,4388,5628
2013,1,13,6,835,3310,4145
2013,1,14,0,444,4615,5059
2013,1,15,1,224,2699,2923
2013,1,16,2,197,3314,3511
2013,1,17,3,362,4455,4817
2013,1,18,4,340,4172,4512
2013,1,19,5,1199,3775,4974
2013,1,20,6,1657,4111,5768
2013,1,21,0,1027,3547,4574
2013,1,22,1,89,2862,2951
2013,1,23,2,69,3151,3220
2013,1,24,3,20,2428,2448
2013,1,25,4,44,2331,2375
2013,1,26,5,179,2586,2765
2013,1,27,6,263,2769,3032
2013,1,28,0,65,2668,2733
2013,1,29,1,321,5513,5834
2013,1,30,2,182,4505,4687
2013,1,31,3,120,4238,4358
2013,2,1,4,84,3117,3201
2013,2,2,5,233,2240,2473
2013,2,3,6,185,2401,2586
2013,2,4,0,122,3824,3946
2013,2,5,1,151,4462,4613
2013,2,6,2,179,4736,4915
2013,2,7,3,175,4313,4488
2013,2,8,4,146,3244,3390
2013,2,9,5,425,3041,3466
2013,2,10,6,501,3112,3613
2013,2,11,0,151,4117,4268
2013,2,12,1,281,5399,5680
2013,2,13,2,171,3385,3556
2013,2,14,3,355,4815,5170
2013,2,15,4,683,4675,5358
2013,2,16,5,679,2560,3239
2013,2,17,6,483,2025,2508
2013,2,18,0,535,2826,3361
2013,2,19,1,163,3797,3960
2013,2,20,2,191,4192,4383
2013,2,21,3,187,3960,4147
2013,2,22,4,123,3439,3562
2013,2,23,5,211,2364,2575
2013,2,24,6,848,3530,4378
2013,2,25,0,333,4669,5002
2013,2,26,1,149,2635,2784
2013,2,27,2,363,5077,5440
2013,2,28,3,297,4831,5128
2013,3,1,4,329,4612,4941
2013,3,2,5,674,3067,3741
2013,3,3,6,475,2620,3095
2013,3,4,0,311,4143,4454
2013,3,5,1,444,4773,5217
2013,3,6,2,79,1057,1136
2013,3,7,3,315,4728,5043
2013,3,8,4,411,4459,4870
2013,3,9,5,2168,4667,6835
2013,3,10,6,2328,4501,6829
2013,3,11,0,1027,5060,6087
2013,3,12,1,449,3840,4289
2013,3,13,2,626,5116,5742
2013,3,14,3,440,4441,4881
2013,3,15,4,1201,5183,6384
2013,3,16,5,1813,4434,6247
2013,3,17,6,982,3002,3984
2013,3,18,0,248,2520,2768
2013,3,19,1,674,5327,6001
2013,3,20,2,556,5331,5887
2013,3,21,3,308,4233,4541
2013,3,22,4,682,4770,5452
2013,3,23,5,2473,4070,6543
2013,3,24,6,1109,2779,3888
2013,3,25,0,84,1849,1933
2013,3,26,1,647,4980,5627
2013,3,27,2,646,5210,5856
2013,3,28,3,699,4941,5640
2013,3,29,4,1969,5474,7443
2013,3,30,5,5008,4656,9664
2013,3,31,6,1401,2420,3821
2013,4,1,0,1304,5116,6420
2013,4,2,1,738,5208,5946
2013,4,3,2,929,5358,6287
2013,4,4,3,904,4968,5872
2013,4,5,4,1559,6120,7679
2013,4,6,5,4099,5247,9346
2013,4,7,6,4428,5402,9830
2013,4,8,0,1951,6599,8550
2013,4,9,1,2138,7700,9838
2013,4,10,2,1965,7674,9639
2013,4,11,3,1886,7280,9166
2013,4,12,4,1173,4891,6064
2013,4,13,5,5376,5993,11369
2013,4,14,6,4373,5322,9695
2013,4,15,0,1289,5690,6979
2013,4,16,1,1519,6796,8315
2013,4,17,2,1363,7200,8563
2013,4,18,3,1195,6566,7761
2013,4,19,4,1083,5095,6178
2013,4,20,5,3412,5470,8882
2013,4,21,6,2512,4889,7401
2013,4,22,0,780,6014,6794
2013,4,23,1,948,6561,7509
2013,4,24,2,1306,7246,8552
2013,4,25,3,1350,6982,8332
2013,4,26,4,1844,7230,9074
2013,4,27,5,4947,5957,10904
2013,4,28,6,3336,4585,7921
2013,4,29,0,480,3853,4333
2013,4,30,1,604,4801,5405
2013,5,1,2,1197,7494,8691
2013,5,2,3,1323,7269,8592
2013,5,3,4,1774,6967,8741
2013,5,4,5,3651,5935,9586
2013,5,5,6,2934,5146,8080
2013,5,6,0,1065,5500,6565
2013,5,7,1,344,4118,4462
2013,5,8,2,821,5848,6669
2013,5,9,3,1122,6748,7870
2013,5,10,4,1979,6978,8957
2013,5,11,5,2099,4432,6531
2013,5,12,6,3084,5019,8103
2013,5,13,0,1064,6377,7441
2013,5,14,1,1264,6858,8122
2013,5,15,2,1321,7505,8826
2013,5,16,3,1524,7448,8972
2013,5,17,4,2544,7611,10155
2013,5,18,5,1926,4479,6405
2013,5,19,6,2080,4654,6734
2013,5,20,0,1625,6829,8454
2013,5,21,1,1648,7455,9103
2013,5,22,2,1401,7586,8987
2013,5,23,3,1288,6848,8136
2013,5,24,4,1004,5694,6698
2013,5,25,5,3621,4418,8039
2013,5,26,6,5654,4306,9960
2013,5,27,0,4453,4614,9067
2013,5,28,1,1588,6017,7605
2013,5,29,2,1736,7621,9357
2013,5,30,3,1370,7455,8825
2013,5,31,4,1835,7355,9190
2013,6,1,5,3657,5911,9568
2013,6,2,6,2998,4748,7746
2013,6,3,0,1442,6033,7475
2013,6,4,1,1852,8180,10032
2013,6,5,2,1910,8165,10075
2013,6,6,3,1223,5702,6925
2013,6,7,4,242,2267,2509
2013,6,8,5,3575,6288,9863
2013,6,9,6,3434,5907,9341
2013,6,10,0,714,3715,4429
2013,6,11,1,1739,7532,9271
2013,6,12,2,1586,7683,9269
2013,6,13,3,1166,6174,7340
2013,6,14,4,2214,7686,9900
2013,6,15,5,4202,6344,10546
2013,6,16,6,3534,5282,8816
2013,6,17,0,1730,6973,8703
2013,6,18,1,940,6268,7208
2013,6,19,2,1802,8334,10136
2013,6,20,3,1795,8472,10267
2013,6,21,4,2367,8055,10422
2013,6,22,5,4403,6510,10913
2013,6,23,6,2405,4871,7276
2013,6,24,0,1470,6664,8134
2013,6,25,1,1559,7717,9276
2013,6,26,2,1312,7299,8611
2013,6,27,3,1302,7587,8889
2013,6,28,4,1061,5316,6377
2013,6,29,5,3973,6647,10620
2013,6,30,6,2405,4776,7181
2013,7,1,0,1374,6570,7944
2013,7,2,1,1286,6667,7953
2013,7,3,2,1603,6215,7818
2013,7,4,3,5222,5610,10832
2013,7,5,4,4785,5867,10652
2013,7,6,5,4295,4686,8981
2013,7,7,6,2490,4459,6949
2013,7,8,0,1323,6849,8172
2013,7,9,1,1197,7651,8848
2013,7,10,2,1118,7091,8209
2013,7,11,3,1384,7558,8942
2013,7,12,4,1006,4786,5792
2013,7,13,5,3224,6148,9372
2013,7,14,6,2798,5699,8497
2013,7,15,0,1343,6765,8108
2013,7,16,1,1304,7211,8515
2013,7,17,2,1341,7379,8720
2013,7,18,3,1121,6781,7902
2013,7,19,4,1512,6575,8087
2013,7,20,5,3129,5577,8706
2013,7,21,6,3132,5406,8538
2013,7,22,0,1578,7218,8796
2013,7,23,1,1513,7822,9335
2013,7,24,2,1707,8149,9856
2013,7,25,3,1908,8320,10228
2013,7,26,4,2244,8126,10370
2013,7,27,5,3175,5299,8474
2013,7,28,6,2863,5379,8242
2013,7,29,0,1915,7413,9328
2013,7,30,1,1955,8025,9980
2013,7,31,2,1468,7305,8773
2013,8,1,3,1178,6666,7844
2013,8,2,4,2359,7581,9940
2013,8,3,5,3316,5216,8532
2013,8,4,6,4317,6194,10511
2013,8,5,0,2345,7817,10162
2013,8,6,1,1547,6922,8469
2013,8,7,2,1931,7896,9827
2013,8,8,3,1538,7434,8972
2013,8,9,4,2152,7393,9545
2013,8,10,5,4131,6031,10162
2013,8,11,6,3876,5720,9596
2013,8,12,0,2154,7459,9613
2013,8,13,1,1591,6804,8395
2013,8,14,2,1999,8498,10497
2013,8,15,3,2192,8608,10800
2013,8,16,4,2796,8093,10889
2013,8,17,5,4740,6428,11168
2013,8,18,6,1750,4085,5835
2013,8,19,0,1847,7219,9066
2013,8,20,1,1726,7966,9692
2013,8,21,2,1647,7594,9241
2013,8,22,3,1861,7789,9650
2013,8,23,4,1158,6541,7699
2013,8,24,5,3783,7207,10990
2013,8,25,6,3327,6257,9584
2013,8,26,0,1687,7698,9385
2013,8,27,1,1538,8084,9622
2013,8,28,2,993,6742,7735
2013,8,29,3,1646,7789,9435
2013,8,30,4,2306,7442,9748
2013,8,31,5,4365,5114,9479
2013,9,1,6,4697,4603,9300
2013,9,2,0,3201,4921,8122
2013,9,3,1,1374,7570,8944
2013,9,4,2,1532,8294,9826
2013,9,5,3,1575,8432,10007
2013,9,6,4,1814,8444,10258
2013,9,7,5,3211,7025,10236
2013,9,8,6,3035,6481,9516
2013,9,9,0,1382,7759,9141
2013,9,10,1,1436,8134,9570
2013,9,11,2,1271,7996,9267
2013,9,12,3,946,6133,7079
2013,9,13,4,1590,8466,10056
2013,9,14,5,3946,7323,11269
2013,9,15,6,3204,6651,9855
2013,9,16,0,1085,7274,8359
2013,9,17,1,1269,8699,9968
2013,9,18,2,1298,8761,10059
2013,9,19,3,1637,8824,10461
2013,9,20,4,1909,8767,10676
2013,9,21,5,2150,4769,6919
2013,9,22,6,2750,6692,9442
2013,9,23,0,1272,7795,9067
2013,9,24,1,1144,8462,9606
2013,9,25,2,1169,8446,9615
2013,9,26,3,1293,8600,9893
2013,9,27,4,1635,8354,9989
2013,9,28,5,3504,6686,10190
2013,9,29,6,3082,6283,9365
2013,9,30,0,1338,7794,9132
2013,10,1,1,1339,9019,10358
2013,10,2,2,1289,9096,10385
2013,10,3,3,1248,8909,10157
2013,10,4,4,1667,8596,10263
2013,10,5,5,3401,7185,10586
2013,10,6,6,2992,6784,9776
2013,10,7,0,421,5459,5880
2013,10,8,1,1278,8666,9944
2013,10,9,2,757,5681,6438
2013,10,10,3,180,2352,2532
2013,10,11,4,117,1683,1800
2013,10,12,5,1300,3961,5261
2013,10,13,6,1523,4504,6027
2013,10,14,0,1830,7110,8940
2013,10,15,1,1031,8350,9381
2013,10,16,2,1114,8615,9729
2013,10,17,3,1049,8499,9548
2013,10,18,4,1871,8502,10373
2013,10,19,5,3192,6223,9415
2013,10,20,6,2542,6052,8594
2013,10,21,0,1331,7725,9056
2013,10,22,1,736,8338,9074
2013,10,23,2,616,7354,7970
2013,10,24,3,592,7305,7897
2013,10,25,4,913,7040,7953
2013,10,26,5,2195,5788,7983
2013,10,27,6,2381,5641,8022
2013,10,28,0,1177,7426,8603
2013,10,29,1,963,8171,9134
2013,10,30,2,806,7338,8144
2013,10,31,3,724,7705,8429
2013,11,1,4,922,7258,8180
2013,11,2,5,2866,6624,9490
2013,11,3,6,2116,5619,7735
2013,11,4,0,555,6399,6954
2013,11,5,1,670,7553,8223
2013,11,6,2,797,8080,8877
2013,11,7,3,485,7580,8065
2013,11,8,4,728,6861,7589
2013,11,9,5,2192,5426,7618
2013,11,10,6,2066,5194,7260
2013,11,11,0,972,6292,7264
2013,11,12,1,262,5900,6162
2013,11,13,2,280,6264,6544
2013,11,14,3,379,6980,7359
2013,11,15,4,784,6970,7754
2013,11,16,5,1530,5361,6891
2013,11,17,6,1446,5579,7025
2013,11,18,0,707,7643,8350
2013,11,19,1,427,7095,7522
2013,11,20,2,452,6957,7409
2013,11,21,3,471,7117,7588
2013,11,22,4,719,7511,8230
2013,11,23,5,1267,4913,6180
2013,11,24,6,370,2857,3227
2013,11,25,0,310,5050,5360
2013,11,26,1,51,1850,1901
2013,11,27,2,44,2220,2264
2013,11,28,3,388,1215,1603
2013,11,29,4,724,2232,2956
2013,11,30,5,784,2258,3042
2013,12,1,6,662,3065,3727
2013,12,2,0,284,6101,6385
2013,12,3,1,417,7106,7523
2013,12,4,2,437,7237,7674
2013,12,5,3,582,7661,8243
2013,12,6,4,145,2831,2976
2013,12,7,5,596,4335,4931
2013,12,8,6,88,1288,1376
2013,12,9,0,67,3406,3473
2013,12,10,1,99,2625,2724
2013,12,11,2,224,5306,5530
2013,12,12,3,158,4975,5133
2013,12,13,4,246,5440,5686
2013,12,14,5,253,2575,2828
2013,12,15,6,539,3815,4354
2013,12,16,0,239,5430,5669
2013,12,17,1,202,5205,5407
2013,12,18,2,292,5548,5840
2013,12,19,3,481,6235,6716
2013,12,20,4,580,5995,6575
2013,12,21,5,1838,4657,6495
2013,12,22,6,660,2189,2849
2013,12,23,0,159,1872,2031
2013,12,24,1,276,2093,2369
2013,12,25,2,354,658,1012
2013,12,26,3,425,2044,2469
2013,12,27,4,801,2818,3619
2013,12,28,5,1936,2514,4450
2013,12,29,6,289,1171,1460
2013,12,30,0,674,3726,4400
2013,12,31,1,531,3635,4166
2014,1,1,2,729,2312,3041
2014,1,2,3,288,3068,3356
2014,1,3,4,75,1559,1634
2014,1,4,5,158,2123,2281
2014,1,5,6,135,1945,2080
2014,1,6,0,123,3430,3553
2014,1,7,1,29,2301,2330
2014,1,8,2,75,3901,3976
2014,1,9,3,190,4802,4992
2014,1,10,4,81,1780,1861
2014,1,11,5,97,1887,1984
2014,1,12,6,999,4468,5467
2014,1,13,0,732,6187,6919
2014,1,14,1,345,4781,5126
2014,1,15,2,516,5994,6510
2014,1,16,3,385,5682,6067
2014,1,17,4,532,5653,6185
2014,1,18,5,410,2942,3352
2014,1,19,6,720,3425,4145
2014,1,20,0,880,4488,5368
2014,1,21,1,45,1721,1766
2014,1,22,2,13,1450,1463
2014,1,23,3,34,2416,2450
2014,1,24,4,40,2611,2651
2014,1,25,5,94,2199,2293
2014,1,26,6,130,2458,2588
2014,1,27,0,69,4466,4535
2014,1,28,1,39,3121,3160
2014,1,29,2,58,3127,3185
2014,1,30,3,68,4141,4209
2014,1,31,4,239,5240,5479
2014,2,1,5,767,4642,5409
2014,2,2,6,836,4635,5471
2014,2,3,0,61,2432,2493
2014,2,4,1,130,5096,5226
2014,2,5,2,116,3684,3800
2014,2,6,3,150,5093,5243
2014,2,7,4,220,5227,5447
2014,2,8,5,390,3689,4079
2014,2,9,6,212,2934,3146
2014,2,10,0,127,4355,4482
2014,2,11,1,181,4602,4783
2014,2,12,2,85,3902,3987
2014,2,13,3,4,52,56
2014,2,14,4,73,1876,1949
2014,2,15,5,139,1642,1781
2014,2,16,6,384,2492,2876
2014,2,17,0,330,3019,3349
2014,2,18,1,269,4885,5154
2014,2,19,2,244,5438,5682
2014,2,20,3,429,6202,6631
2014,2,21,4,346,5498,5844
2014,2,22,5,1954,5942,7896
2014,2,23,6,841,5311,6152
2014,2,24,0,295,5164,5459
2014,2,25,1,157,4438,4595
2014,2,26,2,102,3856,3958
2014,2,27,3,159,4781,4940
2014,2,28,4,173,3970,4143
2014,3,1,5,808,3796,4604
2014,3,2,6,540,2991,3531
2014,3,3,0,16,413,429
2014,3,4,1,63,2216,2279
2014,3,5,2,237,4317,4554
2014,3,6,3,240,4635,4875
2014,3,7,4,256,4858,5114
2014,3,8,5,2811,5683,8494
2014,3,9,6,1488,4491,5979
2014,3,10,0,844,5987,6831
2014,3,11,1,1307,7139,8446
2014,3,12,2,702,5586,6288
2014,3,13,3,213,3809,4022
2014,3,14,4,1120,5915,7035
2014,3,15,5,3755,6716,10471
2014,3,16,6,1263,3608,4871
2014,3,17,0,61,1235,1296
2014,3,18,1,219,4488,4707
2014,3,19,2,112,3679,3791
2014,3,20,3,798,6804,7602
2014,3,21,4,1007,6750,7757
2014,3,22,5,4712,6257,10969
2014,3,23,6,1186,4178,5364
2014,3,24,0,519,4916,5435
2014,3,25,1,105,3014,3119
2014,3,26,2,248,4732,4980
2014,3,27,3,621,5891,6512
2014,3,28,4,897,5844,6741
2014,3,29,5,287,2011,2298
2014,3,30,6,58,848,906
2014,3,31,0,1392,6876,8268
2014,4,1,1,1507,7969,9476
2014,4,2,2,1328,7659,8987
2014,4,3,3,1432,7756,9188
2014,4,4,4,1505,7467,8972
2014,4,5,5,4626,6215,10841
2014,4,6,6,3678,6254,9932
2014,4,7,0,149,2693,2842
2014,4,8,1,1098,7859,8957
2014,4,9,2,1485,8508,9993
2014,4,10,3,2348,9007,11355
2014,4,11,4,2982,8557,11539
2014,4,12,5,7923,7832,15755
2014,4,13,6,7448,7130,14578
2014,4,14,0,3085,7639,10724
2014,4,15,1,191,1651,1842
2014,4,16,2,1356,6495,7851
2014,4,17,3,1515,7198,8713
2014,4,18,4,2323,7105,9428
2014,4,19,5,5913,6111,12024
2014,4,20,6,4099,5528,9627
2014,4,21,0,2029,7721,9750
2014,4,22,1,1262,7943,9205
2014,4,23,2,1202,7827,9029
2014,4,24,3,1609,8376,9985
2014,4,25,4,1548,6110,7658
2014,4,26,5,4961,6666,11627
2014,4,27,6,4496,6665,11161
2014,4,28,0,1253,5234,6487
2014,4,29,1,208,2940,3148
2014,4,30,2,57,1759,1816
2014,5,1,3,1272,8419,9691
2014,5,2,4,1881,8568,10449
2014,5,3,5,4210,7092,11302
2014,5,4,6,3810,6832,10642
2014,5,5,0,1398,6771,8169
2014,5,6,1,1745,8785,10530
2014,5,7,2,931,7718,8649
2014,5,8,3,1560,8963,10523
2014,5,9,4,2008,8531,10539
2014,5,10,5,2590,5739,8329
2014,5,11,6,4123,6969,11092
2014,5,12,0,1737,7779,9516
2014,5,13,1,1661,8385,10046
2014,5,14,2,1533,8282,9815
2014,5,15,3,1518,7969,9487
2014,5,16,4,1548,6569,8117
2014,5,17,5,4254,7080,11334
2014,5,18,6,3609,6719,10328
2014,5,19,0,2139,8395,10534
2014,5,20,1,2067,8889,10956
2014,5,21,2,1301,7300,8601
2014,5,22,3,1846,8604,10450
2014,5,23,4,2178,8354,10532
2014,5,24,5,5142,5502,10644
2014,5,25,6,6745,5461,12206
2014,5,26,0,5030,5779,10809
2014,5,27,1,1632,6695,8327
2014,5,28,2,1500,8530,10030
2014,5,29,3,548,4818,5366
2014,5,30,4,2014,8916,10930
2014,5,31,5,4526,7683,12209
2014,6,1,6,3786,7289,11075
2014,6,2,0,1863,8603,10466
2014,6,3,1,1618,8901,10519
2014,6,4,2,1511,8765,10276
2014,6,5,3,1518,9336,10854
2014,6,6,4,2184,9772,11956
2014,6,7,5,4277,7725,12002
2014,6,8,6,3844,6896,10740
2014,6,9,0,2004,8619,10623
2014,6,10,1,1470,8149,9619
2014,6,11,2,1214,7520,8734
2014,6,12,3,1167,8147,9314
2014,6,13,4,1522,8068,9590
2014,6,14,5,4318,7728,12046
2014,6,15,6,3983,7204,11187
2014,6,16,0,1923,8701,10624
2014,6,17,1,1723,8901,10624
2014,6,18,2,1536,8570,10106
2014,6,19,3,1717,8853,10570
2014,6,20,4,2444,9336,11780
2014,6,21,5,3640,6299,9939
2014,6,22,6,3814,7134,10948
2014,6,23,0,2213,8771,10984
2014,6,24,1,1958,9343,11301
2014,6,25,2,1705,8606,10311
2014,6,26,3,1737,9350,11087
2014,6,27,4,2274,8475,10749
2014,6,28,5,3936,7038,10974
2014,6,29,6,4119,6816,10935
2014,6,30,0,2069,8525,10594
2014,7,1,1,1898,8702,10600
2014,7,2,2,1691,8008,9699
2014,7,3,3,1925,6771,8696
2014,7,4,4,6001,6023,12024
2014,7,5,5,7098,5830,12928
2014,7,6,6,4973,6060,11033
2014,7,7,0,2111,8054,10165
2014,7,8,1,1383,7246,8629
2014,7,9,2,1516,7384,8900
2014,7,10,3,1543,7257,8800
2014,7,11,4,2546,8800,11346
2014,7,12,5,4894,6717,11611
2014,7,13,6,3475,5960,9435
2014,7,14,0,1885,6725,8610
2014,7,15,1,1375,6554,7929
2014,7,16,2,2282,9143,11425
2014,7,17,3,2593,9116,11709
2014,7,18,4,3126,8658,11784
2014,7,19,5,5247,6651,11898
2014,7,20,6,4664,6269,10933
2014,7,21,0,2852,8275,11127
2014,7,22,1,2611,8696,11307
2014,7,23,2,2191,8124,10315
2014,7,24,3,2399,8404,10803
2014,7,25,4,3619,8802,12421
2014,7,26,5,5561,6557,12118
2014,7,27,6,4158,5931,10089
2014,7,28,0,2622,8152,10774
2014,7,29,1,2573,8871,11444
2014,7,30,2,2477,9024,11501
2014,7,31,3,2496,8610,11106
2014,8,1,4,2210,7764,9974
2014,8,2,5,5214,5705,10919
2014,8,3,6,3925,5994,9919
2014,8,4,0,2938,8062,11000
2014,8,5,1,2546,8282,10828
2014,8,6,2,2604,8505,11109
2014,8,7,3,2578,8597,11175
2014,8,8,4,3327,8044,11371
2014,8,9,5,4724,5733,10457
2014,8,10,6,4960,5822,10782
2014,8,11,0,2776,6911,9687
2014,8,12,1,880,5150,6030
2014,8,13,2,2532,8487,11019
2014,8,14,3,2661,8470,11131
2014,8,15,4,3482,8566,12048
2014,8,16,5,5828,6532,12360
2014,8,17,6,4385,6296,10681
2014,8,18,0,2514,8328,10842
2014,8,19,1,1869,8777,10646
2014,8,20,2,1928,7328,9256
2014,8,21,3,2020,7830,9850
2014,8,22,4,2205,8149,10354
2014,8,23,5,2045,4468,6513
2014,8,24,6,3843,7090,10933
2014,8,25,0,2145,8715,10860
2014,8,26,1,1921,9067,10988
2014,8,27,2,2078,9170,11248
2014,8,28,3,2016,9155,11171
2014,8,29,4,2848,8885,11733
2014,8,30,5,4946,5363,10309
2014,8,31,6,4549,4477,9026
2014,9,1,0,1254,7151,8405
2014,9,2,1,754,7963,8717
2014,9,3,2,2645,7899,10544
2014,9,4,3,3631,7298,10929
2014,9,5,4,3289,7820,11109
2014,9,6,5,1776,7660,9436
2014,9,7,6,1134,10231,11365
2014,9,8,0,1116,9377,10493
2014,9,9,1,1371,9719,11090
2014,9,10,2,2749,8622,11371
2014,9,11,3,3755,7353,11108
2014,9,12,4,3139,9144,12283
2014,9,13,5,1318,6984,8302
2014,9,14,6,1534,10517,12051
2014,9,15,0,1674,9803,11477
2014,9,16,1,1923,10339,12262
2014,9,17,2,2284,9480,11764
2014,9,18,3,3831,7796,11627
2014,9,19,4,2591,9381,11972
2014,9,20,5,2018,10817,12835
2014,9,21,6,1350,9518,10868
2014,9,22,0,1341,9799,11140
2014,9,23,1,1836,9894,11730
2014,9,24,2,2369,7028,9397
2014,9,25,3,2037,4680,6717
2014,9,26,4,3259,9028,12287
2014,9,27,5,1887,10894,12781
2014,9,28,6,1580,9454,11034
2014,9,29,0,1752,8987,10739
2014,9,30,1,3746,8018,11764
2014,10,1,2,1229,9428,10657
2014,10,2,3,1504,10330,11834
2014,10,3,4,1688,9359,11047
2014,10,4,5,3371,7383,10754
2014,10,5,6,2809,6954,9763
2014,10,6,0,1656,9105,10761
2014,10,7,1,1122,8459,9581
2014,10,8,2,1435,9930,11365
2014,10,9,3,1614,9742,11356
2014,10,10,4,1304,6939,8243
2014,10,11,5,1571,4203,5774
2014,10,12,6,3492,6035,9527
2014,10,13,0,1080,5615,6695
2014,10,14,1,1560,9460,11020
2014,10,15,2,444,5713,6157
2014,10,16,3,1180,9002,10182
2014,10,17,4,2660,9414,12074
2014,10,18,5,3938,7002,10940
2014,10,19,6,2274,5947,8221
2014,10,20,0,1203,8329,9532
2014,10,21,1,747,6818,7565
2014,10,22,2,240,4204,4444
2014,10,23,3,1055,8793,9848
2014,10,24,4,1716,8847,10563
2014,10,25,5,3830,7505,11335
2014,10,26,6,3309,7049,10358
2014,10,27,0,1577,9045,10622
2014,10,28,1,1419,10288,11707
2014,10,29,2,771,8735,9506
2014,10,30,3,887,9260,10147
2014,10,31,4,1131,8535,9666
2014,11,1,5,1128,5002,6130
2014,11,2,6,895,4803,5698
2014,11,3,0,620,8041,8661
2014,11,4,1,750,9171,9921
2014,11,5,2,700,8541,9241
2014,11,6,3,422,6968,7390
2014,11,7,4,846,7936,8782
2014,11,8,5,1773,5879,7652
2014,11,9,6,2002,5940,7942
2014,11,10,0,1175,8233,9408
2014,11,11,1,1722,9169,10891
2014,11,12,2,779,8850,9629
2014,11,13,3,486,6707,7193
2014,11,14,4,479,6598,7077
2014,11,15,5,1217,4799,6016
2014,11,16,6,861,3922,4783
2014,11,17,0,169,3964,4133
2014,11,18,1,271,5300,5571
2014,11,19,2,194,5843,6037
2014,11,20,3,311,6986,7297
2014,11,21,4,414,5999,6413
2014,11,22,5,908,4719,5627
2014,11,23,6,1107,4540,5647
2014,11,24,0,1070,8200,9270
2014,11,25,1,888,7316,8204
2014,11,26,2,53,1394,1447
2014,11,27,3,432,1439,1871
2014,11,28,4,521,2126,2647
2014,11,29,5,1010,2686,3696
2014,11,30,6,973,4051,5024
2014,12,1,0,460,5922,6382
2014,12,2,1,57,2625,2682
2014,12,3,2,223,6724,6947
2014,12,4,3,345,7046,7391
2014,12,5,4,279,5754,6033
2014,12,6,5,287,2417,2704
2014,12,7,6,703,4611,5314
2014,12,8,0,263,5809,6072
2014,12,9,1,75,3245,3320
2014,12,10,2,261,6488,6749
2014,12,11,3,293,6084,6377
2014,12,12,4,446,6387,6833
2014,12,13,5,738,4941,5679
2014,12,14,6,755,4556,5311
2014,12,15,0,555,7152,7707
2014,12,16,1,212,5796,6008
2014,12,17,2,496,6938,7434
2014,12,18,3,241,6129,6370
2014,12,19,4,308,5610,5918
2014,12,20,5,442,3447,3889
2014,12,21,6,622,2997,3619
2014,12,22,0,155,2846,3001
2014,12,23,1,224,3531,3755
2014,12,24,2,57,1167,1224
2014,12,25,3,779,883,1662
2014,12,26,4,1170,1778,2948
2014,12,27,5,2151,2068,4219
2014,12,28,6,1127,1761,2888
2014,12,29,0,1175,4013,5188
2014,12,30,1,803,4540,5343
2014,12,31,2,550,3704,4254
2015,1,1,3,559,2052,2611
2015,1,2,4,938,4217,5155
2015,1,3,5,217,1501,1718
2015,1,4,6,503,3208,3711
2015,1,5,0,293,4969,5262
2015,1,6,1,45,2041,2086
2015,1,7,2,65,2998,3063
2015,1,8,3,40,2936,2976
2015,1,9,4,87,4150,4237
2015,1,10,5,159,2535,2694
2015,1,11,6,363,3123,3486
2015,1,12,0,83,2085,2168
2015,1,13,1,247,5273,5520
2015,1,14,2,205,4393,4598
2015,1,15,3,272,5540,5812
2015,1,16,4,263,5466,5729
2015,1,17,5,695,3570,4265
2015,1,18,6,277,2271,2548
2015,1,19,0,618,4069,4687
2015,1,20,1,202,6114,6316
2015,1,21,2,121,5281,5402
2015,1,22,3,310,6114,6424
2015,1,23,4,268,4506,4774
2015,1,24,5,231,3273,3504
2015,1,25,6,657,4553,5210
2015,1,26,0,34,2414,2448
2015,1,27,1,72,4030,4102
2015,1,28,2,103,5028,5131
2015,1,29,3,95,4584,4679
2015,1,30,4,131,4774,4905
2015,1,31,5,321,3050,3371
2015,2,1,6,269,3352,3621
2015,2,2,0,54,3857,3911
2015,2,3,1,6,5156,5162
2015,2,4,2,43,6095,6138
2015,2,5,3,162,4914,5076
2015,2,6,4,183,4823,5006
2015,2,7,5,769,4267,5036
2015,2,8,6,1636,5193,6829
2015,2,9,0,181,4836,5017
2015,2,10,1,214,5554,5768
2015,2,11,2,440,6268,6708
2015,2,12,3,231,5278,5509
2015,2,13,4,173,3905,4078
2015,2,14,5,518,2486,3004
2015,2,15,6,72,983,1055
2015,2,16,0,98,1237,1335
2015,2,17,1,36,1162,1198
2015,2,18,2,45,3138,3183
2015,2,19,3,58,2662,2720
2015,2,20,4,63,2454,2517
2015,2,21,5,25,733,758
2015,2,22,6,152,1869,2021
2015,2,23,0,81,3574,3655
2015,2,24,1,60,3861,3921
2015,2,25,2,123,4893,5016
2015,2,26,3,106,3425,3531
2015,2,27,4,191,4508,4699
2015,2,28,5,414,2880,3294
2015,3,1,6,50,752,802
2015,3,2,0,179,3939,4118
2015,3,3,1,158,3726,3884
2015,3,4,2,120,4067,4187
2015,3,5,3,35,525,560
2015,3,6,4,75,1912,1987
2015,3,7,5,380,2891,3271
2015,3,8,6,1354,4175,5529
2015,3,9,0,1409,6766,8175
2015,3,10,1,381,3634,4015
2015,3,11,2,1075,6834,7909
2015,3,12,3,1811,7404,9215
2015,3,13,4,1415,6669,8084
2015,3,14,5,819,2850,3669
2015,3,15,6,2056,4612,6668
2015,3,16,0,1685,7337,9022
2015,3,17,1,1514,7732,9246
2015,3,18,2,804,6723,7527
2015,3,19,3,1191,7011,8202
2015,3,20,4,151,2805,2956
2015,3,21,5,3441,5995,9436
2015,3,22,6,2779,5454,8233
2015,3,23,0,1463,6671,8134
2015,3,24,1,991,6884,7875
2015,3,25,2,689,6864,7553
2015,3,26,3,1248,7530,8778
2015,3,27,4,887,5254,6141
2015,3,28,5,887,3789,4676
2015,3,29,6,1712,4149,5861
2015,3,30,0,1628,7568,9196
2015,3,31,1,1304,6894,8198
2015,7,1,2,2308,8915,11223
2015,7,2,3,2488,8769,11257
2015,7,3,4,6429,6362,12791
2015,7,4,5,5755,4533,10288
2015,7,5,6,6211,5988,12199
2015,7,6,0,2614,8288,10902
2015,7,7,1,2393,9830,12223
2015,7,8,2,1683,7812,9495
2015,7,9,3,1916,9129,11045
2015,7,10,4,3072,9941,13013
2015,7,11,5,4847,7573,12420
2015,7,12,6,4314,7397,11711
2015,7,13,0,1864,8360,10224
2015,7,14,1,1975,9616,11591
2015,7,15,2,2039,10049,12088
2015,7,16,3,2516,10741,13257
2015,7,17,4,2977,9650,12627
2015,7,18,5,4426,6670,11096
2015,7,19,6,4155,5993,10148
2015,7,20,0,2318,8538,10856
2015,7,21,1,2246,9565,11811
2015,7,22,2,2468,10466,12934
2015,7,23,3,2575,10417,12992
2015,7,24,4,3280,10059,13339
2015,7,25,5,5807,7095,12902
2015,7,26,6,4682,6632,11314
2015,7,27,0,2482,8437,10919
2015,7,28,1,2528,9448,11976
2015,7,29,2,2428,9742,12170
2015,7,30,3,1803,9005,10808
2015,7,31,4,2751,9645,12396
2015,8,1,5,4940,7103,12043
2015,8,2,6,4550,6897,11447
2015,8,3,0,2714,9371,12085
2015,8,4,1,2212,9414,11626
2015,8,5,2,2408,10093,12501
2015,8,6,3,2565,10052,12617
2015,8,7,4,2827,9354,12181
2015,8,8,5,5843,7127,12970
2015,8,9,6,4923,6728,11651
2015,8,10,0,2362,8132,10494
2015,8,11,1,2065,9277,11342
2015,8,12,2,2304,10181,12485
2015,8,13,3,2344,10091,12435
2015,8,14,4,2972,9577,12549
2015,8,15,5,5261,6821,12082
2015,8,16,6,3872,6320,10192
2015,8,17,0,2135,8836,10971
2015,8,18,1,2098,9497,11595
2015,8,19,2,1985,9981,11966
2015,8,20,3,1823,8369,10192
2015,8,21,4,3064,9838,12902
2015,8,22,5,4995,7344,12339
2015,8,23,6,4119,6862,10981
2015,8,24,0,1963,8320,10283
2015,8,25,1,2220,10452,12672
2015,8,26,2,1933,10397,12330
2015,8,27,3,2022,10384,12406
2015,8,28,4,2440,9770,12210
2015,8,29,5,4426,7100,11526
2015,8,30,6,3512,6676,10188
2015,8,31,0,1716,9336,11052
2015,9,1,1,1504,10018,11522
2015,9,2,2,1545,9833,11378
2015,9,3,3,1670,9461,11131
2015,9,4,4,2187,8863,11050
2015,9,5,5,5260,5607,10867
2015,9,6,6,6970,5430,12400
2015,9,7,0,4295,6056,10351
2015,9,8,1,1381,9584,10965
2015,9,9,2,1352,9713,11065
2015,9,10,3,1078,9278,10356
2015,9,11,4,2085,10082,12167
2015,9,12,5,1417,5248,6665
2015,9,13,6,3127,7270,10397
2015,9,14,0,1592,9564,11156
2015,9,15,1,1540,10403,11943
2015,9,16,2,1485,10453,11938
2015,9,17,3,1561,10388,11949
2015,9,18,4,1809,10147,11956
2015,9,19,5,3971,7609,11580
2015,9,20,6,3604,7394,10998
2015,9,21,0,1314,6502,7816
2015,9,22,1,1783,10169,11952
2015,9,23,2,2339,10434,12773
2015,9,24,3,2320,10194,12514
2015,9,25,4,1814,9589,11403
2015,9,26,5,3509,7529,11038
2015,9,27,6,2892,7087,9979
2015,9,28,0,1569,9736,11305
2015,9,29,1,930,6310,7240
2015,9,30,2,1047,9137,10184
2016,1,1,4,999,2221,3220
2016,1,2,5,1522,3400,4922
2016,1,3,6,1242,3722,4964
2016,1,4,0,274,4859,5133
2016,1,5,1,249,4601,4850
2016,1,6,2,253,5459,5712
2016,1,7,3,371,6221,6592
2016,1,8,4,347,5806,6153
2016,1,9,5,765,4549,5314
2016,1,10,6,956,4707,5663
2016,1,11,0,428,5866,6294
2016,1,12,1,387,6103,6490
2016,1,13,2,271,5349,5620
2016,1,14,3,478,6686,7164
2016,1,15,4,506,5477,5983
2016,1,16,5,1436,4472,5908
2016,1,17,6,606,2794,3400
2016,1,18,0,142,2357,2499
2016,1,19,1,57,3855,3912
2016,1,20,2,64,4257,4321
2016,1,21,3,71,4157,4228
2016,1,22,4,62,2923,2985
2016,1,27,2,3,525,528
2016,1,28,3,38,1984,2022
2016,1,29,4,94,2848,2942
2016,1,30,5,321,2501,2822
2016,1,31,6,477,3134,3611
2016,2,1,0,190,4414,4604
2016,2,2,1,227,6357,6584
2016,2,3,2,72,4171,4243
2016,2,4,3,301,6390,6691
2016,2,5,4,382,5440,5822
2016,2,6,5,788,4254,5042
2016,2,7,6,671,3993,4664
2016,2,8,0,266,5728,5994
2016,2,9,1,111,3942,4053
2016,2,10,2,184,5309,5493
2016,2,11,3,91,4155,4246
2016,2,12,4,172,4191,4363
2016,2,13,5,118,1417,1535
2016,2,14,6,225,1626,1851
2016,2,15,0,24,477,501
2016,2,16,1,83,3155,3238
2016,2,17,2,241,5856,6097
2016,2,18,3,217,5605,5822
2016,2,19,4,289,5344,5633
2016,2,20,5,2651,5594,8245
2016,2,21,6,733,3521,4254
2016,2,22,0,522,6626,7148
2016,2,23,1,57,2528,2585
2016,2,24,2,67,3212,3279
2016,2,25,3,169,6161,6330
2016,2,26,4,146,5199,5345
2016,2,27,5,982,4450,5432
2016,2,28,6,2792,5940,8732
2016,2,29,0,647,7181,7828
2016,3,1,1,686,7902,8588
2016,3,2,2,210,5708,5918
2016,3,3,3,251,5651,5902
2016,3,4,4,273,5072,5345
2016,3,5,5,1109,4225,5334
2016,3,6,6,1539,4360,5899
2016,3,7,0,1479,7524,9003
2016,3,8,1,1670,8888,10558
2016,3,9,2,1925,9289,11214
2016,3,10,3,1910,9044,10954
2016,3,11,4,2290,8930,11220
2016,3,12,5,3962,6465,10427
2016,3,13,6,1426,3768,5194
2016,3,14,0,870,6801,7671
2016,3,15,1,1015,7543,8558
2016,3,16,2,3953,9403,13356
2016,3,17,3,1786,8887,10673
2016,3,18,4,2561,8868,11429
2016,3,19,5,496,2731,3227
2016,3,20,6,763,3769,4532
2016,3,21,0,838,6742,7580
2016,3,22,1,1410,8353,9763
2016,3,23,2,2380,9960,12340
2016,3,24,3,3139,10224,13363
2016,3,25,4,3274,8938,12212
2016,3,26,5,7027,7089,14116
2016,3,27,6,3745,4819,8564
2016,3,28,0,1485,6945,8430
2016,3,29,1,1658,8563,10221
2016,3,30,2,2050,8823,10873
2016,3,31,3,1950,9079,11029
2016,4,1,4,2542,8333,10875
2016,4,2,5,3478,5803,9281
2016,4,3,6,1921,4879,6800
2016,4,4,0,971,6427,7398
2016,4,5,1,645,6867,7512
2016,4,6,2,1055,8013,9068
2016,4,7,3,490,4943,5433
2016,4,8,4,1651,7878,9529
2016,4,9,5,795,3274,4069
2016,4,10,6,2507,4914,7421
2016,4,11,0,1479,7977,9456
2016,4,12,1,926,7657,8583
2016,4,13,2,1152,8979,10131
2016,4,14,3,1323,9200,10523
2016,4,15,4,2329,9066,11395
2016,4,16,5,5969,7536,13505
2016,4,17,6,5252,7115,12367
2016,4,18,0,2409,9473,11882
2016,4,19,1,1962,9965,11927
2016,4,20,2,1712,9938,11650
2016,4,21,3,1738,9709,11447
2016,4,22,4,2068,9025,11093
2016,4,23,5,3018,5469,8487
2016,4,24,6,4816,7132,11948
2016,4,25,0,2296,9398,11694
2016,4,26,1,1754,9964,11718
2016,4,27,2,924,7436,8360
2016,4,28,3,353,4842,5195
2016,4,29,4,1055,7203,8258
2016,4,30,5,2845,5666,8511
2016,5,1,6,947,3429,4376
2016,5,2,0,1275,6864,8139
2016,5,3,1,803,7329,8132
2016,5,4,2,1018,8607,9625
2016,5,5,3,893,7833,8726
2016,5,6,4,169,2933,3102
2016,5,7,5,2879,6346,9225
2016,5,8,6,4057,6746,10803
2016,5,9,0,1022,8142,9164
2016,5,10,1,1311,8931,10242
2016,5,11,2,620,7049,7669
2016,5,12,3,1488,9317,10805
2016,5,13,4,1543,8563,10106
2016,5,14,5,3362,6027,9389
2016,5,15,6,2686,5821,8507
2016,5,16,0,2267,9090,11357
2016,5,17,1,293,5081,5374
2016,5,18,2,1162,9421,10583
2016,5,19,3,1940,9780,11720
2016,5,20,4,3238,10622,13860
2016,5,21,5,1059,3373,4432
2016,5,22,6,426,2425,2851
2016,5,23,0,1249,6799,8048
2016,5,24,1,2397,10838,13235
2016,5,25,2,2220,10566,12786
2016,5,26,3,1881,10307,12188
2016,5,27,4,2767,9372,12139
2016,5,28,5,5846,5714,11560
2016,5,29,6,4911,4158,9069
2016,5,30,0,4229,5701,9930
2016,5,31,1,2045,9533,11578
2016,6,1,2,1669,10686,12355
2016,6,2,3,1671,10695,12366
2016,6,3,4,1448,7069,8517
2016,6,4,5,4286,7705,11991
2016,6,5,6,2851,6527,9378
2016,6,6,0,2055,10413,12468
2016,6,7,1,2118,11153,13271
2016,6,8,2,2097,11489,13586
2016,6,9,3,2217,11206,13423
2016,6,10,4,2891,10839,13730
2016,6,11,5,4328,7665,11993
2016,6,12,6,4153,6870,11023
2016,6,13,0,2607,10554,13161
2016,6,14,1,2409,11540,13949
2016,6,15,2,2277,10677,12954
2016,6,16,3,1778,9278,11056
2016,6,17,4,2826,10464,13290
2016,6,18,5,5823,7727,13550
2016,6,19,6,4779,7051,11830
2016,6,20,0,2818,10094,12912
2016,6,21,1,1672,7841,9513
2016,6,22,2,2876,11026,13902
2016,6,23,3,1598,7837,9435
2016,6,24,4,2617,9788,12405
2016,6,25,5,5858,7742,13600
2016,6,26,6,5274,7082,12356
2016,6,27,0,2332,9590,11922
2016,6,28,1,1624,9440,11064
2016,6,29,2,2464,11314,13778
2016,6,30,3,2395,10923,13318
2016,7,1,4,3026,9379,12405
2016,7,2,5,7360,6712,14072
2016,7,3,6,7759,5277,13036
2016,7,4,0,3708,3892,7600
2016,7,5,1,3107,8863,11970
2016,7,6,2,2531,9917,12448
2016,7,7,3,2270,9948,12218
2016,7,8,4,2309,9272,11581
2016,7,9,5,4818,7380,12198
2016,7,10,6,4681,7300,11981
2016,7,11,0,2751,9959,12710
2016,7,12,1,2543,10625,13168
2016,7,13,2,2311,10209,12520
2016,7,14,3,2433,9653,12086
2016,7,15,4,3111,9502,12613
2016,7,16,5,7359,6478,13837
2016,7,17,6,8629,6897,15526
2016,7,18,0,2225,7504,9729
2016,7,19,1,2383,9942,12325
2016,7,20,2,2569,10731,13300
2016,7,21,3,2528,10334,12862
2016,7,22,4,3033,9072,12105
2016,7,23,5,4167,6094,10261
2016,7,24,6,3986,5629,9615
2016,7,25,0,2202,8073,10275
2016,7,26,1,2107,9043,11150
2016,7,27,2,2061,9503,11564
2016,7,28,3,1813,7551,9364
2016,7,29,4,3060,9088,12148
2016,7,30,5,3705,5225,8930
2016,7,31,6,4395,6443,10838
2016,8,1,0,2712,9236,11948
2016,8,2,1,2769,10600,13369
2016,8,3,2,2909,10678,13587
2016,8,4,3,3157,10398,13555
2016,8,5,4,3462,9724,13186
2016,8,6,5,4894,6446,11340
2016,8,7,6,5122,6840,11962
2016,8,8,0,2708,9218,11926
2016,8,9,1,2562,9862,12424
2016,8,10,2,2392,9866,12258
2016,8,11,3,2496,8970,11466
2016,8,12,4,2627,8226,10853
2016,8,13,5,3400,5317,8717
2016,8,14,6,2732,4976,7708
2016,8,15,0,1766,7474,9240
2016,8,16,1,2059,9257,11316
2016,8,17,2,1977,9011,10988
2016,8,18,3,2380,9441,11821
2016,8,19,4,2669,9246,11915
2016,8,20,5,4875,6659,11534
2016,8,21,6,2666,4586,7252
2016,8,22,0,2664,9685,12349
2016,8,23,1,2433,10609,13042
2016,8,24,2,2355,10398,12753
2016,8,25,3,2427,10097,12524
2016,8,26,4,2387,8909,11296
2016,8,27,5,4447,6750,11197
2016,8,28,6,3900,6628,10528
2016,8,29,0,2055,9374,11429
2016,8,30,1,1914,10300,12214
2016,8,31,2,1552,10057,11609
2016,9,1,3,1543,8447,9990
2016,9,2,4,3173,9536,12709
2016,9,3,5,5401,5618,11019
2016,9,4,6,7295,5489,12784
2016,9,5,0,4941,6270,11211
2016,9,6,1,2085,9664,11749
2016,9,7,2,1602,9425,11027
2016,9,8,3,1679,9789,11468
2016,9,9,4,2026,9383,11409
2016,9,10,5,3528,6844,10372
2016,9,11,6,4213,7360,11573
2016,9,12,0,2284,10023,12307
2016,9,13,1,2110,10692,12802
2016,9,14,2,1911,10609,12520
2016,9,15,3,2232,11033,13265
2016,9,16,4,2842,10363,13205
2016,9,17,5,5040,7855,12895
2016,9,18,6,4246,7092,11338
2016,9,19,0,952,7507,8459
2016,9,20,1,1926,10699,12625
2016,9,21,2,1859,10627,12486
2016,9,22,3,2045,10680,12725
2016,9,23,4,2987,10349,13336
2016,9,24,5,5185,7907,13092
2016,9,25,6,4670,7273,11943
2016,9,26,0,1844,9607,11451
2016,9,27,1,1883,10468,12351
2016,9,28,2,946,6777,7723
2016,9,29,3,495,5391,5886
2016,9,30,4,1216,7310,8526
2016,10,1,5,1782,4847,6629
2016,10,2,6,3910,6534,10444
2016,10,3,0,2445,9856,12301
2016,10,4,1,2237,10557,12794
2016,10,5,2,1855,10735,12590
2016,10,6,3,2178,10184,12362
2016,10,7,4,3358,9837,13195
2016,10,8,5,1498,3627,5125
2016,10,9,6,4004,6022,10026
2016,10,10,0,3167,7248,10415
2016,10,11,1,1870,9659,11529
2016,10,12,2,1919,9878,11797
2016,10,13,3,2090,10149,12239
2016,10,14,4,2956,9515,12471
2016,10,15,5,5442,6877,12319
2016,10,16,6,4547,6706,11253
2016,10,17,0,2462,9443,11905
2016,10,18,1,2192,10794,12986
2016,10,19,2,2121,10801,12922
2016,10,20,3,2426,10593,13019
2016,10,21,4,1905,8680,10585
2016,10,22,5,2829,6075,8904
2016,10,23,6,3625,5980,9605
2016,10,24,0,1724,9076,10800
2016,10,25,1,1519,9662,11181
2016,10,26,2,1335,9362,10697
2016,10,27,3,860,8420,9280
2016,10,28,4,1720,8907,10627
2016,10,29,5,4623,6992,11615
2016,10,30,6,4536,6366,10902
2016,10,31,0,1886,8840,10726
2016,11,1,1,1488,9881,11369
2016,11,2,2,1629,10494,12123
2016,11,3,3,1661,10297,11958
2016,11,4,4,2398,9582,11980
2016,11,5,5,4527,6776,11303
2016,11,6,6,3646,6194,9840
2016,11,7,0,1452,8703,10155
2016,11,8,1,1864,10162,12026
2016,11,9,2,946,6453,7399
2016,11,10,3,1377,8874,10251
2016,11,11,4,2595,7253,9848
2016,11,12,5,3192,5135,8327
2016,11,13,6,2970,5185,8155
2016,11,14,0,1275,7935,9210
2016,11,15,1,1201,9194,10395
2016,11,16,2,1136,8910,10046
2016,11,17,3,1217,9278,10495
2016,11,18,4,2059,9194,11253
2016,11,19,5,3121,5126,8247
2016,11,20,6,727,3099,3826
2016,11,21,0,528,6298,6826
2016,11,22,1,779,6847,7626
2016,11,23,2,1172,5731,6903
2016,11,24,3,1566,1762,3328
2016,11,25,4,2850,2981,5831
2016,11,26,5,2094,2897,4991
2016,11,27,6,1216,3651,4867
2016,11,28,0,691,7336,8027
2016,11,29,1,287,6044,6331
2016,11,30,2,349,5821,6170
2016,12,1,3,656,8475,9131
2016,12,2,4,921,7490,8411
2016,12,3,5,1423,4786,6209
2016,12,4,6,948,4316,5264
2016,12,5,0,704,7506,8210
2016,12,6,1,155,3738,3893
2016,12,7,2,638,8017,8655
2016,12,8,3,537,7456,7993
2016,12,9,4,455,5964,6419
2016,12,10,5,711,3491,4202
2016,12,11,6,585,3230,3815
2016,12,12,0,573,6464,7037
2016,12,13,1,464,7279,7743
2016,12,14,2,486,7124,7610
2016,12,15,3,148,4408,4556
2016,12,16,4,210,4307,4517
2016,12,17,5,233,2086,2319
2016,12,18,6,425,2888,3313
2016,12,19,0,494,5834,6328
2016,12,20,1,384,5722,6106
2016,12,21,2,560,6027,6587
2016,12,22,3,670,5517,6187
2016,12,23,4,523,3686,4209
2016,12,24,5,281,1091,1372
2016,12,25,6,1240,915,2155
2016,12,26,0,818,1543,2361
2016,12,27,1,1645,4158,5803
2016,12,28,2,1910,4486,6396
2016,12,29,3,842,3412,4254
2016,12,30,4,832,3615,4447
2016,12,31,5,977,2240,3217
2017,1,1,6,1580,2483,4063
2017,1,2,0,181,1457,1638
2017,1,3,1,254,3517,3771
2017,1,4,2,748,6437,7185
2017,1,5,3,402,5812,6214
2017,1,6,4,309,5261,5570
2017,1,7,5,131,1678,1809
2017,1,8,6,142,1778,1920
2017,1,9,0,194,4423,4617
2017,1,10,1,244,5362,5606
2017,1,11,2,589,6678,7267
2017,1,12,3,944,8147,9091
2017,1,13,4,899,7132,8031
2017,1,14,5,165,1699,1864
2017,1,15,6,1436,3912,5348
2017,1,16,0,578,3907,4485
2017,1,17,1,183,5391,5574
2017,1,18,2,535,6810,7345
2017,1,19,3,1031,6345,7376
2017,1,20,4,1384,4182,5566
2017,1,21,5,3412,4745,8157
2017,1,22,6,1180,2886,4066
2017,1,23,0,118,2787,2905
2017,1,24,1,416,6973,7389
2017,1,25,2,793,8231,9024
2017,1,26,3,463,7584,8047
2017,1,27,4,524,6363,6887
2017,1,28,5,1336,4219,5555
2017,1,29,6,1042,4208,5250
2017,1,30,0,194,5226,5420
2017,1,31,1,463,7301,7764
2017,2,1,2,469,7762,8231
2017,2,2,3,439,7210,7649
2017,2,3,4,382,6161,6543
2017,2,4,5,918,3889,4807
2017,2,5,6,1143,4346,5489
2017,2,6,0,879,7520,8399
2017,2,7,1,963,8833,9796
2017,2,8,2,1176,9443,10619
2017,2,9,3,219,5150,5369
2017,2,10,4,425,5549,5974
2017,2,11,5,2045,4776,6821
2017,2,12,6,1086,3637,4723
2017,2,13,0,409,5955,6364
2017,2,14,1,406,7003,7409
2017,2,15,2,511,6974,7485
2017,2,16,3,339,6088,6427
2017,2,17,4,815,6467,7282
2017,2,18,5,5531,5195,10726
2017,2,19,6,7049,5301,12350
2017,2,20,0,4138,5920,10058
2017,2,21,1,1239,7576,8815
2017,2,22,2,1227,8432,9659
2017,2,23,3,2089,9655,11744
2017,2,24,4,3365,9594,12959
2017,2,25,5,2956,5218,8174
2017,2,26,6,1918,4421,6339
2017,2,27,0,937,7327,8264
2017,2,28,1,949,6879,7828
2017,3,1,2,865,8112,8977
2017,3,2,3,696,7438,8134
2017,3,3,4,641,6100,6741
2017,3,4,5,1303,3980,5283
2017,3,5,6,1293,3706,4999
2017,3,6,0,1262,7321,8583
2017,3,7,1,1189,7194,8383
2017,3,8,2,2093,8878,10971
2017,3,9,3,2625,9781,12406
2017,3,10,4,564,5434,5998
2017,3,11,5,1191,3925,5116
2017,3,12,6,1275,3346,4621
2017,3,13,0,849,5621,6470
2017,3,14,1,111,1472,1583
2017,3,15,2,90,3269,3359
2017,3,16,3,381,4798,5179
2017,3,17,4,1162,6045,7207
2017,3,18,5,3718,4527,8245
2017,3,19,6,1930,3759,5689
2017,3,20,0,1839,7464,9303
2017,3,21,1,1895,8717,10612
2017,3,22,2,929,7384,8313
2017,3,23,3,1099,7517,8616
2017,3,24,4,1843,7243,9086
2017,3,25,5,9024,7167,16191
2017,3,26,6,2453,4168,6621
2017,3,27,0,2805,8562,11367
2017,3,28,1,1822,8622,10444
2017,3,29,2,2996,9791,12787
2017,3,30,3,1819,8505,10324
2017,3,31,4,421,3372,3793
